abantu	a ɓ aː n t u
amabele	a m a ɓ eː l e
amabhanqa	a m a b aː ǃ a
amafutha	a m a f uː tʰ a
amagcino	a m a ǀʱ iː n o
amahlebezi	a m a ɬ e ɓ eː z i
amahloni	a m a ɬ oː n i
amakha	a m aː kʰ a
amakhaza	a m a kʰ aː z a
amakhosi	a m a kʰ oː s i
amakhwezikhwezi	a m a kʰ w e z i kʰ w eː z i
amala	a m aː l a
amandla	a m aː n ɮ a
amanga	a m aː n ɡ a
amanqamu	a m a ǃ aː m u
amanyala	a m a ɲ aː l a
amanzi	a m aː n z i
amatata	a m a t aː t a
amathe	a m aː tʰ e
ayina	ʔ a j iː n a
bana	ɓ aː n a
bayede	ɓ a j eː d e
be	ɓ e
bona	ɓ oː n a
buhlungu	ɓ u ɬ uː n ɡ u
c	ǀ
cha	ǀʰ a
cishe	ǀ iː ʃ e
cwala	ǀ w aː l a
cwecwa	ǀ w eː ǀ w a
cwila	ǀ w iː l a
cwilisa	ǀ w i l iː s a
dabuka	d a ɓ uː ɠ a
dana	d aː n a
dla	ɮ a
dlala	ɮ aː l a
dlwengula	ɮ w e n ɡ uː l a
duma	d uː m a
dwa	d w a
ebula	e ɓ uː l a
ebuza	e ɓ uː z a
eluka	e l uː ɠ a
engeza	e n ɡ eː z a
ethwasa	e tʰ w aː s a
fa	f a
funa	f uː n a
futhi	f uː tʰ i
fuya	f uː j a
gaya	ɡ aː j a
gcoba	ǀʱ oː ɓ a
gcwalisa	ǀʱ w a l iː s a
gqagqa	ǃʱ aː ǃʱ a
gqagqaza	ǃʱ a ǃʱ aː z a
gqaja	ǃʱ aː d ʒ a
gqama	ǃʱ aː m a
gqamuka	ǃʱ a m uː ɠ a
gqekeza	ǃʱ e ɠ eː z a
gqola	ǃʱ oː l a
gqula	ǃʱ uː l a
gqwala	ǃʱ w aː l a
gwansa	ɡ w aː n s a
gwavuma	ɡ w a v uː m a
gwaza	ɡ w aː z a
gwedla	ɡ w eː ɮ a
gwema	ɡ w eː m a
gwinqa	ɡ w iː ǃ a
gwinya	ɡ w iː ɲ a
gxeka	ǁʱ eː ɠ a
gxila	ǁʱ iː l a
hamba kahle	h a m b a ɠ aː ɬ e
hambani kahle	h a m b a n i ɠ aː ɬ e
hawu	h aː w u
hlafuna	ɬ a f uː n a
hleka	ɬ eː ɠ a
hleze	ɬ eː z e
hlikihla	ɬ i ɠ iː ɬ a
hlobonga	ɬ o ɓ oː n ɡ a
hlonipha	ɬ o n iː pʰ a
ibala	iː ɓ aː l a
ibandla	i ɓ aː n ɮ a
ibele	iː ɓ eː l e
ibhaka	iː b aː ɠ a
ibhakede	iː b a ɠ eː d e
ibhala	iː b aː l a
ibhanoyi	iː b a n oː j i
ibhantshi	iː b aː ɲ t ʃ i
ibhasi	iː b aː s i
ibhayibheli	iː b a j i b eː l i
ibhayisikili	iː b a j i s i k iː l i
ibhayisikobho	iː b a j i s i k oː b o
ibhaza	iː b a z aː
ibhentshi	iː b eː ɲ t ʃ i
ibhimbi	iː b iː m b i
ibhodlela	iː b o ɮ eː l a
ibhodlo	iː b oː ɮ o
ibhodwe	iː b oː d w e
ibhokisi	iː b o ɠ iː s i
ibhola	iː b oː l a
ibhomu	iː b oː m u
ibhotela	iː b o t eː l a
ibhubesi	iː b u ɓ eː s i
ibhudla	iː b uː ɮ a
ibhuku	iː b uː ɠ u
ibhulakufesi	iː b u l a ɠ u f eː s i
ibhulashi	iː b u l aː ʃ i
ibhuleki	iː b u l eː ɠ i
ibhulukwe	iː b u l uː ɠ w e
ibhungane	iː b u n ɡ aː n e
ibhunu	iː b uː n u
ibizo	iː ɓ iː z o
ibomvu	iː ɓ oː m v u
ibululu	iː ɓ u l uː l u
ibumba	iː ɓ uː m b a
ibunzi	iː ɓ uː n z i
icebo	iː ǀ eː ɓ o
icele	iː ǀ eː l e
ichibi	iː ǀʰ iː ɓ i
ichopho	iː ǀʰ oː pʰ o
ichwane	iː ǀʰ w aː n e
icici	iː ǀ iː ǀ i
icilongo	iː ǀ i l oː n ɡ o
icukazi	iː ǀ u ɠ aː z i
iculo	iː ǀ uː l o
idada	iː d aː d a
idesiki	iː d e s iː ɠ i
idikazi	iː d i ɠ aː z i
idimoni	iː d i m oː n i
idlaka	iː ɮ aː ɠ a
idlozi	iː ɮ oː z i
idolo	iː d oː l o
idolobha	iː d o l oː b a
idube	iː d uː ɓ e
iduku	iː d uː ɠ u
idwala	iː d w aː l a
idweshu	iː d w eː ʃ u
ifa	iː f a
ifilimu	iː f i l iː m u
ifleyistata	i f l e j i s t aː t a
ifosholo	iː f o ʃ oː l o
ifotho	iː f oː tʰ o
ifu	iː f u
ifulentshi	iː f u l eː ɲ t ʃ i
igagasi	iː ɡ a ɡ aː s i
igalaji	iː ɡ a l aː d ʒ i
igalofu	iː ɡ a l oː f u
igama	iː ɡ aː m a
iganu	iː ɡ aː n u
igazi	iː ɡ aː z i
igceke	iː ǀʱ eː ɠ e
igciwane	iː ǀʱ i w aː n e
igcukumuva	iː ǀʱ u ɠ u m uː v a
igedlela	iː ɡ e ɮ eː l a
igeja	iː ɡ eː d ʒ a
igeza	iː ɡ eː z a
igilavu	iː ɡ i l aː v u
igilebhisi	iː ɡ i l e b iː s i
igobongo	iː ɡ o ɓ oː n ɡ o
igola	iː ɡ oː l a
igoli	iː ɡ oː l i
igolide	iː ɡ o l iː d e
igoqo	iː ɡ oː ǃ o
igqubu	iː ǃʱ uː ɓ u
igquma	iː ǃʱ uː m a
igqwetha	iː ǃʱ w eː tʰ a
igugu	iː ɡ uː ɡ u
igula	iː ɡ uː l a
igumbi	iː ɡ uː m b i
igundane	iː ɡ u n d aː n e
igundwane	iː ɡ u n d w aː n e
igwababa	iː ɡ w a ɓ aː ɓ a
igwala	iː ɡ w aː l a
igwebu	iː ɡ w eː ɓ u
igwenya	iː ɡ w eː ɲ a
igwinya	iː ɡ w iː ɲ a
igxolo	iː ǁʱ oː l o
ihansi	iː h aː n s i
ihawa	iː h aː w a
ihembe	iː h eː m b e
ihhala	iː ɦ aː l a
ihhashi	iː ɦ aː ʃ i
ihhofu	iː ɦ oː f u
ihholo	iː ɦ oː l o
ihhotela	iː ɦ o t eː l a
ihhovisi	iː ɦ o v iː s i
ihlahla	iː ɬ aː ɬ a
ihlakani	iː ɬ a ɠ aː n i
ihlathi	iː ɬ aː tʰ i
ihlaya	iː ɬ aː j a
ihlelo	iː ɬ eː l o
ihlezi	iː ɬ eː z i
ihlo	iː ɬ o
ihlobo	iː ɬ oː ɓ o
ihlombe	iː ɬ oː m b e
ihlumela	iː ɬ u m eː l a
iholide	iː h o l iː d e
ihora	iː h oː r a
ihubo	iː h uː ɓ o
ijaji	iː d ʒ aː d ʒ i
ijazi	iː d ʒ aː z i
ijele	iː d ʒ eː l e
ijezi	iː d ʒ eː z i
ijokwe	iː d ʒ oː ɠ w e
ijongosi	iː d ʒ o n ɡ oː s i
ijuba	iː d ʒ uː ɓ a
ijubane	iː d ʒ u ɓ aː n e
ikalikuni	iː k a l i k uː n i
ikamela	iː k a m eː l a
ikati	iː k aː t i
ikatshana	iː k a t ʃ aː n a
ikesi	iː k eː s i
ikewu	iː k eː w u
ikhabe	iː kʰ aː ɓ e
ikhabethe	iː kʰ a ɓ eː tʰ e
ikhala	iː kʰ aː l a
ikhalenda	iː kʰ a l eː n d a
ikhanda	iː kʰ aː n d a
ikhanjana	iː kʰ a ɲ d ʒ aː n a
ikhanzi	iː kʰ aː n z i
ikhaphethe	iː kʰ a pʰ eː tʰ e
ikhasi	iː kʰ aː s i
ikhasimende	iː kʰ a s i m eː n d e
ikhaya	iː kʰ aː j a
ikhefu	iː kʰ eː f u
ikhehla	iː kʰ eː ɬ a
ikheji	iː kʰ eː d ʒ i
ikhekhe	iː kʰ eː kʰ e
ikhekheba	iː kʰ e kʰ eː ɓ a
ikheli	iː kʰ eː l i
ikhemese	iː kʰ e m eː s e
ikhethini	iː kʰ e tʰ iː n i
ikhishi	iː kʰ iː ʃ i
ikholwase	iː kʰ o l w aː s e
ikhonsathi	iː kʰ o n s aː tʰ i
ikhukhamba	iː kʰ u kʰ aː m b a
ikhukhu	iː kʰ uː kʰ u
ikhulu	iː kʰ uː l u
ikhwapha	iː kʰ w aː pʰ a
ikhweza	iː kʰ w eː z a
ikhwezi	iː kʰ w eː z i
ikhwilithi	iː kʰ w i l iː tʰ i
ikilasi	iː k i l aː s i
ikilogo	iː k i l oː ɡ o
iklabishi	iː k x a ɓ iː ʃ i
iklwa	iː k x w a
ilahle	iː l aː ɬ e
ilanga	iː l aː n ɡ a
ilantshi	iː l aː ɲ t ʃ i
ilayisense	iː l a j i s eː n s e
ilayisi	iː l a j iː s i
ilembe	iː l eː m b e
ilisho	iː l iː ʃ o
ilobolo	iː l o ɓ oː l o
ilokhuzane	i l o kʰ u z aː n e
ilokwe	iː l oː ɠ w e
iloli	iː l oː l i
ilulwane	iː l u l w aː n e
ilungelo	iː l u n ɡ eː l o
imadlana	i m a ɮ aː n a
imali	i m aː l i
imamba	i m aː m b a
imayela	iː m a j eː l a
imbabala	i m b a ɓ aː l a
imbala	i m b aː l a
imbali	i m b aː l i
imbambe	i m b aː m b e
imbasa	i m b aː s a
imbazo	i m b aː z o
imbenge	i m b eː n ɡ e
imbewu	i m b eː w u
imbila	i m b iː l a
imbiza	i m b iː z a
imbizo	i m b iː z o
imbodla	i m b oː ɮ a
imbongi	i m b oː n ɡ i
imbongolo	i m b o n ɡ oː l o
imboni	i m b oː n i
imbovane	i m b o v aː n e
imbube	i m b uː ɓ e
imbungulu	i m b u n ɡ uː l u
imbuya	i m b uː j a
imbuzana	i m b u z aː n a
imbuzane	i m b u z aː n e
imbuzi	i m b uː z i
imbuzikazi	i m b u z i ɠ aː z i
imelika	iː m e l iː ɠ a
imfene	i m f eː n e
imfihlo	i m f iː ɬ o
imfologo	i m f o l oː ɡ o
imfoloko	i m f o l oː ɠ o
imfolozi	i m f o l oː z i
imfuluwenza	i m f u l u w eː n z a
imini	i m iː n i
iminithi	iː m i n iː tʰ i
imoto	i m oː t o
impahla	i m p aː ɬ a
impakama	i m p a ɠ aː m a
impakathi	i m p a ɠ aː tʰ i
impala	i m p aː l a
impalampala	i m p a l a m p aː l a
impambosi	i m p a m b oː s i
impande	i m p aː n d e
impangele	i m p a n ɡ eː l e
impela	i m p eː l a
impelesi	i m p e l eː s i
impempe	i m p eː m p e
impendulo	i m p e n d uː l o
impi	iː m p i
impilo	i m p iː l o
impisi	i m p iː s i
impofu	i m p oː f u
impohlo	i m p oː ɬ o
impongo	i m p oː n ɡ o
impophoma	i m p o pʰ oː m a
impoqo	i m p oː ǃ o
impuco	i m p uː ǀ o
impukane	i m p u ɠ aː n e
impumalanga	i m p u m a l aː n ɡ a
impumulo	i m p u m uː l o
impungushe	i m p u n ɡ uː ʃ e
impunzi	i m p uː n z i
impuphu	i m p uː pʰ u
impusela	i m p u s eː l a
imvama	i m v aː m a
imvamisa	i m v a m iː s a
imvana	i m v aː n a
imvelo	i m v eː l o
imvemvane	i m v e m v aː n e
imvu	iː m v u
imvubu	i m v uː ɓ u
imvukazi	i m v u ɠ aː z i
imvukusi	i m v u ɠ uː s i
imvula	i m v uː l a
imvumo	i m v uː m o
inalithi	iː n a l iː tʰ i
incazo	i ǀ aː z o
inceku	i ǀ eː ɠ u
incingo	i ǀ iː n ɡ o
incombo	i ǀ oː m b o
incuncu	i ǀ uː ǀ u
incwadi	i ǀ w aː d i
incwancwa	i ǀ w aː ǀ w a
incwincwi	i ǀ w iː ǀ w i
indaba	i n d aː ɓ a
indabushe	i n d a ɓ uː ʃ e
indandatho	i n d a n d aː tʰ o
indawo	i n d aː w o
indebe	i n d eː ɓ e
indima	i n d iː m a
indingilizi	i n d i n ɡ i l iː z i
indishi	i n d iː ʃ i
indlala	i n ɮ aː l a
indlalifa	i n ɮ a l iː f a
indlamini	i n ɮ a m iː n i
indlamu	i n ɮ aː m u
indlazi	i n ɮ aː z i
indle	iː n ɮ e
indlebe	i n ɮ eː ɓ e
indleko	i n ɮ eː ɠ o
indlela	i n ɮ eː l a
indlobho	i n ɮ oː b o
indlondlo	i n ɮ oː n ɮ o
indlovu	i n ɮ oː v u
indlovukazi	i n ɮ o v u ɠ aː z i
indlozi	i n ɮ oː z i
indlu	iː n ɮ u
indlulamithi	i n ɮ u l a m iː tʰ i
indlwana	i n ɮ w aː n a
indoda	i n d oː d a
indodakazi	i n d o d a ɠ aː z i
indodana	i n d o d aː n a
induku	i n d uː ɠ u
induna	i n d uː n a
indwandwe	i n d w aː n d w e
indwangu	i n d w aː n ɡ u
inenevana	i n e n e v aː n a
inenevu	i n e n eː v u
ingadi	i n ɡ aː d i
ingalangala	i n ɡ a l a n ɡ aː l a
ingalo	i n ɡ aː l o
ingane	i n ɡ aː n e
inganeko	i n ɡ a n eː ɠ o
inganekwane	i n ɡ a n e ɠ w aː n e
ingcanga	i ǀʱ aː n ɡ a
ingcebo	i ǀʱ eː ɓ o
ingcosa	i ǀʱ oː s a
ingcwaba	iː ǀʱ w aː ɓ a
ingcwali	i ǀʱ w aː l i
ingcweti	i ǀʱ w eː t i
ingebe	i n ɡ eː ɓ e
ingede	i n ɡ eː d e
ingisi	iː n ɡ iː s i
ingobe	iː n ɡ oː ɓ e
ingoma	i n ɡ oː m a
ingonyama	i n ɡ o ɲ aː m a
ingoqokazi	i n ɡ o ǃ o ɠ aː z i
ingozi	i n ɡ oː z i
ingqalasizinda	i ǃʱ a l a s i z iː n d a
ingqofa	i ǃʱ oː f a
ingqomfi	i ǃʱ oː m f i
ingqondo	i ǃʱ oː n d o
ingqumbi	i ǃʱ uː m b i
ingqunge	i ǃʱ uː n ɡ e
ingquza	i ǃʱ uː z a
ingubo	i n ɡ uː ɓ o
ingulube	i n ɡ u l uː ɓ e
ingulule	i n ɡ u l uː l e
ingungumbane	i n ɡ u n ɡ u m b aː n e
ingwane	i n ɡ w aː n e
ingwe	iː n ɡ w e
ingwedli	i n ɡ w eː ɮ i
ingwenya	i n ɡ w eː ɲ a
ingxabano	i ǁʱ a ɓ aː n o
ingxenye	i ǁʱ eː ɲ e
ingxi	iː ǁʱ i
ingxobongo	i ǁʱ o ɓ oː n ɡ o
ingxotha	i ǁʱ oː tʰ a
ingxoxo	i ǁʱ oː ǁ o
ingxubevange	i ǁʱ u ɓ e v aː n ɡ e
inhlaba	i n ɬ aː ɓ a
inhlabathi	i n ɬ a ɓ aː tʰ i
inhlahla	i n ɬ aː ɬ a
inhlaka	i n ɬ aː ɠ a
inhlakanipho	i n ɬ a ɠ a n iː pʰ o
inhlalakahle	i n ɬ a l a ɠ aː ɬ e
inhlalo	i n ɬ aː l o
inhlamvu	i n ɬ aː m v u
inhlamvukazi	i n ɬ a m v u ɠ aː z i
inhlangano	i n ɬ a n ɡ aː n o
inhlanhla	i n ɬ aː n ɬ a
inhlansi	i n ɬ aː n s i
inhlanzi	i n ɬ aː n z i
inhlaziyo	i n ɬ a z iː j o
inhlekisa	i n ɬ e ɠ iː s a
inhlelo	i n ɬ eː l o
inhliziyo	i n ɬ i z iː j o
inhlobo	i n ɬ oː ɓ o
inhloko	i n ɬ oː ɠ o
inhloso	i n ɬ oː s o
inhlwathi	i n ɬ w aː tʰ i
iningi	iː n iː n ɡ i
iningizimu	i n i n ɡ i z iː m u
inja	iː ɲ d ʒ a
injemane	i ɲ d ʒ e m aː n e
injingwenikazi	i ɲ d ʒ i n ɡ w e n i ɠ aː z i
injobo	i ɲ d ʒ oː ɓ o
injolikazi	i ɲ d ʒ o l i ɠ aː z i
injongo	i ɲ d ʒ oː n ɡ o
injula	i ɲ d ʒ uː l a
inkabi	i n k aː ɓ i
inkala	i n k aː l a
inkambo	i n k aː m b o
inkampane	i n k a m p aː n e
inkanyezi	i n k a ɲ eː z i
inkathazo	i n k a tʰ aː z o
inkathi	i n k aː tʰ i
inkawu	i n k aː w u
inkehlo	i n k eː ɬ o
inkinga	i n k iː n ɡ a
inkohlisa	i n k o ɬ iː s a
inkomba	i n k oː m b a
inkomo	i n k oː m o
inkontileka	i n k o n t i l eː ɠ a
inkosana	i n k o s aː n a
inkosazana	i n k o s a z aː n a
inkosi	i n k oː s i
inkosikazi	i n k o s i ɠ aː z i
inkotha	i n k oː tʰ a
inkuba	i n k uː ɓ a
inkukhu	i n k uː kʰ u
inkululeko	i n k u l u l eː ɠ o
inkulungwane	i n k u l u n ɡ w aː n e
inkumbulo	i n k u m b uː l o
inkundla	i n k uː n ɮ a
inkungu	i n k uː n ɡ u
inkunzana	i n k u n z aː n a
inkunzi	i n k uː n z i
inkwazi	i n k w aː z i
inkwindi	i n k w iː n d i
inqaba	i ǃ aː ɓ a
inqama	i ǃ aː m a
inqe	iː ǃ e
inqina	i ǃ iː n a
inqindi	i ǃ iː n d i
inqola	i ǃ oː l a
inqolobana	i ǃ o l o ɓ aː n a
inqolobane	i ǃ o l o ɓ aː n e
inqulu	i ǃ uː l u
inqumba	i ǃ uː m b a
inqwaba	i ǃ w aː ɓ a
insangu	i n s aː n ɡ u
insele	i n s eː l e
insephe	i n s eː pʰ e
insimba	i n s iː m b a
insimbi	i n s iː m b i
insimu	i n s iː m u
insipho	i n s iː pʰ o
insizwa	i n s iː z w a
inso	iː n s o
insundu	i n s uː n d u
inswelakalo	i n s w e l a ɠ aː l o
inswelo	i n s w eː l o
intaba	i n t aː ɓ a
intaka	i n t aː ɠ a
intambo	i n t aː m b o
intamo	i n t aː m o
intandane	i n t a n d aː n e
intando	i n t aː n d o
intela	i n t eː l a
intengo	i n t eː n ɡ o
intethe	i n t eː tʰ e
intini	i n t iː n i
into	iː n t o
intombazane	i n t o m b a z aː n e
intombi	i n t oː m b i
intonga	i n t oː n ɡ a
intsha	iː ɲ t ʃ a
intshe	iː ɲ t ʃ e
intshonalanga	i ɲ t ʃ o n a l aː n ɡ a
intshontsho	iː ɲ t ʃ oː ɲ t ʃ o
intshumayelo	i ɲ t ʃ u m a j eː l o
intshushiso	i ɲ t ʃ u ʃ iː s o
intulo	i n t uː l o
intuthane	i n t u tʰ aː n e
intuthu	i n t uː tʰ u
intwala	i n t w aː l a
intwasahlobo	i n t w a s a ɬ oː ɓ o
intwentshe	i n t w eː ɲ t ʃ e
inungu	i n uː n ɡ u
inxa	i ǁ aː
inxaso	i ǁ aː s o
inxeba	iː ǁ eː ɓ a
inxele	iː ǁ eː l e
inxokovane	i ǁ o ɠ o v aː n e
inyakatho	i ɲ a ɠ aː tʰ o
inyala	i ɲ aː l a
inyama	i ɲ aː m a
inyamazane	i ɲ a m a z aː n e
inyanga	i ɲ aː n ɡ a
inyathi	i ɲ aː tʰ i
inyendle	i ɲ eː n ɮ e
inyoka	i ɲ oː ɠ a
inyonga	i ɲ oː n ɡ a
inyongo	i ɲ oː n ɡ o
inyoni	i ɲ oː n i
inyosi	i ɲ oː s i
inyumba	i ɲ uː m b a
inzima	i n z iː m a
inzondo	i n z oː n d o
inzulu	i n z uː l u
iphahla	iː pʰ aː ɬ a
iphakathi	iː pʰ a ɠ aː tʰ i
iphalamende	iː pʰ a l a m eː n d e
iphango	iː pʰ aː n ɡ o
iphaphu	iː pʰ aː pʰ u
iphara	iː pʰ aː r a
iphasika	iː pʰ a s iː ɠ a
iphela	iː pʰ eː l a
iphepha	iː pʰ eː pʰ a
iphiko	iː pʰ iː ɠ o
iphoyisa	iː pʰ o j iː s a
iphupho	iː pʰ uː pʰ o
iphutha	iː pʰ uː tʰ a
iphuzu	iː pʰ uː z u
ipipi	iː p iː p i
ipiyano	iː p i j aː n o
ipulangwe	iː p u l aː n ɡ w e
ipulazi	iː p u l aː z i
iqabi	iː ǃ aː ɓ i
iqakala	iː ǃ a ɠ aː l a
iqanda	iː ǃ aː n d a
iqaqa	iː ǃ aː ǃ a
iqatha	iː ǃ aː tʰ a
iqembu	iː ǃ eː m b u
iqeqeba	iː ǃ e ǃ eː ɓ a
iqhawe	iː ǃʰ aː w e
iqhezu	iː ǃʰ eː z u
iqhina	iː ǃʰ iː n a
iqhinga	iː ǃʰ iː n ɡ a
iqhude	iː ǃʰ uː d e
iqhwa	iː ǃʰ w a
iqhwabazi	iː ǃʰ w a ɓ aː z i
iqhwana	iː ǃʰ w aː n a
iqili	iː ǃ iː l i
iqiniso	iː ǃ i n iː s o
iqola	iː ǃ oː l a
iqoqo	iː ǃ oː ǃ o
iqwahhashi	iː ǃ w a ɦ aː ʃ i
iresiphi	iː r e s iː pʰ i
isabelo	i s a ɓ eː l o
isabizwana	i s a ɓ i z w aː n a
isala	i s aː l a
isalukazi	i s a l u ɠ aː z i
isambane	i s a m b aː n e
isanda	i s aː n d a
isandiso	i s a n d iː s o
isandla	i s aː n ɮ a
isando	i s aː n d o
isandu	i s aː n d u
isangoma	i s a n ɡ oː m a
isapha	iː s aː pʰ a
isebi	i s eː ɓ i
isele	iː s eː l e
isende	iː s eː n d e
isendwishi	iː s e n d w iː ʃ i
isenzo	i s eː n z o
ishaka	iː ʃ aː ɠ a
ishayina	iː ʃ a j iː n a
ishinga	iː ʃ iː n ɡ a
ishiya	iː ʃ iː j a
ishongololo	iː ʃ o n ɡ o l oː l o
ishumi	iː ʃ uː m i
ishwa	iː ʃ w a
isi	iː s i
isibabule	i s i ɓ a ɓ uː l e
isibaya	i s i ɓ aː j a
isibhakela	i s i b a ɠ eː l a
isibhaxelo	i s i b a ǁ eː l o
isibhedlela	i s i b e ɮ eː l a
isibhokodo	i s i b o ɠ oː d o
isibhoza	i s i b oː z a
isibhunu	i s i b uː n u
isibi	i s iː ɓ i
isibiba	i s i ɓ iː ɓ a
isibili	i s i ɓ iː l i
isibindi	i s i ɓ iː n d i
isibingelelo	i s i ɓ i n ɡ e l eː l o
isibomvu	i s i ɓ oː m v u
isibongo	i s i ɓ oː n ɡ o
isibungu	i s i ɓ uː n ɡ u
isibunu	i s i ɓ uː n u
isicathulo	i s i ǀ a tʰ uː l o
isicebi	i s i ǀ eː ɓ i
isicholo	i s i ǀʰ oː l o
isichotho	i s i ǀʰ oː tʰ o
isichwe	i s iː ǀʰ w e
isici	i s iː ǀ i
isicunulo	i s i ǀ u n uː l o
isidakwa	i s i d aː ɠ w a
isidididi	i s i d i d iː d i
isidingo	i s i d iː n ɡ o
isidla	i s iː ɮ a
isidleke	i s i ɮ eː ɠ e
isidlele	i s i ɮ eː l e
isidlo	i s iː ɮ o
isidlokolo	i s i ɮ o ɠ oː l o
isidula	i s i d uː l a
isidumbu	i s i d uː m b u
isidwaba	i s i d w aː ɓ a
isidwebo	i s i d w eː ɓ o
isifazane	i s i f a z aː n e
isifingqo	i s i f iː ǃʱ o
isifo	i s iː f o
isifuba	i s i f uː ɓ a
isifulentshi	i s i f u l eː ɲ t ʃ i
isifunda	i s i f uː n d a
isiga	i s iː ɡ a
isigcawu	i s i ǀʱ aː w u
isigcibisholo	i s i ǀʱ i ɓ i ʃ oː l o
isigcino	i s i ǀʱ iː n o
isigebengu	i s i ɡ e ɓ eː n ɡ u
isigedla	i s i ɡ eː ɮ a
isigedlekazi	i s i ɡ e ɮ e ɠ aː z i
isigege	i s i ɡ eː ɡ e
isigidi	i s i ɡ iː d i
isigidigidi	i s i ɡ i d i ɡ iː d i
isigigaba	i s i ɡ i ɡ aː ɓ a
isigingci	i s i ɡ iː ǀʱ i
isigodi	i s i ɡ oː d i
isigqi	i s iː ǃʱ i
isigqiki	i s i ǃʱ iː ɠ i
isigqila	i s i ǃʱ iː l a
isigqizo	i s i ǃʱ iː z o
isigqoko	i s i ǃʱ oː ɠ o
isigubhu	i s i ɡ uː b u
isigwaca	i s i ɡ w aː ǀ a
isigwadlulo	i s i ɡ w a ɮ uː l o
isigwayi	i s i ɡ w aː j i
isigwedlo	i s i ɡ w eː ɮ o
isigwegwe	i s i ɡ w eː ɡ w e
isigxobo	i s i ǁʱ oː ɓ o
isihla	i s iː ɬ a
isihlabathi	i s i ɬ a ɓ aː tʰ i
isihlahla	i s i ɬ aː ɬ a
isihlakaniphi	i s i ɬ a ɠ a n iː pʰ i
isihlalo	i s i ɬ aː l o
isihlangu	i s i ɬ aː n ɡ u
isihlanu	i s i ɬ aː n u
isihlelo	i s i ɬ eː l o
isihlephu	i s i ɬ eː pʰ u
isihlobo	i s i ɬ oː ɓ o
isihloko	i s i ɬ oː ɠ o
isihlungu	i s i ɬ uː n ɡ u
isijingi	i s i d ʒ iː n ɡ i
isijula	i s i d ʒ uː l a
isikebhe	i s i k eː b e
isikhala	i s i kʰ aː l a
isikhali	i s i kʰ aː l i
isikhashana	i s i kʰ a ʃ aː n a
isikhathi	i s i kʰ aː tʰ i
isikhindi	i s i kʰ iː n d i
isikhombisa	i s i kʰ o m b iː s a
isikhotha	i s i kʰ oː tʰ a
isikhulu	i s i kʰ uː l u
isikhumba	i s i kʰ uː m b a
isikhumbuzo	i s i kʰ u m b uː z o
isikhundla	i s i kʰ uː n ɮ a
isikhwama	i s i kʰ w aː m a
isikhwehlela	i s i kʰ w e ɬ eː l a
isikhwenene	i s i kʰ w e n eː n e
isikhwili	i s i kʰ w iː l i
isikole	i s i k oː l e
isikweleti	i s i k w e l eː t i
isikweletu	i s i k w e l eː t u
isikwenetu	i s i k w e n eː t u
isileti	i s i l eː t i
isilevu	i s i l eː v u
isilima	i s i l iː m a
isilisa	i s i l iː s a
isiliva	iː s i l iː v a
isilo	i s iː l o
isilonda	i s i l oː n d a
isilungu	i s i l uː n ɡ u
isilwane	i s i l w aː n e
isilwi	i s iː l w i
isimame	i s i mʱ aː mʱ e
isimangaliso	i s i m a n ɡ a l iː s o
isimba	iː s iː m b a
isimemo	i s i m eː m o
isimo	i s iː m o
isinci	i s iː ǀ i
isinciphiso	i s i ǀ i pʰ iː s o
isine	i s iː n e
isingane	i s i n ɡ aː n e
isingci	i s iː ǀʱ i
isingisi	i s i n ɡ iː s i
isinguni	i s i n ɡ uː n i
isinkwa	i s iː n k w a
isinkwe	i s iː n k w e
isinqe	i s iː ǃ e
isinqumo	i s i ǃ uː m o
isintu	i s iː n t u
isinxele	i s i ǁ eː l e
isinye	i s iː ɲ e
isinzima	i s i n z iː m a
isiphambano	i s i pʰ a m b aː n o
isiphapha	i s i pʰ aː pʰ a
isiphawulo	i s i pʰ a w uː l o
isiphethe	i s i pʰ eː tʰ e
isiphetho	i s i pʰ eː tʰ o
isiphika	i s i pʰ iː ɠ a
isipho	i s iː pʰ o
isiphukuphuku	i s i pʰ u ɠ u pʰ uː ɠ u
isiphundu	i s i pʰ uː n d u
isiphuzi	i s i pʰ uː z i
isipinashi	i s i p i n aː ʃ i
isipunu	i s i p uː n u
isiqalo	i s i ǃ aː l o
isiqephu	i s i ǃ eː pʰ u
isiqhaza	i s i ǃʰ aː z a
isiqhebeza	i s i ǃʰ e ɓ eː z a
isiqhephu	i s i ǃʰ eː pʰ u
isiqhimu	i s i ǃʰ iː m u
isiqhingana	i s i ǃʰ i n ɡ aː n a
isiqhingi	i s i ǃʰ iː n ɡ i
isiqimu	i s i ǃ iː m u
isiqinti	i s i ǃ iː n t i
isiqithi	i s i ǃ iː tʰ i
isiqopha	i s i ǃ oː pʰ a
isiqoqo	i s i ǃ oː ǃ o
isiquba	i s i ǃ uː ɓ a
isisebenzi	i s i s e ɓ eː n z i
isishayina	i s i ʃ a j iː n a
isishiyagalolunye	i s i ʃ i j a ɡ a l o l uː ɲ e
isishiyagalombili	i s i ʃ i j a ɡ a l o m b iː l i
isishuqulu	i s i ʃ u ǃ uː l u
isishushiso	i s i ʃ u ʃ iː s o
isisu	i s iː s u
isisuthu	i s i s uː tʰ u
isiswazi	i s i s w aː z i
isiswebhu	i s i s w eː b u
isitambu	i s i t aː m b u
isiteleka	i s i t e l eː ɠ a
isitha	iː s iː tʰ a
isithando	i s i tʰ aː n d o
isithandwa	i s i tʰ aː n d w a
isithathu	i s i tʰ aː tʰ u
isithelo	i s i tʰ eː l o
isithembiso	i s i tʰ e m b iː s o
isithixo	i s i tʰ iː ǁ o
isithole	i s i tʰ oː l e
isithombe	i s i tʰ oː m b e
isithunywa	i s i tʰ uː ɲ w a
isithupha	i s i tʰ uː pʰ a
isithutha	i s i tʰ uː tʰ a
isithuthuthu	i s i tʰ u tʰ uː tʰ u
isithwalambiza	i s i tʰ w a l a m b iː z a
isithwathwa	i s i tʰ w aː tʰ w a
isitimela	i s i t i m eː l a
isitini	i s i t iː n i
isitofu	i s i t oː f u
isitsha	i s iː t ʃ a
isitshalo	i s i t ʃ aː l o
isitshwana	i s i t ʃ w aː n a
isitswana	i s i t s w aː n a
isitulo	i s i t uː l o
isivalo	i s i v aː l o
isivande	i s i v aː n d e
isixaxa	i s i ǁ aː ǁ a
isixazululo	i s i ǁ a z u l uː l o
isixhosa	i s i ǁʰ oː s a
isixubho	i s i ǁ uː b o
isixuku	i s i ǁ uː ɠ u
isixula	i s i ǁ uː l a
isiziba	i s i z iː ɓ a
isizulu	i s i z uː l u
isizwe	i s iː z w e
iso	iː s o
isoka	iː s oː ɠ a
isondo	iː s oː n d o
isono	i s oː n o
isonto	iː s oː n t o
isosa	iː s oː s a
isu	iː s u
isundu	iː s uː n d u
iswazi	iː s w aː z i
itafula	iː t a f uː l a
ithambo	iː tʰ aː m b o
ithanga	iː tʰ aː n ɡ a
itheku	iː tʰ eː ɠ u
ithemba	iː tʰ eː m b a
ithikithi	iː tʰ i ɠ iː tʰ i
ithuba	iː tʰ uː ɓ a
ithumbu	iː tʰ uː m b u
ithunga	iː tʰ uː n ɡ a
ithusi	iː tʰ uː s i
ithwasa	iː tʰ w aː s a
itiye	iː t iː j e
itshe	iː t ʃ e
itshitshi	iː t ʃ iː t ʃ i
itswayi	iː t s w aː j i
iva	iː v a
ivaka	iː v aː ɠ a
ivesi	iː v eː s i
ivila	iː v iː l a
ivoti	iː v oː t i
ivukusi	iː v u ɠ uː s i
ivukuzi	iː v u ɠ uː z i
iwa	iː w a
iwayini	iː w a j iː n i
iwodi	iː w oː d i
ixhaphozi	iː ǁʰ a pʰ oː z i
ixhegu	iː ǁʰ eː ɡ u
ixhiba	iː ǁʰ iː ɓ a
ixhumela	iː ǁʰ u m eː l a
ixilongo	iː ǁ i l oː n ɡ o
ixolo	iː ǁ oː l o
ixoxo	iː ǁ oː ǁ o
ixuku	iː ǁ uː ɠ u
iyadi	iː j aː d i
iyezi	iː j eː z i
izaba	i z aː ɓ a
izabulo	i z a ɓ uː l o
izala	iː z aː l a
izambane	iː z a m b aː n e
izembe	iː z eː m b e
izigqoko	i z i ǃʱ ɔː ɠ o
izihlalo	i z i ɬ aː l o
iziko	iː z iː ɠ o
izimu	iː z iː m u
izinga	iː z iː n ɡ a
izinhloni	i z i n ɬ oː n i
izinkabi	i z i ŋ k aː ɓ i
izinkamba	i z i ŋ k aː m b a
izinsizwa	i z i n s iː z w a
izintini	i z i n t i n i
izintombi	i z i n t oː m b i
izinyo	iː z iː ɲ o
izipho	iː z iː pʰ o
izitha	iː z iː tʰ a
izolo	iː z oː l o
izu	iː z uː
izulu	iː z uː l u
izwamoya	iː z w a m oː j a
izwe	iː z w e
izwekazi	iː z w e ɠ aː z i
izwi	iː z w i
jana	d ʒ aː n a
kade	k aː d e
kahle	ɠ aː ɬ e
kahleni	ɠ a ɬ eː n i
kakhulu	ɠ a kʰ uː l u
kambe	k aː m b e
kanjani	ɠ a ɲ d ʒ aː n i
kanti	k a n t iː
kanye	ɠ aː ɲ e
ke	ɠ e
khama	kʰ aː m a
khiqiza	kʰ i ǃ iː z a
khona	kʰ oː n a
khulu	kʰ uː l u
khwehlela	kʰ w e ɬ eː l a
khweza	kʰ w eː z a
khwezela	kʰ w e z eː l a
kleza	k x eː z a
konje	k oː ɲ d ʒ e
kude	ɠ uː d e
kusasa	ɠ u s aː s a
kwazulu	ɠ w a z uː l u
kweleta	k w e l eː t a
la	l a
laba	l a ɓ a
labaya	l aː ɓ a j aː
labo	l aː ɓ o
lahla	l aː ɬ a
lala	l aː l a
lala kahle	l a l a ɠ aː ɬ e
lalani kahle	l a l a n i ɠ aː ɬ e
lapha	l aː pʰ a
lapho	l aː pʰ o
lawaya	l aː w a j aː
lawo	l aː w o
le	l e
leli	l e l i
leliya	l eː l i j aː
lelo	l eː l o
lenga	l eː n ɡ a
lesi	l e s i
lesiya	l eː s i j aː
leso	l eː s o
leyaya	l eː j a j aː
leyo	l eː j o
lezi	l e z i
leziya	l eː z i j aː
lezo	l eː z o
libala	l i ɓ aː l a
lo	l o
loba	l oː ɓ a
lobo	l oː ɓ o
lobu	l o ɓ u
lobuya	l oː ɓ u j aː
lokho	l oː kʰ o
lokhu	l o kʰ u
lokhuya	l oː kʰ u j aː
lolo	l oː l o
lolu	l o l u
loluya	l oː l u j aː
lona	l oː n a
lowaya	l oː w a j aː
lowo	l oː w o
luhlaza	l u ɬ aː z a
luma	l uː m a
lwa	l w a
maye	mʱ a jʱ eː
mema	m eː m a
mhla	m̩ ɬ a
mhlawumbe	m̩ ɬ a w uː m b e
mhlophe	m̩ ɬ oː pʰ e
mina	m iː n a
muntu	m uː n t u
musa	mʱ uː s a
na	n a
nakanjani	n a ɠ a ɲ d ʒ aː n i
namhlanje	n a m̩ ɬ aː ɲ d ʒ e
nceda	ǀ eː d a
ncedisa	ǀ e d iː s a
ncelisa	ǀ e l iː s a
ncibilika	ǀ i ɓ i l iː ɠ a
ncika	ǀ iː ɠ a
ncintisana	ǀ i n t i s aː n a
ncipha	ǀ iː pʰ a
nciphisa	ǀ i pʰ iː s a
ncokola	ǀ o ɠ oː l a
ndiza	n d iː z a
ngcola	ǀʱ oː l a
ngcolisa	ǀʱ o l iː s a
ngcwaba	ǀʱ w aː ɓ a
ngikhona	n ɡ i kʰ oː n a
ngiyabonga	n ɡ i j a ɓ oː n ɡ a
ngiyakuthanda	n ɡ i j a ɠ u tʰ aː n d a
ngiyaphila	n ɡ i j a pʰ iː l a
ngoba	n ɡ oː ɓ a
ngokuba	n ɡ o ɠ uː ɓ a
ngomuso	n ɡ o m uː s o
ngqongqoza	ǃʱ o ǃʱ oː z a
nihambe kahle	n i h a m b e ɠ aː ɬ e
nilale kahle	n i l a l e ɠ aː ɬ e
nina	n iː n a
ningi	n iː n ɡ i
nisale kahle	n i s a l e ɠ aː ɬ e
njalo	ɲ d ʒ aː l o
njani	ɲ d ʒ aː n i
nke	n k e
noma	n oː m a
nqaba	ǃ aː ɓ a
nqabela	ǃ a ɓ eː l a
nqaka	ǃ aː ɠ a
nqamuka	ǃ a m uː ɠ a
nqamula	ǃ a m uː l a
nqekuza	ǃ e ɠ uː z a
nqikaza	ǃ i ɠ aː z a
nqoba	ǃ oː ɓ a
nquma	ǃ uː m a
nqunu	ǃ uː n u
nqwabela	ǃ w a ɓ eː l a
nxa	ǁ aː
nxazonke	ǁ a z oː n k e
nxephepha	ǁ e pʰ eː pʰ a
nyakenye	ɲ a ɠ eː ɲ e
nyenyeza	ɲ e ɲ eː z a
oda	ʔ oː d a
phaka	pʰ aː ɠ a
phakathi	pʰ a ɠ aː tʰ i
phambili	pʰ a m b iː l i
phansi	pʰ aː n s i
phela	pʰ eː l a
phephisa	pʰ e pʰ iː s a
phesheya	pʰ e ʃ eː j a
phezolo	pʰ e z oː l o
phezu	pʰ eː z u
phezulu	pʰ e z uː l u
phinde	pʰ iː n d e
phola	pʰ oː l a
qabatheka	ǃ a ɓ a tʰ eː ɠ a
qabuka	ǃ a ɓ uː ɠ a
qabula	ǃ a ɓ uː l a
qagela	ǃ a ɡ eː l a
qala	ǃ aː l a
qalaza	ǃ a l aː z a
qamba	ǃ aː m b a
qamela	ǃ a m eː l a
qaphela	ǃ a pʰ eː l a
qaqa	ǃ aː ǃ a
qaqamba	ǃ a ǃ aː m b a
qatha	ǃ aː tʰ a
qathaka	ǃ a tʰ aː ɠ a
qeda	ǃ eː d a
qedakala	ǃ e d a ɠ aː l a
qede	ǃ eː d e
qeqebula	ǃ e ǃ e ɓ uː l a
qhakaza	ǃʰ a ɠ aː z a
qhamu	ǃʰ a m u
qhamuka	ǃʰ a m uː ɠ a
qhaqha	ǃʰ aː ǃʰ a
qhaqhazela	ǃʰ a ǃʰ a z eː l a
qhasha	ǃʰ aː ʃ a
qhathanisa	ǃʰ a tʰ a n iː s a
qhebeza	ǃʰ e ɓ eː z a
qhela	ǃʰ eː l a
qhelisa	ǃʰ e l iː s a
qhephuka	ǃʰ e pʰ uː ɠ a
qhesha	ǃʰ eː ʃ a
qhina	ǃʰ iː n a
qhiyama	ǃʰ i j aː m a
qhubeka	ǃʰ u ɓ eː ɠ a
qhuma	ǃʰ uː m a
qhutha	ǃʰ uː tʰ a
qhuthula	ǃʰ u tʰ uː l a
qhwaga	ǃʰ w aː ɡ a
qhwaya	ǃʰ w aː j a
qhweba	ǃʰ w eː ɓ a
qinisela	ǃ i n i s eː l a
qoba	ǃ oː ɓ a
qoka	ǃ oː ɠ a
qoma	ǃ oː m a
qomisa	ǃ o m iː s a
qonda	ǃ oː n d a
qondisa	ǃ o n d iː s a
qoqa	ǃ oː ǃ a
quba	ǃ uː ɓ a
quleka	ǃ u l eː ɠ a
qumba	ǃ uː m b a
qwasha	ǃ w aː ʃ a
qwashaza	ǃ w a ʃ aː z a
sala kahle	s a l a ɠ aː ɬ e
salani kahle	s a l a n i ɠ aː ɬ e
sanibona	s a n i ɓ oː n a
sanibonani	s a n i ɓ o n aː n i
sawubona	s a w u ɓ oː n a
sebenza	s e ɓ eː n z a
shaqa	ʃ aː ǃ a
shaqeka	ʃ a ǃ eː ɠ a
shwabana	ʃ w a ɓ aː n a
singa	s iː n ɡ a
soka	s oː ɠ a
sombu	s o m b u
sombuluka	s o m b u l uː ɠ a
sombulula	s o m b u l uː l a
sona	s oː n a
swaca	s w aː ǀ a
swakama	s w a ɠ aː m a
teleka	t e l eː ɠ a
thathu	tʰ aː tʰ u
thetha	tʰ eː tʰ a
thina	tʰ iː n a
thukuthela	tʰ u ɠ u tʰ eː l a
ubaba	u ɓ aː ɓ a
ubabekazi	u ɓ a ɓ e ɠ aː z i
ubala	uː ɓ aː l a
ubambo	uː ɓ aː m b o
ubani	u ɓ aː n i
ubasi	u ɓ aː s i
ubhadi	u b aː d i
ubhaka	u b aː ɠ a
ubhanana	u b a n aː n a
ubhavu	u b aː v u
ubhejane	u b e d ʒ aː n e
ubheseni	u b e s eː n i
ubhiya	u b iː j a
ubhiye	u b iː j e
ubhoko	uː b oː ɠ o
ubhontshisi	u b o ɲ t ʃ iː s i
ubhoshobana	u b o ʃ o ɓ aː n a
ubhova	u b oː v a
ubhozo	u b oː z o
ubhusha	u b uː ʃ a
ubisi	uː ɓ iː s i
ubolo	uː ɓ oː l o
ubomvu	uː ɓ oː m v u
uboya	u ɓ oː j a
ububanzi	u ɓ u ɓ aː n z i
ububhibhi	u ɓ u b iː b i
ububi	u ɓ uː ɓ i
ububomvu	u ɓ u ɓ oː m v u
ubuchopho	u ɓ u ǀʰ oː pʰ o
ubuciko	u ɓ u ǀ iː ɠ o
ubudala	u ɓ u d aː l a
ubude	u ɓ uː d e
ubudlelwane	u ɓ u ɮ e l w aː n e
ubudoda	u ɓ u d oː d a
ubugqila	u ɓ u ǃʱ iː l a
ubugwala	u ɓ u ɡ w aː l a
ubuhlalu	u ɓ u ɬ aː l u
ubuhlanya	u ɓ u ɬ aː ɲ a
ubuhle	u ɓ uː ɬ e
ubuhleli	u ɓ u ɬ eː l i
ubuhlobo	u ɓ u ɬ oː ɓ o
ubuhlungu	u ɓ u ɬ uː n ɡ u
ubukhali	u ɓ u kʰ aː l i
ubukhosazana	u ɓ u kʰ o s a z aː n a
ubukhosikazi	u ɓ u kʰ o s i ɠ aː z i
ubukhulu	u ɓ u kʰ uː l u
ubuluhlaza	u ɓ u l u ɬ aː z a
ubumhlophe	u ɓ u m̩ ɬ oː pʰ e
ubumnene	u ɓ u m̩ n eː n e
ubumnyama	u ɓ u m̩ ɲ aː m a
ubumpi	u ɓ uː m p i
ubumpofu	u ɓ u m p oː f u
ubumpohlo	u ɓ u m p oː ɬ o
ubumtoti	u ɓ u m̩ t oː t i
ubuncane	u ɓ u ǀ aː n e
ubundlalifa	u ɓ u n ɮ a l iː f a
ubungane	u ɓ u n ɡ aː n e
ubungcono	u ɓ u ǀʱ oː n o
ubungqa	u ɓ uː ǃʱ a
ubungqo	u ɓ uː ǃʱ o
ubungqolokosho	u ɓ u ǃʱ o l o ɠ oː ʃ o
ubuningi	u ɓ u n iː n ɡ i
ubunjani	u ɓ u ɲ d ʒ aː n i
ubunqunu	u ɓ u ǃ uː n u
ubunsomi	u ɓ u n s oː m i
ubuntu	u ɓ uː n t u
ubuntwana	u ɓ u n t w aː n a
ubunxele	u ɓ u ǁ eː l e
ubunyakanyaka	u ɓ u ɲ a ɠ a ɲ aː ɠ a
ubunye	u ɓ uː ɲ e
ubuphansi	u ɓ u pʰ aː n s i
ubuqhawe	u ɓ u ǃʰ aː w e
ubuqotho	u ɓ u ǃ oː tʰ o
ubusha	u ɓ uː ʃ a
ubusika	u ɓ u s iː ɠ a
ubuso	u ɓ uː s o
ubusuku	u ɓ u s uː ɠ u
ubutha	u ɓ uː tʰ a
ubuthakathaka	u ɓ u tʰ a ɠ a tʰ aː ɠ a
ubuthi	u ɓ uː tʰ i
ubuthuntu	u ɓ u tʰ uː n t u
ubuthutha	u ɓ u tʰ uː tʰ a
ubuvaka	u ɓ u v aː ɠ a
ubuvila	u ɓ u v iː l a
ubuxhegu	u ɓ u ǁʰ eː ɡ u
ubuzimu	u ɓ u z iː m u
ubuzwe	u ɓ uː z w e
uchakide	u ǀʰ a ɠ iː d e
ucingo	uː ǀ iː n ɡ o
ucwecwe	uː ǀ w eː ǀ w e
udaba	uː d aː ɓ a
udaka	uː d aː ɠ a
udlame	uː ɮ aː m e
udlawu	uː ɮ aː w u
udokotela	u d o ɠ o t eː l a
udoli	u d oː l i
udondolo	uː d o n d oː l o
udonga	uː d oː n ɡ a
udoti	u d oː t i
udwi	u d w iː
ufezela	u f e z eː l a
ufu	uː f u
ufudu	uː f uː d u
ugadi	u ɡ aː d i
ugalo	uː ɡ aː l o
ugamthilini	u ɡ a m tʰ i l iː n i
uganandela	u ɡ a n a n d eː l a
ugazi	uː ɡ aː z i
ugesi	u ɡ eː s i
ugigi	u ɡ iː ɡ i
ugogo	u ɡ oː ɡ o
ugologo	u ɡ o l oː ɡ o
ugqozi	uː ǃʱ oː z i
ugu	uː ɡ u
ugwadule	uː ɡ w a d uː l e
ugwava	u ɡ w aː v a
ugwayi	u ɡ w aː j i
ugxa	uː ǁʱ a
uhabhu	uː h aː b u
uhambe kahle	u h a m b e ɠ aː ɬ e
uhambo	uː h aː m b o
uhele	uː h eː l e
uhhafu	u ɦ aː f u
uhla	uː ɬ a
uhlaka	uː ɬ aː ɠ a
uhlamvu	uː ɬ aː m v u
uhlangothi	uː ɬ a n ɡ oː tʰ i
uhlanya	uː ɬ aː ɲ a
uhlaza	uː ɬ aː z a
uhleko	uː ɬ eː ɠ o
uhlelo	uː ɬ eː l o
uhlobo	uː ɬ oː ɓ o
uhlu	uː ɬ u
uhulumeni	u h u l u m eː n i
ujamu	u d ʒ aː m u
ujehova	u d ʒ e h oː v a
ujeke	u d ʒ eː ɠ e
ujele	u d ʒ eː l e
ujesu	u d ʒ eː s u
ujinja	u d ʒ iː ɲ d ʒ a
uju	uː d ʒ u
ujusi	u d ʒ uː s i
ukhali	u kʰ aː l i
ukhamba	uː kʰ aː m b a
ukhetho	uː kʰ eː tʰ o
ukhisimusi	u kʰ i s i m uː s i
ukhokho	u kʰ oː kʰ o
ukholwase	u kʰ o l w aː s e
ukhongolose	u kʰ o n ɡ o l oː s e
ukhonkolo	u kʰ o n k oː l o
ukhophe	uː kʰ oː pʰ e
ukhozi	uː kʰ oː z i
ukhuni	uː kʰ uː n i
ukhwathu	uː kʰ w aː tʰ u
ukhweshe	uː kʰ w eː ʃ e
ukoko	u k oː k o
ukotini	u k o t iː n i
ukubulala	u ɠ u ɓ u l aː l a
ukucwila	u ɠ u ǀ w iː l a
ukudla	u ɠ uː ɮ a
ukudoba	u ɠ u d oː ɓ a
ukudweba	u ɠ u d w eː ɓ a
ukufa	u ɠ uː f a
ukugeza	u ɠ u ɡ eː z a
ukugqwala	u ɠ u ǃʱ w aː l a
ukugula	u ɠ u ɡ uː l a
ukugxeka	u ɠ u ǁʱ eː ɠ a
ukuhlamba	u ɠ u ɬ aː m b a
ukuhlikihla	u ɠ u ɬ i ɠ iː ɬ a
ukuhlwa	u ɠ uː ɬ w a
ukukhanya	u ɠ u kʰ aː ɲ a
ukulwa	u ɠ uː l w a
ukuma	u ɠ uː m a
ukumangala	u ɠ u m a n ɡ aː l a
ukuna	u ɠ uː n a
ukuncoma	u ɠ u ǀ oː m a
ukunene	u ɠ u n eː n e
ukungcola	u ɠ u ǀʱ oː l a
ukungenisa	u ɠ u n ɡ e n iː s a
ukungqubuzana	u ɠ u ǃʱ u ɓ u z aː n a
ukunqoba	u ɠ u ǃ oː ɓ a
ukunto	u ɠ uː n t o
ukuntshontsha	u ɠ u ɲ t ʃ oː ɲ t ʃ a
ukunxele	u ɠ u ǁ eː l e
ukunyenyeza	u ɠ u ɲ e ɲ eː z a
ukupela	u ɠ u p eː l a
ukupheka	u ɠ u pʰ eː ɠ a
ukuphela	u ɠ u pʰ eː l a
ukuphoqa	u ɠ u pʰ oː ǃ a
ukuphutha	u ɠ u pʰ uː tʰ a
ukuqala	u ɠ u ǃ aː l a
ukuqaphela	u ɠ u ǃ a pʰ eː l a
ukuqhuma	u ɠ u ǃʰ uː m a
ukuqoma	u ɠ u ǃ oː m a
ukusa	u ɠ uː s a
ukushisa	u ɠ u ʃ iː s a
ukuthula	u ɠ u tʰ uː l a
ukuze	u ɠ uː z e
ukuzibulala	u ɠ u z i ɓ u l aː l a
ukuzigqaja	u ɠ u z i ǃʱ aː d ʒ a
ukwi	uː k w i
ukwindla	u ɠ w iː n ɮ a
ulale kahle	u l a l e ɠ aː ɬ e
uletisi	u l e t iː s i
ulimi	uː l iː m i
ulwandle	uː l w aː n ɮ e
ulwazi	uː l w aː z i
ulwesibili	u l w e s i ɓ iː l i
ulwesihlanu	u l w e s i ɬ aː n u
ulwesine	u l w e s iː n e
ulwesithathu	u l w e s i tʰ aː tʰ u
ulwezi	uː l w eː z i
uma	uː m a
umabelo	u m a ɓ eː l o
umabi	u m aː ɓ i
umabo	u m aː ɓ o
umafikazisina	u m a f i ɠ a z i s iː n a
umakhelwane	u m a kʰ e l w aː n e
umakhi	u m aː kʰ i
umalukazi	u m a l u ɠ aː z i
umalume	u m a l uː m e
umama	u mʱ aː m a
umame	u m aː m e
umandulo	u m a n d uː l o
umaquba	u m a ǃ uː ɓ a
umashiqela	u m a ʃ i ǃ eː l a
umasingana	u m a s i n ɡ aː n a
umata	u m aː t a
umbala	u m̩ ɓ aː l a
umbaso	u m̩ ɓ aː s o
umbayimbayi	u m b a j i m b aː j i
umbhali	u m̩ b aː l i
umbhalo	u m̩ b aː l o
umbhede	u m̩ b eː d e
umbhicongo	u m̩ b i ǀ oː n ɡ o
umbhidli	u m̩ b iː ɮ i
umbhubhudlo	u m̩ b u b uː ɮ o
umbiko	u m̩ ɓ iː ɠ o
umboko	u m̩ ɓ oː ɠ o
umbombo	u m̩ ɓ oː m b o
umbono	u m̩ ɓ oː n o
umbulali	u m̩ ɓ u l aː l i
umcebo	u m̩ ǀ eː ɓ o
umcubungulo	u m̩ ǀ u ɓ u n ɡ uː l o
umculo	u m̩ ǀ uː l o
umcwaningi	u m̩ ǀ w a n iː n ɡ i
umcwebo	u m̩ ǀ w eː ɓ o
umdabu	u m̩ d aː ɓ u
umdanso	u m̩ d aː n s o
umdidi	u m̩ d iː d i
umdlali	u m̩ ɮ aː l i
umdlalo	u m̩ ɮ aː l o
umdlwenguli	u m̩ ɮ w e n ɡ uː l i
umduzu	u m̩ d uː z u
umdwebo	u m̩ d w eː ɓ o
umdweshu	u m̩ d w eː ʃ u
umebo	u m eː ɓ o
umelusi	u m e l uː s i
umendo	u m eː n d o
umenzi	u m eː n z i
umese	u mʱ eː s e
umfana	u m̩ f aː n a
umfanyana	u m̩ f a ɲ aː n a
umfazi	u m̩ f aː z i
umfelokazi	u m̩ f e l o ɠ aː z i
umfino	u m̩ f iː n o
umfokazana	u m̩ f o ɠ a z aː n a
umfokazi	u m̩ f o ɠ aː z i
umfudlana	u m̩ f u ɮ aː n a
umfula	u m̩ f uː l a
umfumfu	u m f uː m f u
umfundi	u m̩ f uː n d i
umfundisi	u m̩ f u n d iː s i
umgankla	u m̩ ɡ aː n k l a
umganu	u m̩ ɡ aː n u
umgcagco	u m̩ ǀʱ aː ǀʱ o
umgede	u m̩ ɡ eː d e
umgibeli	u m̩ ɡ i ɓ eː l i
umgodi	u m̩ ɡ oː d i
umgqibelo	u m̩ ǃʱ i ɓ eː l o
umgqomo	u m ǃʱ oː m o
umgqulo	u m̩ ǃʱ uː l o
umgungundlovu	u m̩ ɡ u n ɡ u n ɮ oː v u
umgwamanda	u m̩ ɡ w a m aː n d a
umgwaqana	u m̩ ɡ w a ǃ aː n a
umgwaqo	u m̩ ɡ w aː ǃ o
umgwebi	u m̩ ɡ w eː ɓ i
umgwenya	u m̩ ɡ w eː ɲ a
umgxala	u m̩ ǁʱ aː l a
umhlaba	u m̩ ɬ aː ɓ a
umhlabathi	u m̩ ɬ a ɓ aː tʰ i
umhlane	u m̩ ɬ aː n e
umhlanga	u m̩ ɬ aː n ɡ a
umhlangano	u m̩ ɬ a n ɡ aː n o
umhlaza	u m̩ ɬ aː z a
umhleli	u m̩ ɬ eː l i
umhlengi	u m̩ ɬ eː n ɡ i
umhlobo	u m̩ ɬ oː ɓ o
umhlophe	u m̩ ɬ oː pʰ e
umhlophekazi	u m̩ ɬ o pʰ e ɠ aː z i
umhlukazi	u m̩ ɬ u ɠ aː z i
umhluzi	u m̩ ɬ uː z i
umhlwazi	u m̩ ɬ w aː z i
umhuzulo	u m̩ h u z uː l o
umhwebi	u m̩ h w eː ɓ i
umhwebo	u m̩ h w eː ɓ o
umisi	u m iː s i
umjaho	u m̩ d ʒ aː h o
umjondolo	u m̩ d ʒ o n d oː l o
umjovo	u m̩ d ʒ oː v o
umkhabo	u m̩ kʰ aː ɓ o
umkhathi	u m̩ kʰ aː tʰ i
umkhawulo	u m̩ kʰ a w uː l o
umkhaya	u m̩ kʰ aː j a
umkhemese	u m kʰ e m eː s e
umkhetho	u m̩ kʰ eː tʰ o
umkhomazi	u m̩ kʰ o m aː z i
umkhombo	u m̩ kʰ oː m b o
umkhomo	u m̩ kʰ oː m o
umkhono	u m̩ kʰ oː n o
umkhonto	u m̩ kʰ oː n t o
umkhuba	u m̩ kʰ uː ɓ a
umkhulu	u m̩ kʰ uː l u
umkhumbi	u m̩ kʰ uː m b i
umkhwekazi	u m̩ kʰ w e ɠ aː z i
umkhwenyana	u m̩ kʰ w e ɲ aː n a
umklomelo	u m̩ k x o m eː l o
umlambo	u m̩ l aː m b o
umlamu	u m̩ l aː m u
umlenze	u m̩ l eː n z e
umlilo	u m̩ l iː l o
umlisa	u m̩ l iː s a
umlobokazi	u m̩ l o ɓ o ɠ aː z i
umlomo	u m̩ l oː m o
umlotha	u m̩ l oː tʰ a
umlungu	u m̩ l uː n ɡ u
ummbila	u m̩ m b iː l a
ummese	u m̩ m eː s e
umncintiswano	u m̩ ǀ i n t i s w aː n o
umndeni	u m̩ n d eː n i
umngane	u m̩ n ɡ aː n e
umngcwabo	u m̩ ǀʱ w aː ɓ o
umngqithi	u m̩ ǃʱ iː tʰ i
umngquphane	u m̩ ǃʱ u pʰ aː n e
umnguni	u m̩ n ɡ uː n i
umnqobi	u m ǃ oː ɓ i
umnqumo	u m̩ ǃ uː m o
umntwana	u m̩ n t w aː n a
umnyama	u m̩ ɲ aː m a
umnyango	u m̩ ɲ aː n ɡ o
umnyelele	u m̩ ɲ e l eː l e
umoba	u m oː ɓ a
umona	u m oː n a
umoya	u m oː j a
umpetshisi	u m̩ p e t ʃ iː s i
umphakathi	u m̩ pʰ a ɠ aː tʰ i
umphako	u m̩ pʰ aː ɠ o
umphambili	u m̩ pʰ a m b iː l i
umphansi	u m̩ pʰ aː n s i
umphefumulo	u m̩ pʰ e f u m uː l o
umpheki	u m̩ pʰ eː ɠ i
umphimbo	u m̩ pʰ iː m b o
umphumela	u m̩ pʰ u m eː l a
umqala	u m̩ ǃ aː l a
umqali	u m̩ ǃ aː l i
umqamelo	u m̩ ǃ a m eː l o
umqhele	u m̩ ǃʰ eː l e
umqolo	u m̩ ǃ oː l o
umqondo	u m̩ ǃ oː n d o
umqophi	u m̩ ǃ oː pʰ i
umqotho	u m̩ ǃ oː tʰ o
umquba	u m̩ ǃ uː ɓ a
umqwakuza	u m̩ ǃ w a ɠ uː z a
umsebenzi	u m̩ s e ɓ eː n z i
umsebenzisi	u m̩ s e ɓ e n z iː s i
umshado	u m̩ ʃ aː d o
umshana	u m̩ ʃ aː n a
umshini	u m̩ ʃ iː n i
umshiya	u m̩ ʃ iː j a
umshumayeli	u m̩ ʃ u m a j eː l i
umshushisi	u m̩ ʃ u ʃ iː s i
umshushiso	u m̩ ʃ u ʃ iː s o
umshwana	u m̩ ʃ w aː n a
umsila	u m̩ s iː l a
umsindo	u m̩ s iː n d o
umsombuluko	u m̩ s o m b u l uː ɠ o
umsuka	u m̩ s uː ɠ a
umsundu	u m̩ s uː n d u
umsuthu	u m̩ s uː tʰ u
umswakama	u m̩ s w a ɠ aː m a
umtata	u m̩ t aː t a
umthambo	u m̩ tʰ aː m b o
umthamo	u m̩ tʰ aː m o
umthandi	u m̩ tʰ aː n d i
umthembu	u m̩ tʰ eː m b u
umthetho	u m̩ tʰ eː tʰ o
umthofu	u m̩ tʰ oː f u
umthombo	u m̩ tʰ oː m b o
umthunzi	u m̩ tʰ uː n z i
umthuqu	u m̩ tʰ uː ǃ u
umthwalo	u m tʰ w aː l o
umtoti	u m̩ t oː t i
umtshwana	u m̩ t ʃ w aː n a
umtswana	u m̩ t s w aː n a
umtube	u m̩ t uː ɓ e
umudwa	u m uː d w a
umufi	u m uː f i
umufo	u m uː f o
umuga	u m uː ɡ a
umugqa	u m uː ǃʱ a
umuhla	u m uː ɬ a
umuhlwa	u m uː ɬ w a
umukhwa	u m uː kʰ w a
umukhwe	u m uː kʰ w e
umumba	u m uː m b a
umumbi	u m uː m b i
umumo	u m uː m o
umunca	uː m uː ǀ a
umunqa	u m uː ǃ a
umunswi	u m uː n s w i
umuntu	u m uː n t u
umuntu ngumuntu ngabantu	u m u n t u n ɡ u m u n t u n ɡ a ɓ aː n t u
umunwe	u m uː n w e
umunyu	u m uː ɲ u
umusa	u m uː s a
umusho	u m uː ʃ o
umusi	u m uː s i
umuso	u m uː s o
umuthi	u m uː tʰ i
umuthwa	u m uː tʰ w a
umuva	u m uː v a
umuvi	u m uː v i
umuwa	u m uː w a
umuzi	u m uː z i
umuzwa	u m uː z w a
umvimba	u m̩ v iː m b a
umvingqi	u m v iː ǃʱ i
umvithi	u m̩ v iː tʰ i
umvoti	u m̩ v oː t i
umvubu	u m̩ v uː ɓ u
umvundla	u m̩ v uː n ɮ a
umvuno	u m̩ v uː n o
umvuzi	u m̩ v uː z i
umvuzo	u m̩ v uː z o
umxhapho	u m̩ ǁʰ aː pʰ o
umxhosa	u m̩ ǁʰ oː s a
umyeni	u m̩ j eː n i
umzala	u m̩ z aː l a
umzali	u m̩ z aː l i
umzamo	u m̩ z aː m o
umzekelo	u m̩ z e ɠ eː l o
umzimba	u m̩ z iː m b a
umzingeli	u m̩ z i n ɡ eː l i
umzukulu	u m̩ z u ɠ uː l u
umzulu	u m̩ z uː l u
umzuzu	u m̩ z uː z u
umzuzwana	u m̩ z u z w aː n a
uncedo	uː ǀ eː d o
uncibijane	u ǀ i ɓ i d ʒ aː n e
uncwaba	u ǀ w aː ɓ a
undasa	u n d aː s a
unesi	u n eː s i
ungcede	u ǀʱ eː d e
ungqi	uː ǃʱ i
ungqo	uː ǃʱ o
ungqongqoshe	u ǃʱ o ǃʱ oː ʃ e
ungulazibuya	u n ɡ u l a z i ɓ uː j a
ungwaqa	u n ɡ w aː ǃ a
unhlaba	u n ɬ aː ɓ a
unhlangula	u n ɬ a n ɡ uː l a
unhlangulana	u n ɬ a n ɡ u l aː n a
unhlolanja	u n ɬ o l aː ɲ d ʒ a
unina	u n iː n a
unkamisa	u n k a m iː s a
unkulunkulu	u n k u l u n k uː l u
unobhala	u n o b aː l a
unogwaja	u n o ɡ w aː d ʒ a
unohha	u nʱ oː ɦ a
unondwebu	u n o n d w eː ɓ u
unqangi	u ǃ aː n ɡ i
unswinswinswi	u n s w i n s w iː n s w i
untulikazi	u n t u l i ɠ aː z i
unwabu	uː n w aː ɓ u
unwele	uː n w eː l e
unya	uː ɲ a
unyaka	u ɲ aː ɠ a
unyawo	uː ɲ aː w o
unyelele	uː ɲ e l eː l e
unyembezi	uː ɲ e m b eː z i
unyezi	u ɲ eː z i
unyoko	u ɲ oː ɠ o
unzo	u n z oː
unzoqhwishi	u n z oː ǃʰ w iː ʃ i
upende	u p eː n d e
uphahla	uː pʰ aː ɬ a
uphaphe	uː pʰ aː pʰ e
uphayinaphu	u pʰ a j i n aː pʰ u
uphepha	u pʰ eː pʰ a
uphephela	u pʰ e pʰ eː l a
uphondo	uː pʰ oː n d o
uqhezu	uː ǃʰ eː z u
uqhoqhoqho	u ǃʰ o ǃʰ oː ǃʰ o
uqhwishi	u ǃʰ w iː ʃ i
uqobo	uː ǃ oː ɓ o
usale kahle	u s a l e ɠ aː ɬ e
usana	uː s aː n a
usapho	uː s aː pʰ o
usawoti	u s a w oː t i
usepthemba	u s e p tʰ eː m b a
ushaka	u ʃ aː ɠ a
ushizi	u ʃ iː z i
ushukela	u ʃ u ɠ eː l a
usiba	uː s iː ɓ a
usogekle	u s o ɡ eː k x e
usuku	uː s uː ɠ u
utamatisi	u t a m a t iː s i
uthando	uː tʰ aː n d o
uthi	uː tʰ i
uthuli	uː tʰ uː l i
utshana	u t ʃ aː n a
utshani	u t ʃ aː n i
utshwala	u t ʃ w aː l a
uvalo	uː v aː l o
uve	uː v e
uvolo	u v oː l o
uweta	u w eː t a
uxamu	u ǁ aː m u
uxolo	uː ǁ oː l o
uyihlo	u j iː ɬ o
uyise	u j iː s e
uzamcolo	u z a m̩ ǀ oː l o
uzekamanzi	u z e ɠ a m aː n z i
uzibandlela	u z i ɓ a n ɮ eː l a
uzibuthe	u z i ɓ uː tʰ e
uzipho	uː z iː pʰ o
uzulu	u z uː l u
vuya	v uː j a
wena	w eː n a
wololo	w o l o l oː
wona	w oː n a
xega	ǁ eː ɡ a
xegisa	ǁ e ɡ iː s a
xhapha	ǁʰ aː pʰ a
xhasa	ǁʰ aː s a
xhuga	ǁʰ uː ɡ a
xhuma	ǁʰ uː m a
xokozela	ǁ o ɠ o z eː l a
xola	ǁ oː l a
xoxa	ǁ oː ǁ a
xuba	ǁ uː ɓ a
xubana	ǁ u ɓ aː n a
xubha	ǁ uː b a
xwaya	ǁ w aː j a
xwayisa	ǁ w a j iː s a
yebo	jʱ eː ɓ o
yeka	j eː ɠ a
yena	j eː n a
yona	j oː n a
za	z a
zala	z aː l a
ze	z e
zona	z oː n a
