'll	ʊ BA
accend	æ AM k AC s AJ ɛ AM n AG d AC
accommodate	ə AM kʰ AD ɒ BA m AF ə AM d AC e AM ɪ AM t AC
accommodator	ə AM k AC ɒ BA m AF ə AM d AC e AM ɪ AM t AC ə AM
accreditation	ə AM k AC ɹ AB ɛ AM d AC ɪ AM t AC e AM ɪ AM ʃ AJ ə AM n AG
accuracy	æ AM k AC j AB ʊ BA r BD ə AM s AJ ɪ AM
acidophilus	æ AM s AJ ɪ AM d AC ɑ AM f BE ɪ AM l AE ə AM s AJ
adam	æ AM ɾ BI ə AM m AF
added	æ AM ɾ BI ɪ AM d AC
adelaide	æ AM d AC ɜ AM l AE æ AM ɪ̯ AB d AC
administrative	ə AM d AC m AF ɪ AM n AG ɪ AM s AJ t̠ AC ɹ̠̊ʷ ə AM tʰ AD ɪ AM v BE
aerose	i AM ɹ AB ə AM ʊ BA z AJ
agglutinin	ə AM ɡ AC l AE uː BB ʔ AL n̩ BM ɪ AM n AG
alacrity	ə AM l AE æ AM k AC ɹ AB ɨ AM t AC i AM
alban	a AM l AE b AH n̩ BM
albicant	a AM l AE b AH ɪ AM k AC n̩ BM t AC
alder	ɔː BB l AE d AC ə AM
alders	ɔː BB l AE d AC ə AM z AJ
alienation	e AM ɪ AM l AE i AM ə AM n AG e AM ɪ AM ʃ AJ ə AM n AG
alignment	ə AM ɫ AE a AM ɪ AM n AG m AF ə AM n AG t AC
allergic	ə AM l AE ɚ AM d AC ʒ AJ ɪ AM k AC
allergies	æ AM l AE ɚ AM d AC ʒ AJ i AM z AJ
allergy	æ AM l AE ɚ AM d AC ʒ AJ i AM
almanac	ɔː BB l AE m AF ə AM n AG æ AM k AC
alpha	æ AM ɫ AE f BE ə AM
alternately	ɔː BB l AE t AC ɜ AM ɹ AB n AG ə AM t AC l AE ɪ AM
am	æ AM m AF
amazing	ə AM m AF e AM ɪ̯ AB z AJ ɪ AM ŋ AG
amphibious	æ AM m AF f BE ɪ AM b AH i AM ə AM s AJ
analects	æ AM n AG ə AM l AE ɛ AM k AC t AC s AJ
andrew	æ AM n AG d AC ʒ AJ ɹ AB ʊ̈ BA u BA
angst	e AM ɪ AM ŋ AG k AC s AJ t AC
angsts	e AM ɪ AM ŋ AG k AC s AJ t AC s AJ
anthropomorphic	æ̃ BJ n̪ AG θ AJ ɹ̠ ə AM p AH ə AM m AF ɔ BA ɹ̠ f BE ɪ̈ AM k AC
apple	æ AM p AH ɫ̩
appled	æ AM p AH ɫ̩ d AC
arbitration	ɑː AN b AH ə AM t̠ AC ɹ̠ e AM ɪ AM ʃ AJ n̩ BM
aristotle	æ AM r BD ɪ AM s AJ t AC ɒ BA t AC ɫ̩
arlon	ɑː AN ɫ AE ɔː BB n AG
article	ɑː AN tʰ AD ɪ AM kʰ AD ə AM ɫ AE
atend	ə AM tʰ AD ɛ AM n AG d AC
attack	ə AM tʰ AD æ AM k AC
attar	æ AM t AC ə AM
attend	ə AM tʰ AD ɛ AM n AG d AC
attic	æ AM ɾ BI ɪ AM k AC
attraction	ə AM t AC ʃ AJ ɹ AB æ AM k AC ʃ AJ ɪ̈ AM n AG
attrition	ə AM t AC ɹ AB ɪ AM ʃ AJ ə AM n AG
augustan	ɔː BB ɡ AC ʌ AM s AJ t AC n̩ BM
aula	ɔː BB l AE a AM
availability	ə AM v BE e AM ɪ AM l AE ə AM b AH ɪ AM l AE ɪ AM t AC ɪ AM
awara	ɒ BA w AK ʌ AM ɹ AB ʌ AM
ayuh	ˀe ɪ AM ʌˀ
baa	b AH ɑː AN
babbler	b AH æ AM b AH ə AM l AE ə AM ɹ AB
back	b AH æ AM k AC
bacterial	b AH æ AM k AC t AC ɪ AM ə AM ɹ AB i AM ə AM ɫ AE
baedeker	b AH e AM ɪ AM d AC ɪ AM k AC ə AM
bagful	b AH æ AM ɡ AC f BE ʊ BA ɫ AE
baikal	b AH a AM ɪ AM k AC ɑː AN ɫ AE
bail	b AH e AM ɪ̯ AB ə AM ɫ AE
balancelle	b AH æ AM l AE ə AM n AG s AJ e AM ɫ AE
bald	b AH ɔː BB ɫ AE d AC
baldric	b AH ɔː BB ɫ AE d AC ɹ AB ɪ AM k AC
bale	b AH e AM ɪ̯ AB ə AM ɫ AE
balrog	b AH ɔː BB ɫ AE ɹ AB ɒ BA ɡ AC
balt	b AH ɔː BB l AE t AC
barn	b AH ɒ BA ə AM n AG
barrel	b AH æ AM ɹ AB ə AM ɫ AE
basal	b AH e AM ɪ AM s AJ ə AM ɫ AE
bashful	b AH æ AM ʃ AJ f BE ʊ BA ɫ AE
bashkortostan	b AH a AM ʃ AJ k AC o̞ː BB ɹ AB t AC ə AM ʉ̯ s AJ t AC æ AM n AG
bastille	b AH æ AM s AJ t AC ɪ AM ə AM ɫ AE
bath	b AH ɑː AN θ AJ
battle	b AH a AM tʰ AD ɫ̩
battlebus	b AH æ AM t AC ə AM ɫ AE b AH ʌ AM s AJ
battlement	b AH æ AM t AC ə AM ɫ AE m AF ə AM n AG t AC
bauble	b AH ɔː BB b AH ə AM ɫ AE
baulk	b AH ɔː BB ɫ AE k AC
bautzen	b AH a AM ʊ BA t AC s AJ ə AM n AG
bawl	b AH ɔː BB ɫ AE
beadle	b AH iː AN d AC ə AM ɫ AE
beagle	b AH iː AN ɡ AC ə AM ɫ AE
beared	b AH ɛː AN d AC
beatle	b AH iː AN t AC ə AM ɫ AE
beauty	b AH j AB u BA ɾ BI i AM
beazle	b AH iː AN z AJ ə AM ɫ AE
becquerel	b AH ɛ AM k AC ə AM ɹ AB ɛ AM ɫ AE
bedevil	b AH ɪ AM d AC ɛ AM v BE ə AM ɫ AE
bedight	b AH ɪ AM d AC ʌ AM ɪ AM t AC
beetle	b AH i AM ɾ BI ə AM ɫ AE
befang	b AH ə AM f BE æ AM ŋ AG
better	b AH ɛ AM tʰ AD ə AM
betther	b AH ɛ AM t̪ AC ɚ AM
betting	b AH ɛ AM ɾ BI ɪ AM ŋ AG
bidet	b AH iː AN d AC e AM ɪ AM
bill	b AH ɪ AM ɫ AE
bitey	b AH a AM ɪ̯ AB ɾ BI i AM
bitter	b AH ɪ AM ʔ AL ə AM
bitty	b AH ɪ AM ɾ BI i AM
blem	b AH l AE ɛ AM m AF
blicky	b AH l AE ɪ AM k AC i AM
bockety	b AH ɑ AM k AC ə AM t AC iː AN
bold	b AH ɒ BA ʊ BA l AE d AC
boldly	b AH ɒ BA ʊ BA l AE d AC l AE i AM
bookcase	b AH ʊ BA kː BG e AM ɪ AM s AJ
boot	b AH uː BB t AC
botanist	b AH ɒ BA t AC n̩ BM ɪ AM s AJ t AC
bother	b AH ɒ BA ð AJ ə AM ɹ AB
bottle	b AH ɒ BA t AC ɫ̩
bountiful	b AH a AM ʊ̯ AK n AG ɾ BI ə AM f BE ə AM ɫ AE
boutye	b AH ɐ BA ʏ BA t AC ʃ AJ ə AM
bowl	b AH ɔ BA ʊ BA ɫ AE
bowling	b AH ɒ BA ʊ BA ɫ AE ɪ AM ŋ AG
brakeforce	b AH ɹ AB e AM ɪ AM k AC f BE ɔː BB ɹ AB s AJ
breach	b AH ɹ AB iː AN t AC ʃ AJ
break	b AH ɹʷ e AM ɪ̯ AB k AC
brighton	b AH ɹ AB a AM ɪ̯ AB ʔ AL ə AM n AG
british	b AH ɹ AB ɪ AM ʔ AL ɪ AM ʃ AJ
buccopalatal	b AH ʌ AM kʰ AD o BA ʊː BB pʰ AI æː AN l AE ə AM ɾ BI ɫ̩
buffer	b AH ɐ BA f BE ə AM ɹ AB
bumboclaat	b AH ʌ AM m AF b AH ə AM k AC l AE ɑ AM t AC
but	b AH ɐ BA t AC
butted	b AH ʌ AM ɾ BI ɨ AM d AC
butter	b AH ʌ AM ʔ AL ɚ AM
butterfly	b AH ʌ AM ɾ BI ɚ AM f BE l AE a AM ɪ AM
butting	b AH ʌ AM ɾ BI ɪ AM ŋ AG
buttings	b AH ʌ AM ɾ BI ɪ AM ŋ AG z AJ
button	b AH ʌ AM ʔ AL n̩ BM
béchamel	b AH ɛ AM ʃ AJ ə AM m AF ɛ AM ɫ AE
cacao	k AC ə AM kʰ AD ɑː AN ə AM ʊ̯ AK
cacoepy	k AC ə AM k AC ə AM ʊ BA ɪ AM p AH ɪ AM
cain	kʰ AD e AM ɪ AM n AG
cake	kʰ AD e AM ɪ AM k AC
call	kʰ AD o BA ɫ AE
cam	k AC æ AM m AF
cambodia	k AC æ AM m AF b AH o BA ʊ BA d AC i AM ə AM
came	kʰ AD e AM ɪ̯ AB m AF
camp	kʰ AD ɛ AM ə AM m AF p AH
can	kʰ AD ə AM n AG
can't	kʰ AD ɑː AN n AG t AC
cane	kʰ AD e AM ɪ AM n AG
cap	kʰ AD æ AM p AH
cappadocia	k AC æ AM p AH ə AM d AC o BA ʊ BA ʃ AJ ə AM
caramba	k AC a AM ɹ AB a AM m AF b AH a AM
carbuncle	kʰ AD ɑː AN b AH ʌ AM ŋ AG k AC l̩ CA
card	kʰ AD ɑː AN d AC
carload	kʰ AD ɑː AN l AE ə AM ʊ BA d AC
carving	k AC ɑ AM ɹ AB v BE ɪ AM ŋ AG
casserole	k AC æ AM s AJ ɚ AM ɔ̹ ɫ AE
cat	kʰ AD æ AM t̚
cathedra	k AC ə AM θ AJ iː AN d AC ɹ AB ə AM
caucasian	k AC ɔː BB k AC e AM ɪ AM ʒ AJ ə AM n AG
caught	k̠ʰ oː BB t AC
cause	kʰ AD oː BB z̥ AJ
cauterize	kʰ AD ɔ BA ɾ BI ə AM ɹ AB a AM ɪ AM z AJ
cavity	kʰ AD æ AM v BE ɪ AM ɾ BI i AM
ceili	k AC e AM ɪ AM l AE i AM
cereal	s AJ ɪ AM ə AM ɹ AB iː AN ə AM ɫ AE
chance	t AC ʃʰ CE ɛ AM ə AM n AG s AJ t AC ʃʰ CE e AM ə AM n AG s AJ
charnel	t AC ʃ AJ ɑː AN n AG ə AM l AE
chartreuse	ʃ AJ ɑː AN t AC ɹ AB ɜː AN z AJ
chatted	t AC ʃ AJ æ AM ɾ BI ɨ AM d AC
cheated	t AC ʃ AJ i AM ɾ BI ɨ AM d AC
china	t AC ʃʰ CE a AM ɪ̯ AB n AG ə AM
choo	t AC ʃ AJ uː BB
cicada	s AJ ɪ AM kʰ AD ɑː AN d AC ə AM
circle	s AJ ɚ AM k AC ə AM ɫ AE
circuit	s AJ ɜː AN k AC ɪ AM t AC
cital	s AJ ʌ AM ɪ AM t AC l̩ CA
clay	k AC l̥ AE e AM ɪ AM
clean	kʰ AD l̥ AE iː AN n AG
click	kʰ AD l̥ AE ɪ AM k AC
cliff	k AC l̥ʰ ɪ AM f BE
climb	kˡ l AE a AM ɪ AM m AF
clip	k AC l̥ʰ ɪ AM p AH
clit	k AC l̥ʰ ɪ AM t AC
coach	kʰ AD ə AM ʊ̯ AK t AC ʃ AJ
coccus	kʰ AD ɑ AM k AC ə AM s AJ
coconut	kʰ AD ə AM ʉ̯ k AC ə AM n AG ʌ AM t AC
collaboration	kʰ AD ə AM l AE æ AM b AH ə AM ɹ AB e AM ɪ̯ AB ʃ AJ ə AM n AG
colt	k AC ɔ BA ʊ BA l AE t AC
come	kʰ AD ɐ BA m AF
comfortable	kʰ AD ʌ AM ɱ AF f BE tʰ AD ə̥ AM b AH ɫ̩
comfy	kʰ AD ʌ AM ɱ AF f BE i AM
comment	kʰ AD ɒ BA m AF ɛ AM n AG t AC
committee	k AC ə AM m AF ɪ AM t AC i AM
compare	k AC ə AM m AF p AH ɛː AN
comptroller	k AC ə AM m AF t AC ɹ AB o BA ʊ BA l AE ə AM ɹ AB
concoct	kʰ AD ə AM ŋ AG kʰ AD ɒ BA k AC t AC
confident	kʰ AD ɒ BA ɱ AF f BE ə AM d AC n̩ BM t AC
confirmation	kʰ AD ɒ BA ɱ AF f BE ə AM m AF e AM ɪ AM ʃ AJ n̩ BM
conservancy	k AC ə AM n AG s AJ ɜː AN v BE ə AM n AG s AJ ɪ AM
consigliere	k AC ɒ BA n AG s AJ ɪ AM l AE j AB ɛ AM ɹ AB i AM
contestant	k AC ə AM n AG tʰ AD ɛ AM s AJ t AC ə AM n AG t AC
conversation	kʰ AD ɒ BA ɱ AF v BE ə AM s AJ e AM ɪ AM ʃ AJ n̩ BM
convert	kʰ AD ə̥ AM ɱ AF v BE ɛ AM ə AM t AC
cot	kʰ AD ɔ BA ʔ AL
cottage	k AC ɑ AM ɾ BI ɪ AM d AC ʒ AJ
cougar	kʰ AD uː BB ɡ AC ə AM
coulda	kʰ AD ʊ BA d AC ə AM
couldn't	k AC ʊ BA n AG ʔ AL
countable	kʰ AD a AM ʊ BA n AG ɾ BI ə AM b AH ɫ̩
country	kʰ AD ʌ AM n AG t̠ AC ɹ̠̊ʷ i AM
coventry	kʰ AD ɒ BA v BE ə AM n AG t AC ʃ AJ ɹ AB i AM
craytur	k AC ɹ AB eː AN t̪ AC ə AM ɹ AB
creation	k AC ɹ AB iːʲ e AM ɪ AM ʃ AJ ɘ AM n AG
creep	kʰ AD ɹ AB iː AN p AH
crikey	k AC ɹ AB ɑ AM e̯ AB k AC ɪ AM i̯ AB
cryptography	k AC ɹ̥ AB ɪ AM p AH tʰ AD ɒ BA ɡ AC ɹ AB ə AM f BE iː AN
cuba	k AC j AB uː BB b AH ə AM
cuban	k AC j AB ʉː BB b AH ə AM n AG
cue	k AC j̥ AB ʉː BB
culprit	kʰ AD ʌ AM ɫ AE p AH ɹ AB ɪ AM t AC
cum	kʰ AD ʌ AM m AF
cunt	kʰ AD ʌ̃ BJ n AG t AC
cur	k AC ɜː AN
cursor	kʰ AD ɜː AN s AJ ə AM
curve	kʰ AD ɜː AN v BE
cymbal	s AJ ɪ AM m AF b AH ɫ̩
dance	d AC ɛ AM ə AM n AG s AJ
dandle	d AC æ AM n AG d AC ə AM ɫ AE
dangleberry	d AC æ AM ŋ AG ɡ AC ə AM ɫ AE b AH ɛ AM ɹ AB i AM
daniel	d AC a AM n AG j AB ə AM l AE
dapple	d AC æ AM p AH ə AM ɫ AE
dappled	d AC æ AM p AH ə AM ɫ AE d AC
dardanelles	d AC ɑː AN d AC ə AM n AG ɛ AM ɫ AE z AJ
daredevil	d AC ɛ AM ə AM d AC ɛ AM v BE ə AM ɫ AE
data	d AC æ AM ɾ BI ə AM
dayouth	d AC æ AM jː BF uː BB θ AJ
dayum	d AC æ̙ j AB ə AM m AF
deacetyltransferase	d AC iː AN ə AM s AJ iː AN t AC a AM ɪ AM ɫ AE t AC ɹ AB ɑː AN n AG s AJ f BE ə AM ɹ AB e AM ɪ AM z AJ
dealkylate	d AC iː AN æ AM ɫ AE k AC ɪ AM l AE e AM ɪ AM t AC
dealkylated	d AC iː AN æ AM ɫ AE k AC ɪ AM l AE e AM ɪ AM t AC ə AM d AC
dealkylating	d AC iː AN æ AM ɫ AE k AC ɪ AM l AE e AM ɪ AM t AC ɪ AM ŋ AG ɡ AC
dealkylation	d AC iː AN æ AM ɫ AE k AC ɪ AM l AE e AM ɪ AM ʃ AJ ə AM n AG
dealkylative	d AC iː AN æ AM ɫ AE k AC ɪ AM l AE ə AM t AC ɪ AM v BE
dean	d AC ĩː n AG
debatable	d AC ɪ AM b AH e AM ɪ AM t AC ə AM b AH ə AM ɫ AE
debateful	d AC ɪ AM b AH e AM ɪ AM t AC f BE ə AM ɫ AE
debuggable	d AC iː AN b AH ʌ AM ɡ AC ə AM b AH ə AM ɫ AE
debulk	d AC iː AN b AH ʌ AM ɫ AE k AC
debunkable	d AC iː AN b AH ʌ AM ŋ AG k AC ə AM b AH ə AM ɫ AE
decadal	d AC ɪ AM k AC e AM ɪ AM d AC ə AM ɫ AE
decagonal	d AC ɪ AM k AC æ AM ɡ AC ə AM n AG ə AM ɫ AE
decahedral	d AC ɛ AM k AC ə AM h AA iː AN d AC ɹ AB ə AM ɫ AE
decalcification	d AC iː AN k AC æ AM ɫ AE s AJ ɪ AM f BE ɪ AM k AC e AM ɪ AM ʃ AJ ə AM n AG
decalcifier	d AC iː AN k AC æ AM ɫ AE s AJ ɪ AM f BE a AM ɪ AM ə AM ɹ AB
decalcify	d AC iː AN k AC æ AM ɫ AE s AJ ɪ AM f BE a AM ɪ AM
decalcifying	d AC iː AN k AC æ AM ɫ AE s AJ ɪ AM f BE a AM ɪ AM j AB ɪ AM ŋ AG ɡ AC
decalcomania	d AC iː AN k AC æ AM ɫ AE k AC ə AM m AF e AM ɪ AM n AG ɪ AM ə AM
decanormal	d AC ɛ AM k AC ə AM n AG ɔː BB m AF ə AM ɫ AE
decaprenyl	d AC ɛ AM k AC ə AM p AH ɹ AB iː AN n AG a AM ɪ AM ɫ AE
decasulfide	d AC ɛ AM k AC ə AM s AJ ʌ AM ɫ AE f BE a AM ɪ AM d AC
decasyllable	d AC ɛ AM k AC ə AM s AJ ɪ AM l AE ə AM b AH ə AM ɫ AE
decidable	d AC ɪ AM s AJ a AM ɪ AM d AC ə AM b AH ə AM ɫ AE
decidual	d AC ɪ AM s AJ ɪ AM d AC ʒ AJ ʊ BA ə AM ɫ AE
decile	d AC ɛ AM s AJ a AM ɪ AM ɫ AE
decimal	d AC ɛ AM s AJ ɪ AM m AF ə AM ɫ AE
decimole	d AC ɛ AM s AJ ɪ AM m AF ə AM ʊ BA ɫ AE
decinormal	d AC ɛ AM s AJ ɪ AM n AG ɔː BB m AF ə AM ɫ AE
decipherable	d AC ɪ AM s AJ a AM ɪ AM f BE ə AM ɹ AB ə AM b AH ə AM ɫ AE
decisional	d AC ɪ AM s AJ ɪ AM ʒ AJ ə AM n AG ə AM ɫ AE
declarable	d AC ɪ AM k AC l AE æ AM ɹ AB ə AM b AH ə AM ɫ AE
decodable	d AC ɪ AM k AC ə AM ʊ BA d AC ə AM b AH ə AM ɫ AE
decomposable	d AC iː AN k AC ə AM m AF p AH ə AM ʊ BA z AJ ə AM b AH ə AM ɫ AE
decompositional	d AC iː AN k AC ɒ BA m AF p AH ə AM z AJ ɪ AM ʃ AJ ə AM n AG ə AM ɫ AE
deconstructable	d AC iː AN k AC ə AM n AG s AJ t AC ɹ AB ʌ AM k AC t AC ə AM b AH ə AM ɫ AE
deconstructional	d AC iː AN k AC ə AM n AG s AJ t AC ɹ AB ʌ AM k AC ʃ AJ ə AM n AG ə AM ɫ AE
decouplable	d AC ɪ AM k AC ʌ AM p AH ə AM l AE ə AM b AH ə AM ɫ AE
decouple	d AC iː AN k AC ʌ AM p AH ə AM ɫ AE
decoupler	d AC iː AN k AC ʌ AM p AH ə AM l AE ə AM ɹ AB
decoupling	d AC iː AN k AC ʌ AM p AH ə AM l AE ɪ AM ŋ AG
decremental	d AC ɛ AM k AC ɹ AB ə AM m AF ə AM n AG t AC ə AM ɫ AE
decryptable	d AC ɪ AM k AC ɹ AB ɪ AM p AH t AC ə AM b AH ə AM ɫ AE
deducible	d AC ɪ AM d AC j AB uː BB s AJ ɪ AM b AH ə AM ɫ AE
deductable	d AC ɪ AM d AC ʌ AM k AC t AC ə AM b AH ə AM ɫ AE
deductible	d AC ɪ AM d AC ʌ AM k AC t AC ə AM b AH ə AM ɫ AE
defalcate	d AC ɛ AM f BE ə AM ɫ AE k AC e AM ɪ AM t AC
defalcation	d AC ɛ AM f BE ə AM ɫ AE k AC e AM ɪ AM ʃ AJ ə AM n AG
defalcator	d AC ɛ AM f BE ə AM ɫ AE k AC e AM ɪ AM t AC ə AM ɹ AB
defatigable	d AC ɪ AM f BE æ AM t AC ɪ AM ɡ AC ə AM b AH ə AM ɫ AE
defaultable	d AC ɪ AM f BE ɔː BB ɫ AE t AC ə AM b AH ə AM ɫ AE
defaulter	d AC ɪ AM f BE ɔː BB ɫ AE t AC ə AM ɹ AB
defeasible	d AC ɪ AM f BE iː AN z AJ ɪ AM b AH ə AM ɫ AE
defeatable	d AC ɪ AM f BE iː AN t AC ə AM b AH ə AM ɫ AE
defendable	d AC ɪ AM f BE ɛ AM n AG d AC ə AM b AH ə AM ɫ AE
defensible	d AC ɪ AM f BE ɛ AM n AG s AJ ɪ AM b AH ə AM ɫ AE
deferential	d AC ɛ AM f BE ə AM ɹ AB ɛ AM n AG ʃ AJ ə AM ɫ AE
deferrable	d AC ɪ AM f BE ɜː AN ɹ AB ə AM b AH ə AM ɫ AE
deferral	d AC ɪ AM f BE ɜː AN ɹ AB ə AM ɫ AE
defiable	d AC ɪ AM f BE a AM ɪ AM j AB ə AM b AH ə AM ɫ AE
defiled	d AC ɪ AM f BE a AM ɪ AM j AB ə AM ɫ AE d AC
definable	d AC ɪ AM f BE a AM ɪ AM n AG ə AM b AH ə AM ɫ AE
definitional	d AC ɛ AM f BE ɪ AM n AG ɪ AM ʃ AJ ə AM n AG ə AM ɫ AE
deflectable	d AC ɪ AM f BE l AE ɛ AM k AC t AC ə AM b AH ə AM ɫ AE
deformable	d AC ɪ AM f BE ɔː BB m AF ə AM b AH ə AM ɫ AE
defoul	d AC ɪ AM f BE a AM ʊ BA ɫ AE
deglucosyl	d AC iː AN ɡ AC l AE uː BB k AC ə AM s AJ ɪ AM ɫ AE
degradable	d AC ɪ AM ɡ AC ɹ AB e AM ɪ AM d AC ə AM b AH ə AM ɫ AE
dehydrocholesterol	d AC iː AN h AA a AM ɪ AM d AC ɹ AB ə AM k AC ə AM l AE ɛ AM s AJ t AC ə AM ɹ AB ɒ BA ɫ AE
dehydroretinol	d AC iː AN h AA a AM ɪ AM d AC ɹ AB ə AM ɹ AB ɛ AM t AC ɪ AM n AG ɒ BA ɫ AE
deicidal	d AC e AM ɪ AM j AB ɪ AM s AJ a AM ɪ AM d AC ə AM ɫ AE
delectable	d AC ɪ AM l AE ɛ AM k AC t AC ə AM b AH ə AM ɫ AE
delft	d AC ɛ AM ɫ AE f BE t AC
delphi	d AC ɛ AM ɫ AE f BE i AM
delphine	d AC ɛ AM ɫ AE f BE iː AN n AG
delphinium	d AC ɛ AM ɫ AE f BE ɪ AM n AG ɪ AM ə AM m AF
delta	d AC ɛ AM ɫ AE t AC ə AM
demicircle	d AC ɛ AM m AF ɪ AM s AJ ɜː AN k AC ə AM ɫ AE
demographical	d AC ɛ AM m AF ə AM ɡ AC ɹ AB æ AM f BE ɪ AM k AC ə AM ɫ AE
dendrological	d AC ɛ AM n AG d AC ɹ AB ə AM l AE ɒ BA d AC ʒ AJ ɪ AM k AC ə AM ɫ AE
dendrophile	d AC ɛ AM n AG d AC ɹ AB ə AM f BE a AM ɪ AM ɫ AE
denton	d AC ɪ AM n AG ʔ AL n̩ BM
dependable	d AC ɪ AM p AH ɛ AM n AG d AC ə AM b AH ə AM ɫ AE
derivable	d AC ɪ AM ɹ AB a AM ɪ AM v BE ə AM b AH ə AM ɫ AE
derival	d AC ɪ AM ɹ AB a AM ɪ AM v BE ə AM ɫ AE
dermal	d AC ɜː AN m AF ə AM ɫ AE
dermatological	d AC ɜː AN m AF ə AM t AC ə AM l AE ɒ BA d AC ʒ AJ ɪ AM k AC ə AM ɫ AE
dermoneural	d AC ɜː AN m AF ə AM n AG j AB ʊ BA ə AM ɹ AB ə AM ɫ AE
desirable	d AC ɪ AM z AJ a AM ɪ AM j AB ə AM ɹ AB ə AM b AH ə AM ɫ AE
desktop	d AC ɛ AM s AJ k AC t AC ɒ BA p AH
desktops	d AC ɛ AM s AJ k AC t AC ɒ BA p AH s AJ
despeckle	d AC iː AN s AJ p AH ɛ AM k AC ə AM ɫ AE
diabolical	d AC a AM ɪ AM ə AM b AH ɒ BA l AE ɪ AM k AC ə AM ɫ AE
diasporan	d AC ʌ AM ɪ AM a AM s AJ p AH ə AM ɹ AB n̩ BM
dibutyl	d AC a AM ɪ AM b AH j AB uː BB t AC a AM ɪ AM ɫ AE
dictatorial	d AC ɪ AM k AC t AC ə AM t AC ɔː BB ɹ AB ɪ AM ə AM ɫ AE
diddle	d AC ɪ AM d AC ə AM ɫ AE
differential	d AC ɪ AM f BE ə AM ɹ AB ə AM n AG ʃ AJ ə AM ɫ AE
diggle	d AC ɪ AM ɡ AC ə AM ɫ AE
diggles	d AC ɪ AM ɡ AC ə AM ɫ AE z AJ
diisopropyl	d AC a AM ɪ AM a AM ɪ AM s AJ ə AM ʊ BA p AH ɹ AB ə AM ʊ BA p AH a AM ɪ AM ɫ AE
dildo	d AC ɪ AM ɫ AE d AC ə AM ʊ BA
dimethylbenzene	d AC a AM ɪ AM m AF iː AN θ AJ a AM ɪ AM ɫ AE b AH ɛ AM n AG z AJ iː AN n AG
dingaling	d AC ɪ AM ŋ AG ə AM l AE ɪ AM ŋ AG
diphenol	d AC a AM ɪ AM f BE iː AN n AG ɒ BA ɫ AE
diphenyl	d AC a AM ɪ AM f BE iː AN n AG a AM ɪ AM ɫ AE
dirgeful	d AC ɜː AN d AC ʒ AJ f BE ə AM ɫ AE
dirndl	d AC ɪ AM ə AM n AG d AC ə AM ɫ AE
disable	d AC ɪ AM s AJ e AM ɪ AM b AH ə AM ɫ AE
disabled	d AC ɪ AM s AJ e AM ɪ AM b AH ə AM ɫ AE d AC
disagreeable	d AC ɪ AM s AJ ə AM ɡ AC ɹ AB i AM ə AM b AH ə AM ɫ AE
disapproval	d AC ɪ AM s AJ ə AM p AH ɹ AB uː BB v BE ə AM ɫ AE
disavail	d AC ɪ AM s AJ ə AM v BE e AM ɪ AM ɫ AE
disavowal	d AC ɪ AM s AJ ə AM v BE a AM ʊ BA ə AM ɫ AE
disbursal	d AC ɪ AM s AJ b AH ɜː AN s AJ ə AM ɫ AE
disculpate	d AC ɪ AM s AJ k AC ʌ AM ɫ AE p AH e AM ɪ AM t AC
disembowel	d AC ɪ AM s AJ ɪ AM m AF b AH a AM ʊ BA ə AM ɫ AE
disentangle	d AC ɪ AM s AJ ɪ AM n AG t AC æ AM ŋ AG ɡ AC ə AM ɫ AE
disentitle	d AC ɪ AM s AJ ɪ AM n AG t AC a AM ɪ AM t AC ə AM ɫ AE
disfavourable	d AC ɪ AM s AJ f BE e AM ɪ AM v BE ɹ AB ə AM b AH ə AM ɫ AE
disgraceful	d AC ɪ AM z AJ ɡ AC ɹ AB e AM ɪ AM s AJ f BE ə AM ɫ AE
disgust	d AC ɪ AM s AJ k AC ʌ AM s AJ t AC
dishevel	d AC ɪ AM s AJ ʃ AJ ɛ AM v BE ə AM ɫ AE
disloyal	d AC ɪ AM s AJ l AE ɔ BA ɪ AM j AB ə AM ɫ AE
dismal	d AC ɪ AM z AJ m AF ə AM ɫ AE
dismantle	d AC ɪ AM s AJ m AF æ AM n AG tʰ AD ə AM ɫ AE
dismissal	d AC ɪ AM z AJ m AF ɪ AM s AJ ə AM ɫ AE
dispel	d AC ɪ AM s AJ p AH ɛ AM ɫ AE
dispellable	d AC ɪ AM s AJ p AH ɛ AM l AE ə AM b AH ə AM ɫ AE
dispensable	d AC ɪ AM s AJ pʰ AI ɛ AM n AG s AJ ə AM b AH ɫ̩
disposal	d AC ɪ AM s AJ p AH ə AM ʊ BA z AJ ə AM ɫ AE
disproportional	d AC ɪ AM s AJ p AH ɹ AB ə AM p AH ɔː BB ʃ AJ ə AM n AG ə AM ɫ AE
disrespectful	d AC ɪ AM s AJ ɹ AB ɪ AM s AJ p AH ɛ AM k AC t AC f BE ə AM ɫ AE
dissemble	d AC ɪ AM s AJ ɛ AM m AF b AH ə AM ɫ AE
distil	d AC ɪ AM s AJ t AC ɪ AM ɫ AE
distill	d AC ɪ AM s AJ t AC ɪ AM ɫ AE
divinyl	d AC a AM ɪ AM v BE a AM ɪ AM n AG ɪ AM ɫ AE
divisible	d AC ɪ AM v BE ɪ AM z AJ ɪ AM b AH ə AM ɫ AE
dna	d AC i AM ɛ AM n AG e AM ɪ AM
dniester	n AG iː AN s AJ t AC ə AM
dojo	d AC ə AM ʊ̯ AK d AC ʒ AJ ə AM ʊ̯ AK
done	d AC ʊ BA n AG
dope	d AC ə AM ʊ BA p AH
double	d AC ʌ AM b AH ɫ AE
dower	d AC a AM ʊ BA ə AM ɹ AB
drawn	d AC ɹ AB ɔː BB n AG
dreich	d AC ɹ AB iː AN x AJ
drill	d AC ɹ AB ɪ AM ɫ AE
drink	d̠ AC ɹ̠ʷ ɪ AM ŋ AG k AC
drive	d̠ AC ɹ̠̝ʷ a AM ɪ AM v BE
drown	d̠ AC ɹ̠ʷ a AM ʊ BA n AG
drug	d̠ AC ɹ̠ʷ ʌ AM ɡ AC
drugs	d AC ʒ AJ ɹ AB ʌ AM ɡ AC z AJ
dunn	d AC ɐ BA n AG
eaten	iː AN ʔ AL n AG
emphasis	ɛ AM ɱ AF f BE ə AM s AJ ɪ AM s AJ
enabled	ɪ AM n AG e AM ɪ AM b AH ə AM ɫ AE d AC
encouragement	ɪ AM n AG k AC ʌ AM ɹ AB ɪ AM d AC ʒ AJ m AF ə AM n AG t AC
entangle	ɛ AM n AG t AC a AM ŋ AG ɡ AC l̩ CA
epigraphy	ʔ AL ɨ AM pʰ AI ɪː AN ɡ AC ɹ AB ə AM f BE iː AN
epimutation	ɛ AM p AH ɪ AM m AF j AB u BA t AC e AM ɪ AM ʃ AJ ə AM n AG
epitaph	ɛ AM p AH ɪ AM t AC ɑː AN f BE
epitomic	ɛ AM p AH ɪ AM t AC ɒ BA m AF ɪ AM k AC
essential	ə AM s AJ ɛ AM n AG t AC ʃ AJ ə AM l AE
esteem	ɛ AM s AJ t AC iː AN m AF
eugh	ʌ AM x AJ
ew	ɪ̃ BJ ʉ̃ BN u BA
farrand	f BE æ AM ɹ AB ə AM n AG t AC
fastness	f BE æ AM s AJ n AG ə AM s AJ
fatal	f BE e AM ɪ AM ɾ BI ɫ̩
fatally	f BE e AM ɪ̯ AB ɾ BI l̩ CA i AM
fated	f BE e AM ɪ̯ AB ɾ BI ɨ AM d AC
fauces	f BE ɔː BB s AJ iː AN z AJ
fauxtograph	f BE oː BB t AC ə AM ɡ AC ɹ AB ɑː AN f BE
fauxtography	f BE oː BB t AC ɒ BA ɡ AC ɹ AB ə AM f BE i AM
feel	f BE iː AN ɫ AE
fence	f BE ɛ AM n AG t AC s AJ
fencer	f BE ɛ AM n AG s AJ ɚ AM
feudal	f BE j AB uː BB d AC ɫ̩
fiddy	f BE ɪ AM ɾ BI i AM
file	f BE a AM ɪ̯ AB ɫ AE
fill	f BE ɪ AM ɫ AE
filling	f BE ɪ AM ɫ AE l AE ɪ AM ŋ AG
film	f BE ɪ AM ɫ AE m AF
fitra	f BE ɪ AM tˤ AC ɾ BI a AM
fitz	f BE ɪ AM t AC s AJ
flaithiúlach	f BE l AE æ AM h AA uː BB l AE ə AM x AJ
flizz	f BE l AE ɪ AM z AJ
flouted	f BE l AE a AM ʊ̯ AK ɾ BI ɨ AM d AC
flouting	f BE l AE a AM ʊ̯ AK ɾ BI ɪ AM ŋ AG
foot	fʷ BE ʊ BA t̚
football	fʷ BE ʊ BA ʔ AL t̚ b AH ɑ AM ɫ AE
foretell	f BE ɔː BB t AC ɛ AM ɫ AE
foretellable	f BE oː BB t AC ɛ AM ɫ AE ə AM b AH l̩ CA
foundation	f BE a AM ʊ̯ AK n AG d AC e AM ɪ̯ AB ʃ AJ n̩ BM
fountain	f BE a AM ʊ BA n AG ʔ AL n̩ BM
free	f BE ɹ AB ɪ AM i̯ AB
french	f BE ɹ̠ ɛ AM n̠ AG t AC ʃ AJ
friend	f BE ɹ̥ AB e AM n AG d̥ AC
fro	f BE ɹ AB ə AM ʊ BA
fuck	f BE ʌ AM kʰ AD
fuel	f BE j AB u BA w AK ə AM ɫ AE
full	f BE ʊ BA ɫ AE
fur	f BE ɜ̝ː
furcal	f BE ɚ AM k AC ə AM ɫ AE
gaeltacht	ɡ AC e AM ɪ AM l AE t AC ə AM x AJ t AC
gangtok	ɡ AC æ AM ŋ AG t AC ɒ BA k AC
gasoline	ɡ AC æ AM s AJ ɵ BA l AE i AM n AG
gaumy	ɡ AC ɔː BB m AF i AM
genetic	d AC ʒ AJ ɪ AM n AG ɛ AM t AC ɪ AM k AC
genkan	ɡ AC ɛ AM ŋ AG k AC ɑ AM n AG
getting	ɡ AC ɛ AM ɾ BI ɪ AM ŋ AG
glizzy	ɡ AC l AE ɪ AM z AJ i AM
gmail	d AC ʒ AJ iː AN m AF e AM ɪ AM l AE
gotta	ɡ AC ɒ BA ʔ AL ə AM
grass	ɡ AC ɹ̠ ɛ AM ə AM s AJ
grated	ɡ AC ɹ AB e AM ɪ̯ AB ɾ BI ɪ AM d AC
gratified	ɡ AC ɹ AB æː AN ɾ BI ɨ AM f BE a AM ɪː AN d̚
grating	ɡ AC ɹ AB e AM ɪ̯ AB ɾ BI ɪ AM ŋ AG
grivna	ɡ AC ɹ AB ɪ AM v BE n AG ɑ AM
grow	ɡ AC ɹ AB ə AM ʊ̯ AK
grows	ɡ AC ɹ AB ə AM ʊ̯ AK z AJ
guileless	ɡ AC a AM ɪ AM ɫ AE l AE ə AM s AJ
guttle	ɡ AC ʌ AM ɾ BI l̩ CA
guttural	ɡ AC ʌ AM ɾ BI ɚ AM ɫ̩
gyros	d AC ʒ AJ a AM ɪ AM ɹ AB o BA ʊ BA z AJ
h	æ AM ɪ AM t AC ʃ AJ
hadith	h AA a AM d AC iː AN θ AJ
hail	h AA e AM ɪ̯ AB ɫ AE
hang	h AA e AM ɪ AM ŋ AG
hangnail	h AA e AM ɪ AM ŋ AG n AG e AM ɪ̯ AB ɫ AE
happening	h AA æ AM p AH n AG ɪ AM n AG
hat	h AA a AM t AC
heading	h AA ɛ AM ɾ BI ɪ AM ŋ AG
health	h AA ɛ AM l̪ AE θ AJ
hew	ç j AB uː BB
hexadecile	h AA ɛ AM k AC s AJ ə AM d AC iː AN s AJ a AM ɪ AM ɫ AE
hibernation	h AA a AM ɪ AM b AH əː AN n AG e AM ɪ AM ʃ AJ n̩ BM
high	h AA a AM ɪ̯ AB
hill	h AA ɪ AM ɫ AE
hiller	h AA ɪ AM l AE ə AM ɹ AB
him	ɪ̈ AM m AF
hinoki	h AA i AM n AG o BA k AC i AM
hitherto	h AA ɪ AM ð AJ ə AM tʰ AD uː BB
hmm	m̥ AF m̩ BL
hmmm	m̥ AF m̩ː CG
hold	h AA ə AM ʊ BA ɫ AE d AC
holding	h AA ə AM ʊ BA ɫ AE d AC ɪ AM ŋ AG
hole	h AA ə AM ʊ BA ɫ AE
holey	h AA ɒ BA ʊ BA ɫ AE l AE i AM
holier	h AA ɒ BA ʊ BA ɫ AE l AE i AM ə AM
holiest	h AA ɒ BA ʊ BA ɫ AE l AE i AM ɪ AM s AJ t AC
homophobe	h AA ə AM ʊ BA m AF ə AM f BE ə AM ʊ BA b AH
hon	m̥ AF ɑ AM n AG
hood	h AA ʊ̈ BA d AC
hordesman	h AA ɔː BB d AC z AJ m AF n̩ BM
hotel	h AA oː BB t AC e AM l AE
housemother	h AA a AM ʊ BA s AJ m AF ɐ BA ð AJ ə AM ɹ AB
hrivna	ɦ AA ɹ AB ɪ AM u̯ AK nʲ AG ɑ AM
hubris	ç j AB u̟ː BB b AH ɹʷ ɪ AM s AJ
hue	ç u̟ː BB
huge	ç u̟ː BB d AC ʒ AJ
huh	h AA ʌ̃ BJ
human	ç j AB u̟ː BB m AF ə AM n AG
humanist	ç uː BB m AF ə AM n AG ɪ AM s AJ t AC
humongous	ç u̟ː BB m AF ʊ BA ŋ AG ɡ AC ə AM s AJ
hydra	h AA a AM ɪ̯ AB d AC ʒ AJ ɹ AB ə AM
hyperhidrosis	h AA a AM ɪ AM p AH ə AM ɹ AB h AA a AM ɪ AM d AC ɹ AB o BA ʊ BA s AJ ɪ AM s AJ
hypotenuse	h AA a AM ɪ AM p AH ɒ BA ʔ AL n̩ BM j AB uː BB z AJ
háček	ɦ AA ɑː AN t AC ʃ AJ ɛ AM k AC
iced	a AM ɪ̯ AB s AJ t AC
imma	aː AN m AF ə AM
inamorata	ɪ AM n AG æ AM m AF ə AM ɹ AB ɑː AN ɾ BI ə AM
incidental	ɪ AM n AG s AJ ɪ AM d AC ɛ AM ɾ̃ CC ə AM l AE
indical	ɪ AM n AG d AC ɪ AM k AC l̩ CA
inexorably	ɪ AM n AG ɛ AM ɡ AC z AJ ə AM ɹ AB ə AM b AH l AE i AM
inference	ɪ AM ɱ AF f BE ɹ AB ə AM n AG s AJ
inferrible	ɪ AM n AG f BE ə AM ɹ AB ɪ AM b AH l̩ CA
inhalation	ɪ AM n AG ɦ AA ə AM l AE e AM ɪ AM ʃ AJ n̩ BM
insolvency	ɪ AM n AG s AJ ɒ BA l AE v BE n̩ BM s AJ i AM
installation	ɪ AM n AG s AJ t AC ə AM l AE e AM ɪ AM ʃ AJ ə AM n AG
insufferable	ɪ AM n AG s AJ ʌ AM f BE ɹ AB ə AM b AH l̩ CA
interloper	ɪ AM n AG t AC ə AM l AE ə AM ʊ̯ AK p AH ə AM
international	ɪ AM n AG t AC ə AM n AG æ AM ʃ AJ ə AM n AG ə AM ɫ AE
investigate	ɪ AM n AG v BE e AM s AJ t AC ɪ AM ɡ AC e AM ɪ̯ AB t AC
ipa	a AM ɪ AM pʰ AI iː AN e AM ɪ AM
ireland	ʌ AM ɪ AM ɚ AM l AE ə AM n AG d AC
it	ɪ̈ AM t AC
item	a AM ɪ̯ AB ɾ BI ə AM m AF
ith	a AM ɪ̯ AB θ AJ
jar	d AC ʒ AJ ɑː AN ɹ AB
jump	d AC ʒ AJ ʌ AM m AF p AH
jury	d AC ʒ AJ ʊ BA ə AM ɹ̠ i AM
k	kʰ AD e AM ɪ AM
kana	kʰ AD ɑː AN n AG ə AM
karma	k AC ə AM ɾ BI m AF ə AM
kash	k AC a AM ʃ AJ
katy	kʰ AD e AM ɪ̯ AB ɾ BI i AM
kebnekaise	k AC ɛ AM b AH n AG ə AM k AC a AM i AM s AJ ə AM
keloid	k AC iː AN l AE ɔ BA ɪ AM d AC
kettle	kʰ AD ɛ AM t AC ɫ̩
key	kʲʰ AD iː AN
kibosh	k AC a AM ɪ AM b AH o BA ʃ AJ
kick	kʰ AD ɪ AM k AC
killer	kʰ AD ɪ AM l AE ə AM ɹ AB
kiss	kʰ AD ɪ AM s AJ
knoll	n AG ə AM ʊ BA l AE
koizumi	kʰ AD ɔ BA i̯ AB z AJ u BA m AF i AM
korea	kʰ AD ɵ BA ɹ AB iː AN ə AM
l	ɫ AE
la	ɛ AM ɫ AE l AE e AM j AB
lambrusco	l AE æ AM m AF b AH ɹ AB ʊ BA s AJ k AC ə AM ʊ BA
lander	l AE æ AM n AG d AC ə AM
language	l AE e AM ɪ AM ŋ AG ɡ AC w AK ɪ AM d AC ʒ AJ
largely	l AE ɑː AN d AC ʒ AJ l AE i AM
latter	l AE æ AM ɾ BI ɚ AM
laundry	l AE ɑ AM n AG d AC ɹ AB i AM
learner	l AE ɚ AM n AG ɚ AM
leeway	l AE iː AN w AK e AM ɪ AM
li'l	l AE ɪ AM ɫ̩
liable	l AE a AM ɪ̯ AB ə AM b AH ɫ̩
libre	l AE i AM b AH ʁ AJ
listen	l AE ɪ AM s AJ n̩ BM
little	l AE ɪ AM tʰ AD ɫ̩
luck	l AE ɐ BA k AC
lulls	ɫ AE ʌ AM ɫ AE z AJ
lunch	l AE ʌ̃ BJ n AG t AC ʃ AJ
lycra	l AE a AM ɪ AM k AC ɹ AB ə AM
madder	m AF a AM d AC ə AM ɹ AB
madhab	m AF æ AM ð AJ h AA æ AM b AH
mail	m AF e AM ɪ̯ AB ɫ AE
make	m AF e AM ɪ AM kʲ AC
malinois	m AF æ AM l AE ɪ AM n AG w AK ɑː AN
mamaliga	m AF ə AM m AF ə AM l AE i AM ɡ AC ə AM
mash	m AF a AM ʃ AJ
mawky	m AF ɔː BB k AC i AM
maybe	m AF e AM ɪ̯ AB b AH i AM
medal	m AF ɛ AM ɾ BI ɫ̩
meese	m AF iː AN s AJ
merveilleuse	m AF ɛ AM ʁ AJ v BE ɛ AM j AB ø BA z AJ
merveilleux	m AF ɛ AM ʁ AJ v BE ɛ AM j AB ø BA
metal	m AF ɛ AM ɾ BI ɫ̩
methoxphenidine	m AF ɛː AN θ AJ ɑ AM k AC s AJ f BE ɛː AN n AG ɨ AM ɾ BI ĩː n AG
mhm	m̩ BL m̥ AF m̩ BL
mi'kmaq	m AF ɪ AM ɡ AC ə AM m AF ɒ BA q AC
michael	m AF ɐ BA ɪ AM kʰ AD ɫ̩
michigander	m AF ɪ AM ʃ AJ ə AM ɡ AC æ AM n AG d AC ɚ AM
middle	m AF ɪ AM d AC ʊ BA
middleman	m AF ɪ AM d AC ɫ̩ m AF æ AM n AG
midst	m AF ɪ AM t AC s AJ t AC
mikey	m AF ɐ BA ɪ AM kʰ AD iː AN
mile	m AF a AM ɪ̯ AB ɫ AE
milkshake	m AF ɪ AM ɫ AE k AC ʃ AJ e AM ɪ AM k AC
mill	m AF ɪ AM ɫ AE
mister	m AF ɪ AM s AJ t AC ə AM ɹ AB
mmm	m̩ BL
molasses	m AF ə AM l AE æ AM s AJ ɪ AM z AJ
money	m AF ɐ BA n AG i AM
month	m AF ɐ BA n̪ AG θ AJ
mother	m AF ɐ BA ð AJ ə AM ɹ AB
motlopi	m AF ə AM ʊ BA t̚ l AE ə AM ʊ BA p AH i AM
muddy	m AF ʌ AM d AC i AM
multiplayer	m AF ɐ BA ɫ AE t AC i AM p AH l AE e AM ɪ̯ AB ə AM ɹ AB
multiplier	m AF ʌ AM ɫ AE t AC ɪ AM p AH l AE a AM ɪ AM ɚ AM
murr	m AF ɚ AM
mustard	m AF ʌ AM s AJ t AC ɚ AM d AC
musty	m AF ʌ AM s AJ t AC ɪ AM
myrrh	m AF ɚ AM
nah	n AG ɑː AN
nail	n AG e AM ɪ̯ AB ɫ AE
nares	n AG ɛ AM ə AM ɹ AB i AM z AJ
narration	n AG ə AM ɹ AB e AM ɪ AM ʃ AJ n̩ BM
nauruan	n AG ɑː AN uː BB ɹ AB uː BB n̩ BM
need	n AG ɪ AM i̯ AB d AC
newcastle	n AG j AB ʉ BA kʰ AD ɑː AN s AJ ɫ̩
ng	ŋ AG
niggard	n AG ɪ AM ɡ AC ə AM d AC
niggered	n AG ɪ AM ɡ AC ə AM d AC
nighttime	n AG a AM ɪ AM ʔ AL t AC a AM ɪ AM m AF
nine	n AG a AM ɪ̯ AB n AG
niort	n AG j AB ɔ BA ɹ AB
nippon	n AG ɪ AM p AH ɒ BA n AG
nizz	n AG ɪ AM z AJ
nonce	n AG ɒ BA n AG t AC s AJ
nope	n AG o BA ʊ BA p̚
nut	n AG ɐ BA t AC
obnubilation	ɒ BA b AH n AG j AB uː BB b AH ɪ AM l AE e AM ɪ AM ʃ AJ n̩ BM
oftentime	ɒ BA f BE t AC n̩ BM t AC a AM ɪ AM m AF
oil	ɔ BA ɪ AM ɫ AE
ointment	ɔ̃ BN ɪ̃ BJ n AG ʔ AL m AF ɪ̃ BJ n AG ʔ AL
one	w AK ɐ BA n AG
oni	o BA ʊ BA n AG iː AN
otaku	ə AM ʊ̯ AK tʰ AD ɑː AN kʰ AD uː BB
other	ɐ BA ð AJ ə AM ɹ AB
our	ɑ AM ˞
pack	pʰ AI æ AM k AC
package	pʰ AI a AM k AC ɛ AM d AC ʒ AJ
paddle	pʰ AI æ AM ɾ BI ɫ̩
paddy	pʰ AI æ AM ɾ BI i AM
padre	pʰ AI ɑ AM d AC ɹ AB e AM ɪ̯ AB
pah	pʼ BC aʰ
pail	pʰ AI e AM ɪ̯ AB ɫ AE
pale	pʰ AI e AM ɪ̯ AB ɫ AE
pantry	p AH a AM nʰ CF ɹ̥ AB i AM
parcel	pʰ AI ɑː AN s AJ ə AM ɫ AE
park	p AH ɒ BA ə AM k AC
parole	p AH ə AM ɹ AB ə AM ʊ BA ɫ AE
parse	pʰ AI ɑː AN z AJ
pass	pʰ AI ɛ AM ə AM s AJ
pat	pʰ AI æˀ t̚
path	pʰ AI ɛ AM ə AM θ AJ
patrick	pʰ AI æ AM t̠ AC ɹ̠̊ʷ ɪ AM k̚
pattern	p AH a AM ʔ AL ə AM n AG
patting	pʰ AI æ AM ɾ BI ɪ AM ŋ AG
pattings	pʰ AI æ AM ɾ BI ɪ AM ŋ AG z AJ
pay	pʰ AI e AM ɪ AM
pear	pʰ AI e AM ə AM
pearl	pʰ AI əː AN ɫ AE
pearls	pʰ AI əː AN ɫ AE z AJ
peculiar	pʰ AI ə̥ AM kʰ AD j̊ AB uː BB l AE j AB ʊ BA ə AM
peel	pʰ AI iː AN ɫ AE
peg	pʰ AI ɛ AM ɡ AC
penchant	p AH ɑ̃ BJ ʃ AJ ɑ̃ BJ
penes	pʰ AI iː AN n AG iː AN z AJ
penis	pʰ AI iː AN n AG ɪ AM s AJ
percuss	p AH ə AM kʰ AD ʌ AM s AJ
performance	p AH ɚ AM f BE ɔ BA ɹ AB m AF ə AM n AG s AJ
person	pʰ AI ɜː AN s AJ n̩ BM
pet	pʰ AI ɛ AM ʔ AL t AC
petting	pʰ AI ɛ AM ɾ BI ɪ AM ŋ AG
phew	ɸ BE j AB u̥ BA
philadelphia	f BE ɪ AM ɫ AE ə AM d AC ɜ AM ɫ AE f BE i AM ə AM
phlebolith	f BE l AE ɛ AM b AH ə AM l AE ɪ AM θ AJ
photo	f BE ə AM ʊ BA tʰ AD ə AM ʊ BA
photograph	f BE ə AM ʊ BA tʰ AD ə̥ AM ɡ AC ɹ̠ ɑː AN f BE
photosynthesis	f BE ə AM ʊ BA tʰ AD ə AM ʊ BA s AJ ɪ AM n̪ AG θ AJ ə AM s AJ ɪ AM s AJ
pick	pʰ AI ɪ AM k AC
piling	pʰ AI a AM ɪ̯ AB ɫ AE l AE ɪ AM ŋ AG
pill	pʰ AI ɪ AM ɫ AE
pin	pʰ AI ɪ AM n AG
pit	pʰ AI ɪ AM ʔ AL t AC
pittance	pʰ AI ɪ AM ʔ AL n̩ BM s AJ
place	pʰ AI l̥ AE e AM ɪ AM s AJ
plack	pʰ AI l̥ AE æ AM k AC
plague	pʰ AI l̥ AE e AM ɪ AM ɡ AC
plain	pʰ AI l̥ AE e AM ɪ AM n AG
plan	pʰ AI l̥ AE æ AM n AG
plane	pʰ AI l̥ AE e AM ɪ AM n AG
plant	pʰ AI l̥ AE ɑː AN n AG t AC
plate	pʰ AI l̥ AE e AM ɪ AM t AC
play	p AH l̥ AE e AM ɪ AM
please	p AH l̥ AE ɪ AM i AM z AJ
poem	pʰ AI ə AM ʊ̯ AK ɪ AM m AF
poetry	p AH ə AM ʊʷ ə AM t AC ɹ AB ɪ AM
poilu	p AH w AK ɑː AN l AE uː BB
polar	pʰ AI ə AM ʊ̯ AK l AE ə AM ɹ AB
pole	pʰ AI o BA ʊ̯ AK ɫ AE
police	p AH ə AM l AE iː AN s AJ
pool	pʰ AI u BA ɫ AE
postal	p AH ə AM ʊ BA s AJ t AC l̩ CA
potato	p AH ə̥ AM tʰ AD e AM ɪ AM tʰ AD ə AM ʊ BA
pressure	p AH ɹ AB ɛ AM ʃ AJ ɚ AM
pretzel	pʰ AI ɹ AB ɛ AM ʔ AL t AC s AJ ɫ̩
prick	pʰ AI ɹ̠̊ ɪ AM k AC
pride	p AH ɹ̥ʷ a AM ɪ AM d AC
priest	p AH ɹ̥ AB iː AN s AJ t AC
prim	pʰ AI ɹ̠̊ ɪ AM m AF
prism	pʰ AI ɹ̠̊ ɪ AM z AJ m̩ BL
prison	pʰ AI ɹ̠̊ ɪ AM z AJ n̩ BM
processors	p AH ɹ AB ə AM ʊ BA s AJ ɛ AM s AJ ə AM z AJ
pronunciation	pʰ AI ɹ AB ə AM n AG ʌ AM n AG s AJ i AM e AM ɪ AM ʃ AJ ə AM n AG
propaganda	p AH ɹ AB ɒ BA p AH ə AM ɡ AC æ AM n AG d AC ə AM
pulchritude	pʰ AI ʌ AM ɫ AE k AC ɹ AB ə AM t AC j AB uː BB d AC
puppy	pʰ AI ɐ BA p AH i AM
purl	pʰ AI əː AN ɫ AE
purls	pʰ AI əː AN ɫ AE z AJ
push	pʷ AH ʊ BA ʃ AJ
put	pʰ AI ʊ BA ʔ AL t AC
putt	pʰ AI ɐ BA t AC
putting	pʰ AI ʌ AM t AC ɪ AM ŋ AG
quaint	kʰ AD w AK e AM ɪ̯ AB n AG t AC
queen	kʷ AH w AK iː AN n AG
quesadilla	kʰ AD e AM ɪ̯ AB s AJ ə AM d AC iː AN l AE j AB ə AM
quick	k AC w̥ AK ɪ AM k AC
quid	kʰ AD w̥ AK ɪ AM d AC
quiff	kʰ AD w̥ AK ɪ AM f BE
quill	kʰ AD w̥ AK ɪ AM l AE
quilt	kʰ AD w̥ AK ɪ AM l AE t AC
quin	kʰ AD w̥ AK ɪ AM n AG
quinn	kʰ AD w̥ AK ɪ AM n AG
quint	kʰ AD w̥ AK ɪ AM n AG t AC
quip	kʰ AD w̥ AK ɪ AM p AH
quit	kʰ AD w̥ AK ɪ AM t AC
quiz	kʰ AD w̥ AK ɪ AM z AJ
rail	ɹ AB e AM ɪ AM ɫ AE
rajgira	ɾ BI ɑː AN d AC ʒ AJ ɡ AC i AM r BD ɑː AN
rambo	ɹ AB æ AM m AF b AH ə AM ʊ BA
reading	ɹ AB iː AN ɾ BI ɪ AM ŋ AG
reconnoiter	ɹʷ ɛ AM k AC ə AM n AG ɔ BA ɪ̯ AB tʰ AD ə AM
reconnoitre	ɹʷ ɛ AM k AC ə AM n AG ɔ BA ɪ̯ AB tʰ AD ə AM
rehearse	ɹ AB ɪ AM h AA ɜː AN s AJ
relative	ɹ AB ɛ AM l AE ə AM ɾ BI ɪ AM v BE
relatively	ɹ AB ɛ AM l AE ə AM ɾ BI ɪ AM v BE l AE i AM
relinquish	ɹ AB ɪ AM l AE ɪ AM ŋ AG k AC w AK ɪ AM ʃ AJ
remote	ɹ AB ɪ AM m AF ə AM ʊ BA t AC
republic	ɹ AB ɪ AM p AH ʌ AM b AH l AE ɪ AM k AC
reticent	ɹ AB ɛ AM d AC ə AM s AJ ə AM n AG t AC
revelry	ɹ AB ɛ AM v BE ə AM ɫ AE ɹ AB i AM
reëvoke	ɹ AB iː AN ʔ AL i AM v BE ə AM ʊ BA k AC
rider	ɹ̠ a AM ɪ AM d AC ə AM
rocks	ɹʷ ɔ BA k AC s AJ
rocky	ɹʷ ɒ BA k AC iː AN
rose	ɹ̠ʷ ə AM ʊ BA z̥ AJ
rub	ɹ AB ɐ BA b AH
rubbed	ɹ AB ʌˑ b̚ d̥ AC
rubber	ɹ AB ɐ BA b AH ə AM ɹ AB
rubbers	ɹ AB ɐ BA b AH ə AM z AJ
ruby	ɹ AB uː BB b AH i AM
rule	ɹ AB uː BB ɫ AE
saddle	s AJ æ AM d AC l̩ CA
sail	s AJ e AM ɪ̯ AB ɫ AE
salami	s AJ ə AM l AE ɑː AN m AF ɪ AM
sang	s AJ ɛ AM ŋ AG
scale	s AJ k AC e AM ɪ̯ AB ɫ AE
scallion	s AJ k AC æ AM l AE ɪ AM ə AM n AG
schemes	s AJ k AC iː AN m AF z̥ AJ
scold	s AJ k AC ɒ BA ʊ BA ɫ AE d AC
screech	s AJ k AC ɹ AB iː AN t AC ʃ AJ
scuttle	s AJ k AC ʌ AM t AC ɫ̩
senpai	s AJ ɛ AM n AG p AH a AM ɪ̯ AB
sentence	s AJ ɛ AM n AG ʔ AL n̩ BM t AC s AJ
servo	s AJ ɜː AN v BE ə AM ʊ BA
shi	ʃ AJ a AM ɪ AM
shouldn't	ʃ AJ ʊ BA n AG ʔ AL
siberia	s AJ a AM ɪ AM b AH ɪ AM ə AM ɹ AB ɪ AM ə AM
siberian	s AJ a AM ɪ AM b AH ɪ AM ə AM ɹ AB ɪ AM ə AM n AG
sigmatism	s AJ ɪ AM ɡ AC m AF ʌ AM t AC ɪ AM z AJ m AF
sixth	s AJ ɪ AM k AC s AJ θ AJ
skillful	s AJ k AC ɪ AM ɫ AE f BE ə AM ɫ AE
skrrt	s AJ k AC r̩ CB ʔ AL
skweee	s AJ k AC w AK iː AN
slaten	s AJ l AE e AM ɪ AM t AC n̩ BM
snares	s AJ n AG ɛː AN z AJ
snash	s AJ n AG a AM ʃ AJ
snow	s AJ n AG ə AM ʊ̯ AK
soil	s AJ ɔ BA ɪ̯ AB ɫ AE
solvent	s AJ ɒ BA l AE v BE ə AM n AG t AC
some	s AJ ɐ BA m AF
something	s AJ ɐ BA m AF θ AJ ɪ AM ŋ AG
somnambulist	s AJ ɒ BA m AF n AG æ AM m AF b AH j AB ʊ BA l AE ɪ AM s AJ t AC
somnambulistic	s AJ ɒ BA m AF n AG æ AM m AF b AH j AB ʊ BA l AE ɪ AM s AJ t AC ɪ AM k AC
sophisticate	s AJ ə AM f BE ɪ AM s AJ t AC ɪ AM k AC ə AM t AC
sorta	s AJ ɔː BB t AC ə AM
sotto	s AJ o BA tː BG o BA
splash	s AJ p AH l AE a AM ʃ AJ
squamation	s AJ k AC w AK e AM ɪ AM m AF e AM ɪ AM ʃ AJ n̩ BM
squander	s AJ k AC w AK ɒ BA n AG d AC ə AM
squee	s AJ k AC w AK iː AN
standardise	s AJ t AC æ AM n AG d AC ə AM ɹ AB d AC a AM ɪ AM z AJ
steel	s AJ t AC iː AN ɫ AE
stirk	s AJ t AC ɜː AN k AC
stope	s AJ t AC o BA ʊ BA p AH
strength	s AJ t̠ AC ɹ̠ ɪ AM ŋ AG k AC θ AJ
strident	s AJ t AC ɹ AB a AM ɪ AM dˀ AL n AG t AC
stripboard	s AJ t AC ɹ AB ɪʰ b AH ɔː BB d AC
strong	ʃ AJ t̠ AC ɹ̠ ɒ BA ŋ AG
structure	s AJ t AC ɹ AB ɐ BA k AC t AC ʃ AJ ə AM ɹ AB
struggle	s AJ t AC ɹ AB ʌ AM ɡ AC l̩ CA
strut	s AJ t AC ɹ AB ɐ BA t AC
subhuman	s AJ ʌ AM b AH h AA j AB uː BB m AF ə AM n AG
substituent	s AJ ʌ AM b AH s AJ t AC ɪ AM t AC ʃ AJ u BA ə AM n AG t AC
subtle	s AJ ʌ AM ɾ BI ɫ̩
subway	s AJ ʌ AM b AH w AK e AM ɪ̯ AB
sudden	s AJ ʌ AM d AC n̩ BM
suggestion	s AJ ə AM d AC ʒ AJ ɛ AM ʃ AJ t AC ʃ AJ ə AM n AG
support	s AJ ə AM pʰ AI ɔː BB t AC
suppose	s AJ ə AM pʰ AI ə AM ʊ BA z AJ
syllable	s AJ ɪ AM l AE ə AM b AH ɫ AE
symbology	s AJ ɪ AM m AF b AH ɒ BA l AE ə AM d AC ʒ AJ i AM
symphony	s AJ ɪ AM ɱ AF f BE ə AM n AG i AM
syndical	s AJ ɪ AM n AG d AC ɪ AM k AC l̩ CA
syntagms	s AJ ɪ AM n AG t AC æ AM m AF z AJ
t'	ː
tab	tʰ AD æ AM b̥ AH
tackle	tʰ AD æ AM k AC ɫ̩
take	tʰ AD e AM ɪ̯ AB k AC
talib	tʰ AD æ AM l AE ɪ AM b AH
talked	tʰ AD ɔː BB k AC t AC
tallit	tʰ AD ɑ AM ɫ AE ɪ AM s AJ
tampon	tʰ AD æ AM m AF p AH ɒ BA n AG
tap	tʰ AD æ AM p AH
tape	tʰ AD e AM ɪ̯ AB p AH
tapestry	t AC æ AM p AH ə AM s AJ t AC ʃ AJ ɹ AB i AM
taring	t AC ɛ AM ə AM ɹ AB ɪ AM ŋ AG
tarter	t AC ɑː AN t AC ə AM ɹ AB
tattoo	tʰ AD æ AM tʰ AD u̟ː BB
tea	tʰ AD iː AN
teal	t AC iː AN ɫ AE
teared	t AC ɪː AN d AC
tearing	t AC ɪ AM ə AM ɹ AB ɪ AM ŋ AG
tech	tʰ AD ɛ AM k AC
tej	t AC ɛ AM d AC ʒ AJ
telangana	t̪ AC ɛ AM l AE ə AM ŋ AG ɡ AC ɑː AN n AG ə AM
ten	tʰ AD ɛ AM n AG
tenth	tʰ AD ɛ AM n̪ AG θ AJ
thagomizer	θ AJ æ AM ɡ AC ə AM m AF a AM ɪ AM z AJ ə AM
thank	θ AJ a AM ŋ AG k AC
theosophy	θ AJ ɪ AM ɒ BA s AJ ə AM f BE ɪ AM
theriac	θ AJ ɛ AM ɹ AB i AM ə AM k AC
thickie	θ AJ ɪ AM k AC i AM
thousand	θ AJ a AM ʊ BA z AJ n̩ BM d AC
thread	θ AJ ɾ̪̊ BI ɛ AM d AC
three	θ AJ ɾ̪̊ BI ɪ AM i AM
thrice	θ AJ ɾ̪̊ BI ɑ AM ɪ AM s AJ
thrill	θ AJ ɾ̪̊ BI ɪ AM ɫ AE
throne	θ AJ ɹ AB ə AM ʊ BA n AG
through	θ AJ ɾ̪̊ BI ɵ BA ʉ BA
throughout	θ AJ ɹ AB uːʷ a AM ʊ BA t AC
throw	θ AJ ɾ̪̊ BI ə AM ʊ BA
timber	t AC ɪˑ m AF b AH əː AN
time	tʰ AD a AM ɪ AM m AF
tin	tʰ AD ɪ AM n AG
tiptoe	tʰ AD ɪ AM p AH tʰ AD ə AM ʊ̯ AK
titty	tʰ AD ɪ AM ɾ BI i AM
to	tʰ AD u̟ː BB
tomato	tʰ AD ə̥ AM m AF ɑː AN tʰ AD ə AM ʊ BA
too	tʰ AD u̟ː BB
top	tʰ AD ɒˀ p AH
toronto	tʰ AD ə AM ɹ AB ɒ BA ɾ̃ CC ə AM
towards	tʰ AD ə̥ AM w AK ɔː BB d AC z AJ
town	tʰ AD a AM ʊ̯ AK n AG
trace	t AC ʃ AJ ɹ AB e AM ɪ AM s AJ
tracer	t AC ʃ AJ ɹ AB e AM ɪ AM s AJ ə AM ɹ AB
traditionally	t AC ɹ AB ɪ AM d AC ɪ AM ʃ AJ n̩ BM l AE i AM
train	t̠ AC ɹ̠̝ʷ e AM ɪ AM n AG
trainee	t AC ʃ AJ ɹ AB e AM ɪ AM n AG i AM
trainees	t AC ʃ AJ ɹ AB e AM ɪ AM n AG i AM z AJ
transcaucasia	t AC ɹ AB æ AM n AG s AJ k AC ɔː BB k AC e AM ɪ AM ʒ AJ ə AM
trap	t̠ AC ɹ̝̊ ä p AH
tree	t̠ AC ɹ̠̊ʷ ɪ AM i̯ AB
trick	t̠ʰ AD ɹ̠̊ ɪ AM k AC
trig	t̠ʰ AD ɹ̠̊ ɪ AM ɡ AC
trill	t̠ʰ AD ɹ̠̊ ɪ AM l AE
trim	t̠ʰ AD ɹ̠̊ ɪ AM m AF
trinal	t AC ɹ AB ʌ AM ɪ AM n̩ BM l AE
trip	t̠ʰ AD ɹ̠̊ ɪ AM p AH
trope	t AC ɹ̥ AB ə AM ʊ BA p AH
trust	t AC ɹ AB ʌ AM s AJ t AC
tsk	ǀ
tucker	tʰ AD ʌ AM k AC ə AM
turning	t AC ɚ AM n AG ɪ AM ŋ AG
tut	ǀ
twain	tʰ AD w̥ AK e AM ɪ AM n AG
twat	tʰ AD w̥ AK æ AM t AC
twelfth	tʰ AD w̥ AK ɛ AM l̪ AE θ AJ
twelve	t AC w̥ AK ɛ AM ɫ AE v BE
twentieth	t AC w̥ AK ɛ AM ɾ̃ CC i AM ə AM θ AJ
twenty	t AC w̥ AK ɛ̃ BJ n AG t AC i AM
twerk	t AC w̥ AK ɜː AN k AC
twice	t AC w̥ AK a AM ɪ AM s AJ
twin	t AC w̥ AK ɪ AM n AG
twink	tʰ AD w̥ AK ɪ AM ŋ AG k AC
twist	t AC w̥ AK ɪ AM s AJ t AC
twit	tʰ AD w̥ AK ɪ AM t AC
twitch	tʰ AD w̥ AK ɪ AM t AC ʃ AJ
two	tʰ AD u̟ː BB
twos	tʰ AD u̟ː BB z AJ
typewriter	t AC a AM ɪ AM p AH ɹ AB a AM ɪ AM t AC ə AM ɹ AB
ugh	ʌ AM
unacceptable	ɐ BA n AG ə AM k AC s AJ ɛ AM p AH tʰ AD ə AM b AH ɫ̩
uncle	ɐ BA ŋ AG k AC ɫ̩
under	ɐ BA n AG d AC ə AM ɹ AB
unfair	ɐ BA n AG f BE ɛː AN ɹ AB
unilateral	j AB ʉː BB n AG ɪ AM l AE æ AM t AC ʃ AJ ɹ AB ɫ̩
unisex	j AB uː BB n AG ɪ AM s AJ ɛ AM k AC s AJ
unnerstand	ɜ AM ɽ̃ CC ɻ AJ s AJ t AC æ AM n AG d̚
untac	j AB u BA ɛ AM n AG t AC ɪ AM ɛ AM j AB s AJ iː AN
untaet	j AB u BA ɛ AM n AG t AC i AM ɛ AM j AB ɪ AM t AC iː AN
up	ɐ BA ʔ AL p AH
usher	ʌ AM ʃ AJ ə AM ɹ AB
utter	ɐ BA t AC ə AM
vajazzle	v BE ə AM d AC ʒ AJ æ AM z AJ l̩ CA
vale	v BE e AM ɪ AM ɫ AE
verbal	v BE ɜː AN b AH ɫ̩
versatile	v BE ɜː AN s AJ ə AM t AC a AM ɪ AM ɫ AE
veteran	v BE ɛ AM ɾ BI ə AM ɹ AB ə AM n AG
veto	v BE iː AN ɾ BI o BA ʊ BA
vicissitude	v BE ɨ AM s AJ ɪ AM s AJ ɨ AM t AC j AB uː BB d AC
vicissity	v BE ɪ AM s AJ ɪ AM s AJ ɨ AM t AC i AM
vindical	v BE ɪ AM n AG d AC ɪ AM k AC l̩ CA
virtually	v BE ɚ AM t AC ʃ AJ u BA ə AM ɫ AE i AM
vlach	v BE l AE ɑː AN k AC
vocab	v BE ə AM ʊ BA k AC æ AM b AH
wail	w AK e AM ɪ AM ɫ AE
waistband	w AK e AM ɪ AM s AJ t AC b AH æ AM n AG d AC
waiting	w AK e AM ɪ̯ AB ɾ BI ɪ AM ŋ AG
wale	w AK e AM ɪ AM ɫ AE
wales	w AK e AM ɪ AM ɫ AE z AJ
wanted	w AK ɒ BA n AG tʰ AD ɪ AM d AC
wasn't	w AK ɒ BA z AJ n̩ BM ʔ AL
wealth	w AK ɛ AM l̪ AE θ AJ
wean	w AK eː AN n AG
weeaboos	w AK iː AN a AM b AH yː BB z AJ
welp	w AK ɛ AM l AE p̚
westside	w AK ɛ AM s AJ t AC s AJ a AM ɪ AM d AC
whew	ʍ BK ĭ̥ ŭ̥
whole	h AA ə AM ʊ BA ɫ AE
wholemeal	h AA ɔ BA ʊ BA ɫ AE m AF i AM ə AM ɫ AE
wholly	h AA ə AM ʊ BA l AE ɪ AM
width	w AK ɪ AM d̪ AC θ AJ
wieldy	w AK ɪ AM ə AM l AE d AC ɪ AM
wilde	w AK a AM ɪ AM ə̯ AB ɫ AE d AC
will	w AK ɪ AM ɫ AE
winter	w AK ɪ AM ɾ̃ CC ɚ AM
wisconsin	w AK ə AM s AJ kʰ AD ɑ AM n AG s AJ n̩ BM
wouldn't	w AK ʊ BA ɾ BI ə AM n AG t AC
wrake	ɹ AB e AM ɪ̯ AB kʰ AD
writer	ɹ̠ a AM ɪ AM tʰ AD ə AM
www	d AC ʌ AM ɥ AK ʊ̆ CD d AC ʌ AM ɥ AK ʊ̆ CD d AC ʌ AM bˡ j AB u BA
xxx	ʔ AL ɛ AM k AC s AJ ʔ AL ɛ AM k AC s AJ ʔ AL ɛ AM k AC s AJ
yatt	j AB æ AM t AC
yep	j AB ɛ AM p̚
yive	j AB ɪ AM v BE
yolngu	j AB oː BB l AE ŋ AG ʊ BA
yum	j AB ʌ AM m AF
zarina	z AJ ʌ AM ɹʲ i AM n AG ə AM
zemfira	z AJ ɪ AM ɱ AF f BE i AM ɹ AB ə AM
ziti	z AJ i AM ɾ BI i AM
zooplasty	z AJ ə AM ʊ BA ə AM p AH l AE æ AM s AJ t AC i AM
zun	z AJ ʌ AM n AG
übermensch	ʔ AL yː BB b AH ɐ BA m AF ɛ AM n AG ʃ AJ
