'kay	ʔ AL kʰ AD e AM ɪ̯ AB
'll	ʊ BA
abode	ʔ AL ə AM b AH o BA ʊː BB d̥̚
accend	æ AM k AC s AJ ɛ AM n AG d AC
accommodate	ə AM kʰ AD ɑ AM m AF ə AM d AC e AM ɪ AM t AC
accommodator	ə AM k AC ɑ AM m AF ə AM d AC e AM ɪ AM t AC ɚ AM
accordable	ə AM kʰ AD ɔ BA r BD ɾ BJ ə AM b AH ɫ̩
accordantly	ə AM kʰ AD ɔ BA ɹ AB ɾ BJ ɨ̞ AM n AG ʔ AL ɫ AE i AM
accreditation	ə AM k AC ɹ AB ɛ AM d AC ɨ AM ɾ BJ e AM ɪ AM ʃ AJ ə AM n AG
acidophilus	æ AM s AJ ɪ AM d AC ɑ AM f BE ɪ AM l AE ə AM s AJ
acknowledge	ɨ AM ɡ AC n AG ɑː AN l AE ɨ AM d AC ʒ AJ
adam	æ AM ɾ BJ ə AM m AF
added	æ AM ɾ BJ ɪ AM d AC
additive	æ AM ɾ BJ ə AM ɾ BJ ɪ AM v BE
adelaide	æ AM d AC ɜ AM l AE æ AM ɪ̯ AB d AC
aelita	a AM ɪ̯ AB l AE i AM ɾ BJ ə AM
aerose	i AM ɹ AB ə AM ʊ BA z AJ
agglutinin	ə AM ɡ AC l AE uː BB ʔ AL n̩ BM ɪ AM n AG
aha	ə AM h AA ɑ AM
alacrity	ə AM l AE æ AM k AC ɹ AB ɨ AM t AC i AM
alder	ɑ AM l AE d AC ɚ AM
alders	ɔ BA l AE d AC ɚ AM z AJ
alienation	e AM ɪ AM l AE i AM ə AM n AG e AM ɪ AM ʃ AJ ə AM n AG
alignment	ə AM ɫ AE a AM ɪ AM n AG m AF ə AM n AG t AC
allergic	ə AM l AE ɚ AM d AC ʒ AJ ɪ AM k AC
allergies	æ AM l AE ɚ AM d AC ʒ AJ i AM z AJ
allergy	æ AM l AE ɚ AM d AC ʒ AJ i AM
alliteration	ə AM l AE ɪ AM ɾ BJ ə AM ɹ AB e AM ɪ AM ʃ AJ ə AM n AG
almanac	ɔ BA l AE m AF ə AM n AG æ AM k AC
alpha	æ AM ɫ AE f BE ə AM
am	ẽ ə̃ː BI m AF
amazing	ə AM m AF e AM ɪ̯ AB z AJ ɪ AM ŋ AG
amity	æ AM m AF ɪ AM ɾ BJ i AM
amphibious	æ AM m AF f BE ɪ AM b AH i AM ə AM s AJ
analects	æ AM n AG ə AM l AE ɛ AM k AC t AC s AJ
andrew	æ AM n AG d AC ʒ AJ ɹ AB ʊ̈ BA u BA
angst	e AM ɪ AM ŋ AG k AC s AJ t AC
angsts	e AM ɪ AM ŋ AG k AC s AJ t AC s AJ
anselm	æ AM n AG s AJ ɛ AM l AE m AF
antarctica	æ AM ɾ̃ CB ɑ AM ɹ AB ɾ BJ ɪ AM k AC ə AM
anthropomorphic	æ̃ BH n̪ AG θ AJ ɹ̠ ə AM p AH ə AM m AF ɔ BA ɹ̠ f BE ɪ̈ AM k AC
antre	æ AM n AG ɾ BJ ɚ AM
app	ʔ AL æ AM ʔ AL p̚
appear	ə AM pʰ AI i AM ɹ AB
apple	æ AM p AH ɫ̩
appled	æ AM p AH ɫ̩ d AC
arbitration	ɑ AM ɹ AB b AH ə AM t̠ AC ɹ̠ e AM ɪ AM ʃ AJ n̩ BM
aristotle	ɛ AM r BD ɪ AM s AJ t AC ɑ AM ɾ BJ ɫ̩
arlon	ɑː AN ɫ AE ɔː BB n AG
article	ɑː AN ɹ AB ɾ BJ ɨ AM k AC ɫ AE
artina	ɑ AM ɹ AB tʰ AD i AM n AG ə AM
artisanal	ä ɹ AB t AC ə AM z AJ æ AM n AG ə AM l AE
asked	æ AM s AJ t AC
assertion	ə AM s AJ ɚ AM ʃ AJ n̩ BM
atend	ə AM tʰ AD ɛ AM n AG d AC
attack	ə AM tʰ AD æ AM k AC
attar	æ AM t̬ ə AM ɹ AB
attend	ə AM tʰ AD ɛ AM n AG d AC
attic	æ AM ɾ BJ ɪ AM k AC
attitude	æ AM ɾ BJ ɪ AM t AC u BA d AC
attraction	ə AM t AC ʃ AJ ɹ AB æ AM k AC ʃ AJ ɪ̈ AM n AG
attrition	ə AM t AC ɹ AB ɪ AM ʃ AJ ə AM n AG
aula	ɔː BB l AE a AM
authenticity	ɑ AM θ AJ ɛ AM n AG t AC ɪ AM s AJ ɪ AM ɾ BJ i AM
auto	ɔ BA ɾ BJ o BA ʊ BA
automate	ɒ BA ɾ BJ o BA ʊ BA m AF e AM ɪ AM t AC
automatic	ɔ BA ɾ BJ ə AM m AF æ AM ɾ BJ ɪ AM k AC
autumn	ɔ BA ɾ BJ ɪ̈ AM m AF
availability	ə AM v BE e AM ɪ AM l AE ə AM b AH ɪ AM l AE ɪ AM t AC ɪ AM
avocado	ɑ AM v BE ə AM k AC ɑ AM ɾ BJ o BA ʊ BA
awara	ɑ AM w AK ʌ AM ɹ AB ʌ AM
ayuh	ˀe ɪ AM ʌˀ
baa	b AH ɑ AM
back	b AH æ AM k AC
bacterial	b AH æ AM k AC t AC ɪ AM ə AM ɹ AB i AM ə AM ɫ AE
badder	b AH æ AM ɾ BJ ɚ AM
baedeker	b AH e AM ɪ AM d AC ə AM k AC ə AM ɹ AB
bail	b AH e AM ɪ̯ AB ə AM ɫ AE
balancelle	b AH æ AM l AE ə AM n AG s AJ e AM ɫ AE
baldric	b AH ɔː BB ɫ AE d AC ɹ AB ɪ AM k AC
bale	b AH e AM ɪ̯ AB ə AM ɫ AE
balt	b AH ɔː BB l AE t AC
bar	b AH ɑ AM ˞
bard	b AH ɑ AM ɹ AB d AC
barn	b AH ɒ BA ə AM n AG
barrel	b AH ɛ AM ɚ AM ɹ AB ə AM ɫ AE
barter	b AH ɑ AM ɹ AB ɾ BJ ɚ AM
basal	b AH e AM ɪ AM z AJ ə AM ɫ AE
bashful	b AH æ AM ʃ AJ f BE ʊ BA ɫ AE
bashkortostan	b AH ɑ AM ʃ AJ k AC ɔ BA ɹ AB t AC o BA ə̯ AB s AJ t AC ɛ AM ə AM n AG
bath	b AH ɑː AN θ AJ
batter	b AH æ AM ɾ BJ ɚ AM
battle	b AH æ AM ɾ BJ ɫ̩
batty	b AH æ AM ɾ BJ i AM
baulk	b AH ɔ BA ɫ AE k AC
bautzen	b AH a AM ʊ BA t AC s AJ ə AM n AG
beagle	b AH iː AN ɡ AC ə AM ɫ AE
beared	b AH ɛː AN d AC
beater	b AH i AM ɾ BJ ɚ AM
beatles	b AH iː AN ɾ BJ ɫ̩ z AJ
beauty	b AH j AB u BA ɾ BJ i AM
bedding	b AH ɛ AM ɾ BJ ɪ AM ŋ AG
bedight	b AH ɪ AM d AC ʌ AM ɪ AM t AC
beetle	b AH i AM ɾ BJ ə AM ɫ AE
befang	b AH ə AM f BE æ AM ŋ AG
belarus	b AH ɛ AM l AE ɪ̈ AM ɹ AB u BA s AJ
berlin	b AH ɚ AM l AE ɪ AM n AG
bestride	b AH ɪ AM s AJ t AC ɹ AB a AM ɪ AM d AC
better	b AH ɛ AM ɾ BJ ɚ AM
betther	b AH ɛ AM t̪ AC ɚ AM
betting	b AH ɛ AM ɾ BJ ɪ AM ŋ AG
between	b AH ɪ AM tʰ AD w AK i AM n AG
bidet	b AH ɨ AM d AC e AM ɪ AM
bike	b AH ɐ BA ɪ AM k AC
bill	b AH ɪ AM ɫ AE
bing	b AH i AM ŋ AG
bird	b AH ɚ AM ɖ AC
bitey	b AH a AM ɪ̯ AB ɾ BJ i AM
bitter	b AH ɪ AM ɾ BJ ɚ AM
bittersweet	b AH ɪ AM ɾ BJ ɚ AM s AJ w AK i AM ʔ AL t̚
bitty	b AH ɪ AM ɾ BJ i AM
blem	b AH l AE ɛ AM m AF
blicky	b AH l AE ɪ AM k AC i AM
bluntness	b AH l AE ʌ AM n AG ʔ AL n AG ɪ AM s AJ
boated	b AH o BA ʊ̯ AK ɾ BJ ɨ AM d AC
boating	b AH o BA ʊ̯ AK ɾ BJ ɪ AM ŋ AG
boatings	b AH o BA ʊ̯ AK ɾ BJ ɪ AM ŋ AG z AJ
bockety	b AH ɑ AM k AC ə AM t AC iː AN
boded	b AH o BA ʊ̯ AK d AC ɨ AM d AC
body	b AH ɑ AM ɾ BJ i AM
bodybuilder	b AH ɑː AN ɾ BJ i AM b AH ɪ AM ɫ AE ɾ BJ ɚ AM
bother	b AH ɑ AM ð AJ ɚ AM
bottle	b AH ɑ AM ɾ BJ ɫ̩
bottler	b AH ɑ AM ɾ BJ l̩ BN ɚ AM
bottom	b AH ɑ AM ɾ BJ ə AM m AF
bottoms	b AH ɑ AM ɾ BJ ə AM m AF s AJ
bountiful	b AH a AM ʊ̯ AK n AG ɾ BJ ə AM f BE ə AM ɫ AE
boutye	b AH ɐ BA ʏ BA t AC ʃ AJ ə AM
brakeforce	b AH ɹ AB e AM ɪ AM k AC f BE ɔː BB ɹ AB s AJ
brattily	b AH ɹ AB æ AM ɾ BJ ɪ AM l AE i AM
bratty	b AH ɹ AB æ AM ɾ BJ i AM
breach	b AH ɹ AB iː AN t AC ʃ AJ
break	b AH ɹʷ e AM ɪ̯ AB k AC
bricolage	b AH ɹ AB i AM k AC o BA ʊ BA l AE ɑ AM ʒ AJ
brighten	b AH ɹ AB a AM ɪ̯ AB ʔ AL n̩ BM
brighter	b AH ɹ AB a AM ɪ̯ AB ɾ BJ ɚ AM
brighton	b AH ɹ AB a AM ɪ̯ AB ʔ AL ə AM n AG
britain	b AH ɹ AB ɪ AM ʔ AL n̩ BM
british	b AH ɹ AB ɪ AM ʔ AL ɪ AM ʃ AJ
broha	b AH ɹ AB o BA ʊ̯ AK h AA ɑ AM
buccopalatal	b AH ʌ AM kʰ AD o BA ʊː BB pʰ AI æː AN l AE ə AM ɾ BJ ɫ̩
builder	b AH ɪ AM ɫ AE ɾ BJ ɚ AM
bumboclaat	b AH ʌ AM m AF b AH ə AM k AC l AE ɑ AM t AC
burglar	b AH ɚ AM ɡ AC l AE ɚ AM
butted	b AH ʌ AM ɾ BJ ɨ AM d AC
butter	b AH ʌ AM ʔ AL ɚ AM
butterfly	b AH ʌ AM ɾ BJ ɚ AM f BE l AE a AM ɪ AM
butting	b AH ʌ AM ɾ BJ ɪ AM ŋ AG
buttings	b AH ʌ AM ɾ BJ ɪ AM ŋ AG z AJ
buttock	b AH ə AM ɾ BJ ə AM k AC
button	b AH ʌ AM ʔ AL n̩ BM
cacao	k AC ə AM kʰ AD e AM ɪ̯ AB o BA ʊ̯ AK
cacoepy	k AC ə AM k AC ə AM ʊ BA ɪ AM p AH ɪ AM
cadel	kʰ AD e AM i AM d AC l̩ BN
cain	kʰ AD e AM ɪ AM n AG
caisson	k AC e AM ɪ AM s AJ ɑ AM n AG
cake	kʰ AD e AM ɪ AM k AC
calculator	kʰ AD æ AM ɫ AE k AC j AB ə AM l AE e AM ɪ̯ AB ɾ BJ ɚ AM
calendar	kʰ AD æ AM l AE ə AM n AG d AC ɚ AM
call	kʰ AD ɔ BA ɫ AE
called	k AC ɔ BA l AE d AC
cam	k AC æ AM m AF
cambodia	k AC æ AM m AF b AH o BA ʊ BA d AC i AM ə AM
came	kʰ AD e AM ɪ̯ AB m AF
camp	kʰ AD ɛ AM ə AM m AF p AH
can	kʰ AD ɛ AM ə AM n AG
canada	kʰ AD ɛ AM ə AM n AG ə AM d AC ə AM
canadia	kʰ AD ə AM n AG e AM ɪ̯ AB ɾ BJ i AM ə AM
canadian	kʰ AD ə AM n AG e AM ɪ AM ɾ BJ i AM ə AM n AG
cane	kʰ AD e AM ɪ AM n AG
cap	kʰ AD æ AM p AH
cap'n	k AC æ AM ʔ AL m̩ BL
cappadocia	k AC æ AM p AH ə AM d AC o BA ʊ BA ʃ AJ ə AM
caramba	k AC a AM ɹ AB a AM m AF b AH a AM
carbuncle	kʰ AD ɑ AM ɹ AB b AH ʌ AM ŋ AG k AC l̩ BN
card	kʰ AD ɑ AM ɹ AB d AC
care	k AC ɛ AM ə̯ AB ɻ AJ
carload	kʰ AD ɑ AM ɹ AB l AE o BA ʊ BA d AC
carton	kʰ AD ɑ AM ɹ AB ʔ AL n̩ BM
carving	k AC ɑ AM ɹ AB v BE ɪ AM ŋ AG
casserole	k AC æ AM s AJ ɚ AM ɔ̹ ɫ AE
cat	kʰ AD æ AM t̚
cater	kʰ AD e AM ɪ̯ AB ɾ BJ ɚ AM
cathedra	k AC ə AM θ AJ iː AN d AC ɹ AB ə AM
catty	kʰ AD æ AM ɾ BJ i AM
caucasian	k AC ɔː BB k AC e AM ɪ AM ʒ AJ ə AM n AG
caught	k̠ʰ oː BB t AC
cause	kʰ AD ɒː BB z̥ AJ
caused	kʰ AD ɒ BA z AJ d AC
cauterize	kʰ AD ɔ BA ɾ BJ ə AM ɹ AB a AM ɪ AM z AJ
cavity	kʰ AD æ AM v BE ɪ AM ɾ BJ i AM
ceili	k AC e AM ɪ AM l AE i AM
center	s AJ ɪ AM ɾ̃ CB ɚ AM
centre	s AJ ɪ AM ɾ̃ CB ɚ AM
centres	s AJ ɪ AM ɾ̃ CB ɚ AM s AJ
cereal	s AJ ɪ AM ə AM ɹ AB iː AN ə AM ɫ AE
certification	s AJ ɚ AM ɾ BJ ɪ AM f BE ɪ AM k AC e AM ɪ AM ʃ AJ ə AM n AG
chance	t AC ʃʰ CF ɛ AM ə AM n AG s AJ t AC ʃʰ CF e AM ə AM n AG s AJ
chaparral	ʃ AJ æ AM p AH ɚ AM ɹ AB ɛ AM l AE
char	t AC ʃ AJ ɑ AM ˞
charnel	t AC ʃ AJ ɑː AN ɹ AB n AG ə AM l AE
chartreuse	ʃ AJ ɑ AM ɹ AB t AC ɹ AB uː BB z AJ
chastity	t AC ʃ AJ æ AM s AJ t AC ɪ AM ɾ BJ i AM
chatted	t AC ʃ AJ æ AM ɾ BJ ɨ AM d AC
chatty	t AC ʃ AJ æ AM ɾ BJ i AM
chaver	h AA ɑ AM v BE ɛ AM ɹ AB
cheated	t AC ʃ AJ i AM ɾ BJ ɨ AM d AC
children	t AC ʃ AJ ɪ AM l AE d̠ AC ɹ̠̝ʷ ə AM n AG
china	t AC ʃʰ CF a AM ɪ̯ AB n AG ə AM
chitterlings	t AC ʃ AJ ɪ AM ɾ BJ ɚ AM l AE ɪ AM ŋ AG z AJ
choo	t AC ʃ AJ uː BB
chortle	t AC ʃ AJ ɔ BA ɹ AB ɾ BJ ɫ̩
cicada	s AJ ɪ̈ AM kʰ AD ɑ AM ɾ BJ ə AM
circle	s AJ ɚ AM k AC ə AM ɫ AE
circuit	s AJ ɚ AM k AC ə AM t AC
cital	s AJ a AM ɪ AM d AC l̩ BN
citation	s AJ a AM ɪ AM tʰ AD e AM ɪ AM ʃ AJ n̩ BM
cited	s AJ ɐ BA ɪ̯ AB ɾ BJ ɨ AM d AC
citing	s AJ a AM ɪ̯ AB ɾ BJ ɪ AM ŋ AG
clay	k AC l̥ AE e AM ɪ AM
clean	kʰ AD l̥ AE ĩ n AG
cleanup	k AC l AE iː AN n AG ʌ AM p AH
click	kʰ AD l̥ AE ɪ AM k AC
cliff	k AC l̥ʰ ɪ AM f BE
climb	kˡ l AE a AM ɪ AM m AF
clip	k AC l̥ʰ ɪ AM p AH
clit	k AC l̥ʰ ɪ AM t AC
clutter	k AC l AE ʌ AM ɾ BJ ɚ AM
coach	kʰ AD o BA ʊ̯ AK t AC ʃ AJ
coated	kʰ AD o BA ʊ̯ AK ɾ BJ ɨ AM d AC
coating	kʰ AD o BA ʊ̯ AK ɾ BJ ɪ AM ŋ AG
coatings	kʰ AD o BA ʊ̯ AK ɾ BJ ɪ AM ŋ AG z AJ
coccus	kʰ AD ɑ AM k AC ə AM s AJ
coconut	kʰ AD o BA ʊ̯ AK k AC ə AM n AG ʌ AM t AC
collaboration	kʰ AD ə AM l AE æ AM b AH ə AM ɹ AB e AM ɪ̯ AB ʃ AJ ə AM n AG
come	kʰ AD ʌ AM m AF
comfort	kʰ AD ʌ AM ɱ AF f BE ɚ AM t AC
comfortable	kʰ AD ʌ AM ɱ AF f BE tʰ AD ə̥ AM b AH ɫ̩
comfy	kʰ AD ʌ AM ɱ AF f BE i AM
comment	kʰ AD ɑ AM m AF ɛ AM n AG t AC
committee	k AC ə AM m AF ɪ AM t AC i AM
community	k AC ə AM m AF j AB u BA n AG ə AM ɾ BJ i AM
compare	k AC ə AM m AF p AH ɛ AM ɹ AB
comptroller	k AC ə AM m AF t AC ɹ AB o BA ʊ BA l AE ə AM ɹ AB
computer	k AC ə AM m AF pʰ AI j AB u BA ɾ BJ ɚ AM
concoct	kʰ AD ə AM ŋ AG kʰ AD ɒ BA k AC t AC
concoction	kʰ AD ə AM ŋ AG kʰ AD ɑ AM k AC ʃ AJ ɪ AM n AG
confer	kʰ AD ə̥ AM ɱ AF f BE ɚ AM
conference	kʰ AD ɑ AM ɱ AF f BE ɹ AB ə AM n AG s AJ
confident	kʰ AD ɑ AM ɱ AF f BE ə AM d AC n̩ BM t AC
confirmation	kʰ AD ɑ AM ɱ AF f BE ɚ AM m AF e AM ɪ AM ʃ AJ n̩ BM
conservancy	k AC ə AM n AG s AJ ɜː AN v BE ə AM n AG s AJ ɪ AM
consider	k AC ə AM n AG s AJ ɪ AM ɾ BJ ɚ AM
consigliere	k AC ɒ BA n AG s AJ ɪ AM l AE j AB ɛ AM ɹ AB i AM
consonantal	kʰ AD ɑ AM n AG s AJ ə AM n AG ə AM n AG ɾ BJ ə AM ɫ AE
contestant	k AC ə AM n AG tʰ AD ɛ AM s AJ t AC ə AM n AG t AC
conversation	kʰ AD ɑ AM ɱ AF v BE ɚ AM s AJ e AM ɪ AM ʃ AJ n̩ BM
convert	kʰ AD ə̥ AM ɱ AF v BE ɚ AM t AC
corncob	k AC ɔ BA ɹ AB n AG k AC ɑ AM b AH
corrode	k AC ɚ AM ɹ AB o BA ʊ̯ AK d AC
cot	kʰ AD ɑ AM t̚
coterie	k AC o BA ʊ BA ɾ BJ ə AM ɹ AB i AM
cottage	k AC ɑ AM ɾ BJ ɪ AM d AC ʒ AJ
cotton	k AC ɑ AM ʔ AL n̩ BM
cougar	kʰ AD u BA ɡ AC ɚ AM
coulda	kʰ AD ʊ BA d AC ə AM
couldn't	k AC ʊ BA n AG ʔ AL
countable	kʰ AD a AM ʊ BA n AG ɾ BJ ə AM b AH ɫ̩
counter	kʰ AD a AM ʊ̯ AK ɾ̃ CB ɚ AM
counterintuitive	kʰ AD a AM ʊ BA ɾ̃ CB ɚ AM ɪ AM n AG tʰ AD u BA ɪ AM ɾ BJ ɪ AM v BE
country	kʰ AD ʌ AM n AG t̠ AC ɹ̠̊ʷ i AM
cousin	kʰ AD ɐ BA z AJ ə AM n AG
coventry	kʰ AD ɑ AM v BE ə AM n AG t AC ʃ AJ ɹ AB i AM
crayon	kʰ AD ɹ AB e AM ɪ AM ɑ AM n AG
craytur	k AC ɹ AB eː AN t̪ AC ə AM ɹ AB
creation	k AC ɹ AB iːʲ e AM ɪ AM ʃ AJ ɘ AM n AG
creep	kʰ AD ɹ AB iː AN p AH
crikey	k AC ɹ AB ɑ AM e̯ AB k AC ɪ AM i̯ AB
crocodile	kʰ AD ɹ AB ɑ AM k AC ə AM d AC a AM ɪ AM ɫ AE
croissant	kʰ AD ɹ AB ə AM s AJ ɑ AM n AG t AC
croton	k AC ɹ AB o BA ʊ̯ AK ʔ AL n̩ BM
crumble	k AC ɹ AB ʌ AM m AF b AH ɪ̈ AM l AE
cryptography	k AC ɹ̥ AB ɪ AM p AH tʰ AD ɒ BA ɡ AC ɹ AB ə AM f BE iː AN
cuba	k AC j AB uː BB b AH ə AM
cuban	k AC j AB ʉː BB b AH ə AM n AG
cue	k AC j̥ AB ʉː BB
culprit	kʰ AD ʌ AM ɫ AE p AH ɹ AB ɪ AM t AC
cum	kʰ AD ʌ AM m AF
cunt	kʰ AD ʌ̃ BH n AG t AC
cur	k AC ɚ AM
cursed	kʰ AD ɚ AM s AJ ɪ̈ AM d AC
cursor	kʰ AD ɜ AM ˞ s AJ ə AM ˞
curtain	k AC ɚ AM ʔ AL n̩ BM
cylinder	s AJ ɪ AM l AE ɪ̈ AM n AG d AC ɚ AM
cymbal	s AJ ɪ AM m AF b AH ɫ̩
dance	d AC ɛ AM ə AM n AG s AJ
dandle	d AC æ AM n AG d AC ə AM ɫ AE
daniel	d AC a AM n AG j AB ə AM l AE
data	d AC æ AM ɾ BJ ə AM
daughter	d AC ɔ BA ɾ BJ ɚ AM
dayouth	d AC æ AM jː BG uː BB θ AJ
dayum	d AC æ̙ j AB ə AM m AF
dean	d AC ĩː n AG
deity	d AC i AM ə AM ɾ BJ i AM
delightful	d AC ə AM l AE a AM ɪ̯ AB t̚ f BE ə AM ɫ AE
delta	d AC ɛ AM ɫ AE t AC ə AM
density	d AC ɛ AM n AG s AJ ə AM ɾ BJ i AM
dental	d AC ɛ AM ɾ̃ CB ɫ̩
denton	d AC ɪ AM n AG ʔ AL n̩ BM
desirable	d AC ɪ AM z AJ a AM ɪ AM j AB ə AM ɹ AB ə AM b AH ə AM ɫ AE
desktop	d AC ɛ AM s AJ k AC t AC ɑ AM p AH
desktops	d AC ɛ AM s AJ k AC t AC ɑ AM p AH s AJ
diabolical	d AC a AM ɪ AM ə AM b AH ɑ AM l AE ɪ AM k AC ə AM ɫ AE
didn't	d AC ɪ AM ʔ AL n̩ BM t AC
differential	d AC ɪ AM f BE ə AM ɹ AB ə AM n AG ʃ AJ ə AM ɫ AE
dildo	d AC ɪ AM ɫ AE d AC o BA ʊ BA
dingaling	d AC ɪ AM ŋ AG ə AM l AE ɪ AM ŋ AG
dingwad	d AC ɪ AM ŋ AG w AK ɑ AM d AC
dinner	d AC ɪ AM n AG ɚ AM
dirty	d AC ɚ AM ɾ BJ i AM
disburse	d AC ɪ AM s AJ p AH ɚ AM s AJ
disentangle	d AC ɪ AM s AJ ɪ AM n AG t AC æ AM ŋ AG ɡ AC ə AM ɫ AE
disentitle	d AC ɪ AM s AJ ɪ AM n AG t AC a AM ɪ AM t AC ə AM ɫ AE
disgust	d AC ɪ AM s AJ k AC ʌ AM s AJ t AC
dismal	d AC ɪ AM z AJ m AF ə AM ɫ AE
dismantle	d AC ɪ AM s AJ m AF æ̃ BH n AG ɾ BJ ɫ̩
dispel	d AC ɪ AM s AJ p AH ɛ AM ɫ AE
dispensable	d AC ɪ AM s AJ pʰ AI ɛ AM n AG s AJ ə AM b AH ɫ̩
dissemble	d AC ɪ AM s AJ ɛ AM m AF b AH ə AM ɫ AE
distill	d AC ɪ AM s AJ t AC ɪ AM ɫ AE
ditto	d AC ɪ AM ɾ BJ o BA ʊ BA
dna	d AC i AM ɛ AM n AG e AM ɪ AM
dniester	n AG iː AN s AJ t AC ə AM
dockize	d AC ɒ BA k AC ɑ AM ɪ̯ AB z AJ
dojo	d AC o BA ʊ̯ AK d AC ʒ AJ o BA ʊ̯ AK
dole	d AC o BA ʊ̯ AK ɫ AE
don't	d AC o BA ʊ̯ AK ʔ AL t̚
dope	d AC o BA ʊ BA p AH
double	d AC ʌ AM b AH ɫ AE
dower	d AC a AM ʊ BA ɚ AM
drawn	d AC ɹ AB ɔː BB n AG
dream	d̠ AC ɹ̠ʷ ɪ AM i̯ AB m AF
dreich	d AC ɹ AB iː AN x AJ
drill	d AC ɹ AB ɪ AM ɫ AE
drink	d̠ AC ɹ̠ʷ ɪ AM ŋ AG k AC
drive	d̠ AC ɹ̠̝ʷ a AM ɪ AM v BE
drop	d AC ʒ AJ ɹ AB ɑ AM p AH
drown	d̠ AC ɹ̠ʷ a AM ʊ BA n AG
drug	d̠ AC ɹ̠ʷ ʌ AM ɡ AC
drugs	d AC ʒ AJ ɹ AB ʌ AM ɡ AC z AJ
dude	d AC ʉː BB u̯ AK d AC
dyadic	d AC a AM ɪ AM æ AM ɾ BJ ɪ AM k AC
eaten	iː AN ʔ AL n AG
eating	i AM ɾ BJ ɪ AM ŋ AG
eccentricity	ɛ AM k AC s AJ ə AM n AG t AC ɹ AB ɪ AM s AJ ə AM ɾ BJ i AM
edit	ɛ AM ɾ BJ ɪ AM ʔ AL t̚
eighty	ʔ AL e AM ɪ̯ AB ɾ BJ i AM
emphasis	ɛ AM ɱ AF f BE ə AM s AJ ɪ AM s AJ
enabled	ɛ AM n AG e AM ɪ AM b AH ə AM ɫ AE d AC
encouragement	ɪ AM n AG k AC ʌ AM ɹ AB ɪ AM d AC ʒ AJ m AF ə AM n AG t AC
enter	ɪ AM ɾ̃ CB ɚ AM
entertain	ɛ AM ɾ̃ CB ɚ AM tʰ AD e AM ɪ AM n AG
epigraphy	ʔ AL ɨ AM pʰ AI ɪː AN ɡ AC ɹ AB ə AM f BE iː AN
epimutation	ɛ AM p AH ɪ AM m AF j AB u BA t AC e AM ɪ AM ʃ AJ ə AM n AG
epitaph	ɛ AM p AH ɪ AM t AC æ AM f BE
epitomic	ɛ AM p AH ɪ AM t AC ɒ BA m AF ɪ AM k AC
ersatz	ɛ AM ə AM ɹ AB s AJ ɑː AN t AC s AJ
essential	ə AM s AJ ɛ AM n AG t AC ʃ AJ ə AM l AE
esteem	ɛ AM s AJ t AC iː AN m AF
eugh	ʌ AM x AJ
evidence	ɛ AM v BE ə AM ɾ BJ ɪ AM n AG s AJ
ew	ɪ̃ BH ʉ̃ CE u BA
exigency	ɛ AM ɡ AC z AJ ɨ AM d AC ʒ AJ ə AM n AG s AJ i AM
farrand	f BE æ AM ɹ AB ə AM n AG t AC
fastness	f BE æ AM s AJ n AG ə AM s AJ
fatal	f BE e AM ɪ AM ɾ BJ ɫ̩
fatality	f BE e AM ɪ̯ AB tʰ AD æ AM l AE ɪ AM ɾ BJ i AM
fatally	f BE e AM ɪ̯ AB ɾ BJ l̩ BN i AM
fated	f BE e AM ɪ̯ AB ɾ BJ ɨ AM d AC
fattening	f BE æˀ ə AM n AG ɪ AM ŋ AG
fatuity	f BE ə AM t AC uː BB ɨ AM ɾ BJ i AM
fauces	f BE ɔː BB s AJ iː AN z AJ
fauxtograph	f BE oː BB t AC ə AM ɡ AC ɹ AB ɑː AN f BE
fauxtography	f BE oː BB t AC ɑ AM ɡ AC ɹ AB ə AM f BE i AM
feel	f BE iː AN ɫ AE
fence	f BE ɛ AM n AG t AC s AJ
fencer	f BE ɛ AM n AG s AJ ɚ AM
fettuccini	f BE ɛ AM ɾ BJ ə AM t AC ʃʰ CF i AM n AG i AM
feudal	f BE j AB uː BB d AC ɫ̩
fiddle	f BE ɪ AM ɾ BJ l̩ BN
fiddy	f BE ɪ AM ɾ BJ i AM
fight	f BE ʌ AM ɪ AM t AC
fighter	f BE a AM ɪ̯ AB ɾ BJ ɚ AM
fighty	f BE ʌ AM ɪ AM ɾ BJ i AM
file	f BE a AM ɪ̯ AB ɫ AE
fill	f BE ɪ AM ɫ AE
filling	f BE ɪ AM ɫ AE l AE ɪ AM ŋ AG
film	f BE ɪ AM ɫ AE m AF
fire	f BE a AM ɪ AM ɚ AM
firm	f BE ɚ AM m AF
fitra	f BE ɪ AM tˤ AC ɾ BJ a AM
fitz	f BE ɪ AM t AC s AJ
flaithiúlach	f BE l AE æ AM h AA uː BB l AE ə AM x AJ
flatter	f BE l AE æ AM ɾ BJ ɚ AM
flizz	f BE l AE ɪ AM z AJ
flouted	f BE l AE a AM ʊ̯ AK ɾ BJ ɨ AM d AC
flouting	f BE l AE a AM ʊ̯ AK ɾ BJ ɪ AM ŋ AG
flutter	f BE l AE ʌ AM ɾ BJ ɚ AM
foot	fʷ BE ʊ BA t̚
football	fʷ BE ʊ BA ʔ AL t̚ b AH ɑ AM ɫ AE
fordy	f BE ɔ BA ɚ̯ ɾ BJ i AM
forest	f BE ɔ BA ɹ AB ɛ̈ s AJ tʰ AD
foretell	f BE ɔː BB t AC ɛ AM ɫ AE
forever	f BE ɚ AM ɛ AM v BE ɚ AM
fortnight	f BE ɔ BA ˞ ʔ AL n AG ɐ BA ɪ̯ AB t̚
fortunate	f BE o BA ɹ AB t AC ʃ AJ ə AM n AG ə AM tʰ AD
forty	f BE ɔ BA ɹ AB ɾ BJ i AM
fountain	f BE a AM ʊ BA n AG ʔ AL n̩ BM
free	f BE ɹ AB ɪ AM i̯ AB
french	f BE ɹ̠ ɛ AM n̠ AG t AC ʃ AJ
friend	f BE ɹ̥ AB e AM n AG d̥ AC
fuck	f BE ʌ AM kʰ AD
fuckability	f BE ʌ AM k AC ɪ̈ AM b AH ɪ AM l AE ɪ̈ AM ɾ BJ i AM
fuel	f BE j AB u BA w AK ə AM ɫ AE
full	f BE ʊ BA ɫ AE
function	f BE ʌ AM ŋ AG k AC ʃ AJ ɪ̈ AM n AG
fur	f BE ɚ AM
furcal	f BE ɚ AM k AC ə AM ɫ AE
furrier	f BE ɚˑ i AM ɚ AM
furtive	f BE ɚ AM ɽ BJ ɪ AM v BE
futtock	f BE ə AM ɾ BJ ə AM k AC
gaeltacht	ɡ AC e AM ɪ AM l AE t AC ə AM x AJ t AC
gangtok	ɡ AC æ AM ŋ AG t AC ɒ BA k AC
gasoline	ɡ AC æ AM s AJ ɵ BA l AE i AM n AG
gaumy	ɡ AC ɔː BB m AF i AM
gawd	ɡ AC ɔː BB d AC
genetic	d AC ʒ AJ ɪ AM n AG ɛ AM t AC ɪ AM k AC
genkan	ɡ AC ɛ AM ŋ AG k AC ɑ AM n AG
gentle	d AC ʒ AJ ɛ̃ BH ɾ̃ CB l̩ BN
gentleman	d AC ʒ AJ ɛ AM ɾ̃ CB ɫ̩ m AF ə AM n AG
getting	ɡ AC ɛ AM ɾ BJ ɪ AM ŋ AG
gewürztraminer	ɡ AC ə AM v BE ɚ AM t AC s AJ t AC ɹ AB ə AM m AF iː AN n AG ɚ AM
ghetto	ɡ AC ɛ AM ɾ BJ o BA ʊ̯ AK
ghettoize	ɡ AC ɛ AM ɾ BJ o BA ʊ̯ AK a AM ɪ̯ AB z AJ
glitter	ɡ AC l AE ɪ AM ɾ BJ ɚ AM
glizzy	ɡ AC l AE ɪ AM z AJ i AM
gmail	d AC ʒ AJ iː AN m AF e AM ɪ AM l AE
goat	ɡ AC o BA ʊ BA ʔ AL t̚
goathouse	ɡ AC o BA ʊ BA ʔ AL t̚
golden	ɡ AC ə AM l AE d AC ə AM n AG
good	ɡ AC ʊ̈ BA d AC
gotta	ɡ AC ɑ AM ɾ BJ ə AM
gotten	ɡ AC ɑ AM ʔ AL n̩ BM
graffito	ɡ AC ɹ AB ə AM f BE i AM ɾ BJ o BA ʊ̯ AK
grandfather	ɡ AC ɹ̠ʷ ẽˑ ə̯̃ n AG d AC f BE ɑˑ CH ð AJ ɚ AM
grass	ɡ AC ɹ̠ ɛ AM ə AM s AJ
grated	ɡ AC ɹ AB e AM ɪ̯ AB ɾ BJ ɪ AM d AC
gratified	ɡ AC ɹ AB æː AN ɾ BJ ɨ AM f BE a AM ɪː AN d̚
grating	ɡ AC ɹ AB e AM ɪ̯ AB ɾ BJ ɪ AM ŋ AG
greater	ɡ AC ɹ AB e AM ɪ AM ɾ BJ ɚ AM
grivna	ɡ AC ɹ AB ɪ AM v BE n AG ɑ AM
grow	ɡ AC ɹ AB o BA ʊ̯ AK
grows	ɡ AC ɹ AB o BA ʊ̯ AK z AJ
guesstimate	ɡ AC ɜ AM s AJ t AC ɪ̈ AM m AF e AM ɪ̯ AB ʔ AL t̚
guileless	ɡ AC a AM ɪ AM ɫ AE l AE ə AM s AJ
guttle	ɡ AC ʌ AM ɾ BJ l̩ BN
guttural	ɡ AC ʌ AM ɾ BJ ɚ AM ɫ̩
gyros	d AC ʒ AJ a AM ɪ AM ɹ AB o BA ʊ BA z AJ
h	æ AM ɪ AM t AC ʃ AJ
habitat	h AA æ AM b AH ɪ AM t AC æ AM ʔ AL
hadith	h AA a AM d AC iː AN θ AJ
hail	h AA e AM ɪ̯ AB ɫ AE
hang	h AA e AM ɪ AM ŋ AG
hangnail	h AA e AM ɪ AM ŋ AG n AG e AM ɪ̯ AB ɫ AE
happening	h AA æ AM p AH n AG ɪ AM n AG
hawaii	h AA ʊ̈ BA w AK ɔ BA j AB i AM
he	ç i AM
heading	h AA ɛ AM ɾ BJ ɪ AM ŋ AG
health	h AA ɛ AM l̪ AE θ AJ
hearse	h AA ɚ AM s AJ
heartbeat	h AA ɑ AM ɹ AB ʔ AL b AH i AM ʔ AL
heat	ç i AM t AC
hew	ç j AB uː BB
hibernation	h AA a AM ɪ AM b AH ɚ AM n AG e AM ɪ AM ʃ AJ n̩ BM
high	h AA a AM ɪ̯ AB
hill	h AA ɪ AM ɫ AE
hiller	h AA ɪ AM ɫ AE l AE ɚ AM
him	ɪ̈ AM m AF
hinoki	h AA i AM n AG o BA k AC i AM
hinter	h AA ɪ AM ɾ̃ CB ɚ AM
hitherto	h AA ɪ AM ð AJ ɚ AM tʰ AD u BA
hmm	m̥ AF m̩ BL
hmmm	m̥ AF m̩ː CI
hold	h AA o BA ə AM ɫ AE d AC
holding	h AA ə AM ʊ BA ɫ AE d AC ɪ AM ŋ AG
hole	h AA o BA ʊ BA ɫ AE
homophobe	h AA ə AM ʊ BA m AF ə AM f BE ə AM ʊ BA b AH
hon	m̥ AF ɑ AM n AG
honyock	h AA ɒ BA ŋ AG j AB ɒ BA k AC
hood	h AA ʊ̈ BA d AC
hooter	h AA u BA ɾ BJ ɚ AM
horus	h AA ɔː BB ɹ AB ə AM s AJ
hotel	h AA oː BB t AC e AM l AE
houston	j̊ AB uː BB s AJ t AC ɨ AM n AG
hrivna	ɦ AA ɹ AB ɪ AM u̯ AK nʲ AG ɑ AM
hubris	ç j AB u̟ː BB b AH ɹʷ ɪ AM s AJ
hue	ç u BA
huge	ç u̟ː BB d AC ʒ AJ
huguenot	ɕ AJ u BA ɡ AC ə AM n AG ɒ BA t AC
huh	h AA ə̃ BH
human	ç j AB u̟ BA m AF ə AM n AG
humanist	ç uː BB m AF ə AM n AG ɪ AM s AJ t AC
humanity	h AA j AB u BA m AF æ AM n AG ɪ AM ɾ BJ i AM
humongous	ç u̟ː BB m AF ʊ BA ŋ AG ɡ AC ə AM s AJ
humph	h AA ʌ AM m AF f BE
hunter	h AA ʌ AM ɾ̃ CB ɚ AM
hurry	h AA ɚ AM ɹ AB i AM
hydra	h AA a AM ɪ̯ AB d AC ʒ AJ ɹ AB ə AM
hydropsy	h AA a AM ɪ̯ AB d AC ɹ AB ɑ AM p AH s AJ i AM
hyperhidrosis	h AA a AM ɪ AM p AH ə AM ɹ AB h AA a AM ɪ AM d AC ɹ AB o BA ʊ BA s AJ ɪ AM s AJ
hypotenuse	h AA a AM ɪ AM p AH ɑ AM ʔ AL ə AM n AG uː BB s AJ
háček	ɦ AA ɑː AN t AC ʃ AJ ɛ AM k AC
iced	a AM ɪ̯ AB s AJ t AC
illegal	ɪ AM ɫ AE l AE i AM ɡ AC ə AM ɫ AE
illegitimate	ɪ AM l AE ɨ AM d AC ʒ AJ ɪ AM ɾ BJ ə AM m AF ɨ AM t AC
illusion	ɪ AM l AE uː BB ʒ AJ ə AM n AG
imma	aː AN m AF ə AM
inamorata	ɪ AM n AG æ AM m AF ə AM ɹ AB ɑː AN ɾ BJ ə AM
incel	ɪ AM n AG s AJ ɛ AM ɫ AE
incidental	ɪ AM n AG s AJ ɪ AM d AC ɛ AM ɾ̃ CB ə AM l AE
incommunicado	ɪ AM n AG k AC ə AM m AF j AB u BA n AG ɨ AM k AC ɑː AN d AC o BA ʊ BA
incredible	ɪ̈ AM ŋ AG k AC ɹ̥ʷ ɛ AM ɾ BJ ə AM b AH ɫ̩
inexorably	ɪ AM n AG ɛ AM ɡ AC z AJ ə AM ɹ AB ə AM b AH l AE i AM
inference	ɪ AM ɱ AF f BE ɹ AB ə AM n AG s AJ
inhalation	ɪ AM n AG ɦ AA ə AM l AE e AM ɪ AM ʃ AJ n̩ BM
insolvency	ɪ AM n AG s AJ ɒ BA l AE v BE n̩ BM s AJ i AM
installation	ɪ AM n AG s AJ t AC ə AM l AE e AM ɪ AM ʃ AJ ə AM n AG
insufferable	ɪ AM n AG s AJ ʌ AM f BE ɹ AB ə AM b AH l̩ BN
interchangeable	ɪ AM ɾ̃ CB ɚ AM t AC ʃ AJ e AM ɪ AM n AG d AC ʒ AJ ə AM b AH l̩ BN
interloper	ɪ AM ɾ̃ CB ɚ AM l AE o BA ʊ̯ AK p AH ɚ AM
international	ɪ AM ɾ̃ CB ɚ AM n AG æ AM ʃ AJ ə AM n AG ə AM ɫ AE
interstate	ɪ AM ɾ̃ CB ɚ AM s AJ t AC e AM ɪ̯ AB t AC
investigate	ɪ AM n AG v BE e AM s AJ t AC ɪ AM ɡ AC e AM ɪ̯ AB t AC
ipa	a AM ɪ AM pʰ AI iː AN e AM ɪ AM
ireland	ʌ AM ɪ AM ɚ AM l AE ə AM n AG d AC
it	ɪ̈ AM t AC
italy	ɪ AM ɾ BJ ə AM l AE i AM
item	a AM ɪ̯ AB ɾ BJ ə AM m AF
ith	a AM ɪ̯ AB θ AJ
jabberwocky	d AC ʒ AJ æ AM b AH ɚ AM w AK ɑ AM k AC i AM
jar	d AC ʒ AJ ɑ AM ɹ AB
jump	d AC ʒ AJ ʌ AM m AF p AH
juniper	d AC ʒ AJ u BA n AG ɪ̈ AM p AH ɚ AM
jupiter	d AC ʒ AJ u BA p AH ɪ AM ɾ BJ ɚ AM
jury	d AC ʒ AJ ʊ BA ə AM ɹ̠ i AM
k	kʰ AD e AM ɪ AM
kana	kʰ AD ɑː AN n AG ə AM
kardashian	kʰ AD ɑ AM ɹ AB d AC æ AM ʃ AJ i AM ə AM n AG
karma	k AC ə AM ɾ BJ m AF ə AM
katana	k AC ɪ̈ AM tʰ AD ɑ AM n AG ə AM
katy	kʰ AD e AM ɪ̯ AB ɾ BJ i AM
kebnekaise	k AC ɛ AM b AH n AG ə AM k AC a AM i AM s AJ ə AM
keloid	k AC iː AN l AE ɔ BA ɪ AM d AC
kelvin	kʰ AD ɛ AM l AE v BE ɨ AM n AG
kettle	kʰ AD ɛ AM ɾ BJ ɫ̩
key	kʲʰ AD iː AN
kick	kʰ AD ɪ AM k AC
kiddie	kʰ AD ɪ AM ɾ BJ i AM
killer	kʰ AD ɪ AM ɫ AE l AE ɚ AM
kimono	k AC ɪ̈ AM m AF o BA ʊ̯ AK n AG ə AM
kimonoed	k AC ɪ̈ AM m AF o BA ʊ̯ AK n AG ɪ̈ AM d AC
kindergarten	kʰ AD ɪ AM ɾ̃ CB ə AM ɹ AB ɡ AC ɑː AN ɹ AB ʔ AL n̩ BM
kirton	k AC ɚ AM ʔ AL n̩ BM
kiss	kʰ AD ɪ AM s AJ
kitten	k AC ɪ AM ʔ AL n̩ BM
kitty	kʰ AD ɪ AM ɾ BJ i AM
knar	n AG ɑ AM ˞
koizumi	kʰ AD ɔ BA i̯ AB z AJ u BA m AF i AM
korea	kʰ AD ɵ BA ɹ AB i AM ə AM
l	ɫ AE
la	ɛ AM ɫ AE l AE e AM j AB
ladder	l AE æ AM ɾ BJ ɚ AM
lambrusco	l AE æ AM m AF b AH ɹ AB ʊ BA s AJ k AC o BA ʊ BA
land	ɫ AE e AM ə̯ AB n AG d AC
lander	l AE æ AM n AG d AC ɚ AM
language	l AE e AM ɪ AM ŋ AG ɡ AC w AK ɪ AM d AC ʒ AJ
lar	l AE ɑ AM ˞
largely	l AE ɑː AN d AC ʒ AJ l AE i AM
later	l AE e AM ɪ̯ AB ɾ BJ ɚ AM
latin	l AE æ AM ʔ AL n̩ BM
latter	l AE æ AM ɾ BJ ɚ AM
laundry	l AE ɑ AM n AG d AC ɹ AB i AM
learner	l AE ɚ AM n AG ɚ AM
leeway	l AE iː AN w AK e AM ɪ AM
li'l	l AE ɪ AM ɫ̩
liable	l AE a AM ɪ̯ AB ə AM b AH ɫ̩
light	ɫ AE ɐ BA ɪ̯ AB ʔ AL
lighter	l AE a AM ɪ AM ɾ BJ ɚ AM
lightning	l AE ʌ AM ɪ̯ AB ʔ AL n AG ɪ AM ŋ AG
lincolnshire	l AE i AM ŋ AG kʰ AD ə̆ BF n AG ʃ AJ ɚ AM
listen	l AE ɪ AM s AJ n̩ BM
liter	l AE i AM ɾ BJ ɚ AM
literally	l AE ɪ AM ɾ BJ ɚ AM ə AM l AE i AM
literary	ɫ AE ɪ AM ɾ BJ ə AM ɹ AB ɛ AM ə AM ɹ AB i AM
litre	l AE i AM ɾ BJ ɚ AM
litter	l AE ɪ AM ɾ BJ ɚ AM
little	ɫ AE ɪ AM ɾ BJ ɫ AE
littlest	l AE ɪ AM ɾ BJ l̩ BN ə AM s AJ t̚
loiter	l AE ɔ BA j AB ɾ BJ ɚ AM
lubricious	l AE u BA b AH ɹ AB ɪ AM ʃ AJ ə AM s AJ
luddite	l AE ʌ AM ɾ BJ ʌ AM i AM t AC
lulls	ɫ AE ʌ AM ɫ AE z AJ
lunch	l AE ʌ̃ BH n AG t AC ʃ AJ
lycra	l AE a AM ɪ AM k AC ɹ AB ə AM
m'kay	ŋ AG k AC e AM ɪ AM
ma'am	m AF ɛ AM ə AM m AF
madder	m AF æ AM ɾ BJ ə AM ɹ AB
mail	m AF e AM ɪ̯ AB ɫ AE
make	m AF e AM ɪ AM kʲ AC
malinois	m AF æ AM l AE ɪ AM n AG w AK ɑː AN
mamaliga	m AF ə AM m AF ə AM l AE i AM ɡ AC ə AM
man	m AF ẽ ə̃ BH n AG
mar	m AF ɑ AM ˞
marten	m AF ɑ AM ɹ AB ʔ AL n̩ BM
martyr	m AF ɑ AM ɹ AB ɾ BJ ɚ AM
mat	m AF æ AM ʔ AL t̚
matter	m AF æ AM ɾ BJ ɚ AM
mawky	m AF ɔː BB k AC i AM
maybe	m AF e AM ɪ̯ AB b AH i AM
meal	m AF iː AN ʟ̩
medal	m AF ɛ AM ɾ BJ ɫ̩
meehan	m AF iː AN h AA æ̝ː n AG
meeting	m AF i AM ɾ BJ ɪ AM ŋ AG
melodic	m AF ɨ AM l AE ɑ AM ɾ BJ ɪ AM k AC
mersh	m AF ɚ AM ʃ AJ
merveilleuse	m AF ɛ AM ʁ AJ v BE ɛ AM j AB ø BA z AJ
merveilleux	m AF ɛ AM ʁ AJ v BE ɛ AM j AB ø BA
meta	m AF ɛ AM ɾ BJ ə AM
metal	m AF ɛ AM ɾ BJ ɫ̩
metathesis	m AF ɛ AM tʰ AD æ AM θ AJ ə AM s AJ ɪ AM s AJ
meteor	m AF i AM ɾ BJ i AM ɚ AM
meter	m AF i AM ɾ BJ ɚ AM
methoxphenidine	m AF ɛː AN θ AJ ɑ AM k AC s AJ f BE ɛː AN n AG ɨ AM ɾ BJ ĩː n AG
metic	m AF ɛ AM ɾ BJ ə AM k AC
metre	m AF iː AN ɾ BJ ɚ AM
mhm	m̩ BL m̥ AF m̩ BL
mi'kmaq	m AF ɪ AM ɡ AC ə AM m AF ɒ BA q AC
michael	m AF ɐ BA ɪ AM kʰ AD ɫ̩
michigander	m AF ɪ AM ʃ AJ ə AM ɡ AC æ AM n AG d AC ɚ AM
middle	m AF ɪ AM ɾ BJ ɫ̩
middleman	m AF ɪ AM d AC ɫ̩ m AF æ AM n AG
midst	m AF ɪ AM t AC s AJ t AC
mighty	m AF ʌ AM ɪ AM ɾ BJ i AM
mike	m AF ɐ BA ɪ AM ʔ AL k̚
mikey	m AF ɐ BA ɪ AM kʰ AD iː AN
mile	m AF a AM ɪ̯ AB ɫ AE
milkshake	m AF ɪ AM ɫ AE k AC ʃ AJ e AM ɪ AM k AC
mill	m AF ɪ AM ɫ AE
minnesota	m AF ɪ AM n AG ɪ AM s AJ o BA ʊ BA ɾ BJ ə AM
minnesotan	m AF ɪ AM n AG ə AM s AJ o BA ʊ BA ʔ AL n̩ BM
minter	m AF ɪ AM ɾ̃ CB ɚ AM
mirth	m AF ɚ AM θ AJ
mister	m AF ɪ AM s AJ t AC ɚ AM
mmm	m̩ BL
model	m AF ɑ AM ɾ BJ ɫ AE
molasses	m AF ɵ BA l AE æ AM s AJ ɨ AM z AJ
moms	m AF ɑ AM m AF z AJ
month	m AF ʌ AM n̪ AG θ AJ
mosquitoey	m AF ə AM s AJ k AC i AM ɾ BJ o BA ʊ BA i AM
motlopi	m AF o BA ʊ BA ʔ AL l AE o BA ʊ BA p AH i AM
motorcycle	m AF o BA ʊ BA ɾ BJ ɚ AM s AJ a AM ɪ AM k AC l̩ BN
mountain	m AF æ̃ BH ʊ̯̃ n AG ʔ AL n̩ BM
mountaineer	m AF æ̃ BH ʊ̯̃ n AG ʔ AL n̩ BM i AM ə AM ɹ AB
muddy	m AF ʌ AM d AC i AM
multiplayer	m AF ʌ AM ɫ AE t AC i AM p AH l AE e AM ɪ̯ AB ɚ AM
multiplier	m AF ʌ AM ɫ AE t AC ɪ AM p AH l AE a AM ɪ AM ɚ AM
murr	m AF ɚ AM
mustard	m AF ʌ AM s AJ t AC ɚ AM d AC
mutton	m AF ʌ AM ʔ AL n̩ BM
myrrh	m AF ɚ AM
myrtle	m AF ɚ AM ɾ BJ ɫ AE
nah	n AG ɑː AN
nail	n AG e AM ɪ̯ AB ɫ AE
nares	n AG æ AM ɹ AB iː AN z AJ
narration	n AG ɛ AM ɚ AM ɹ AB e AM ɪ AM ʃ AJ n̩ BM
nauruan	n AG ɑː AN uː BB ɹ AB uː BB n̩ BM
neato	n AG i AM ɾ BJ o BA ʊ̯ AK
neutral	n AG uː BB t AC ʃ AJ ɹ AB ə AM l AE
nevada	n AG ə AM v BE ɑ AM ɾ BJ ə AM
never	n AG ɛ AM v BE ɚ̹
newcastle	n AG j AB u BA kʰ AD æ AM s AJ ɫ̩
newcomer	n AG j AB u BA kʰ AD ʌ AM m AF ɚ AM
ng	ŋ AG
niggard	n AG ɪ AM ɡ AC ɚ AM d AC
niggered	n AG ɪ AM ɡ AC ɚ AM d AC
nightmare	n AG ʌ AM ɪ AM ʔ AL m AF ɛ AM ə AM ɹ AB
nighttime	n AG a AM ɪ AM ʔ AL t AC a AM ɪ AM m AF
nilotic	n AG a AM ɪ AM l AE ɑ AM ɾ BJ ɪ AM k AC
nine	n AG a AM ɪ̯ AB n AG
nippon	n AG ɪ AM pʰ AI ɑ AM n AG
nitrate	n AG a AM ɪ̯ AB tʰ AD ɹ AB e AM ɪ̯ AB t AC
nitrogen	n AG ɐ BA ɪ AM tʰ AD ɹ AB ə AM d AC ʒ AJ ə AM n AG
nizz	n AG ɪ AM z AJ
nonce	n AG ɒ BA n AG t AC s AJ
nope	n AG o BA ʊ BA p̚
notice	n AG o BA ʊ BA ɾ BJ ɪ AM s AJ
nut	n AG ɐ BA t AC
o'malley	ɵ BA m AF æ AM l AE i AM
october	ɑ AM k AC tʰ AD o BA ʊ BA b AH ɚ AM
odder	ʔ AL ɑ AM ɾ BJ ɚ AM
oil	ɔ BA ɪ AM ɫ AE
olden	ɔ BA l AE d AC ə AM n AG
olive	ʔ AL ɑː AN ɫ AE l AE ɨ AM v̥ BE
oni	o BA ʊ BA n AG iː AN
oppose	ʔ AL ə AM pʰ AI o BA ʊː BB z̥ AJ
order	ɔ BA ɹ AB ɾ BJ ɚ AM
origami	ɔ BA ɹ AB ɪ̈ AM ɡ AC ɑ AM m AF i AM
otaku	o̞ BA ʊ̯ AK tʰ AD ɑ AM kʰ AD u BA
otter	ʔ AL ɑ AM ɾ BJ ɚ AM
our	ɑ AM ˞
outer	a AM ʊ BA ɾ BJ ɚ AM
pack	pʰ AI æ AM k AC
package	pʰ AI a AM k AC ɛ AM d AC ʒ AJ
paddle	pʰ AI æ AM ɾ BJ ɫ̩
paddy	pʰ AI æ AM ɾ BJ i AM
padre	pʰ AI ɑ AM d AC ɹ AB e AM ɪ̯ AB
pah	pʼ BC aʰ
pail	pʰ AI e AM ɪ̯ AB ɫ AE
pale	pʰ AI e AM ɪ̯ AB ɫ AE
pansentience	p AH æ AM n AG s AJ ɛ AM n AG t AC ʃ AJ i AM ə AM n AG s AJ
pantry	p AH æ AM nʰ CG ɹ̥ AB i AM
par	pʰ AI ɑ AM ˞
parcel	pʰ AI ɑː AN s AJ ə AM ɫ AE
park	p AH ɒ BA ə AM k AC
parole	p AH ə AM ɹ AB ə AM ʊ BA ɫ AE
parse	pʰ AI ɑ AM ɹ AB z AJ
partay	pʰ AI ɑ AM ɹ AB tʰ AD e AM ɪ̯ AB
partner	p AH ɑ AM ɹ AB ʔ AL n AG ɚ AM
party	pʰ AI ɑ AM ɹ AB ɾ BJ i AM
pascal	pʰ AI æ AM s AJ kʰ AD æ AM ɫ AE
pass	pʰ AI ɛ AM ə AM s AJ
passion	pʰ AI æ AM ʃ AJ ə AM n AG
pat	pʰ AI æˀ t̚
patent	pʰ AI æ̝ ʔ AL n̩ BM t AC
path	pʰ AI ɛ AM ə AM θ AJ
patrick	pʰ AI æ AM t̠ AC ɹ̠̊ʷ ɪ AM k̚
pattern	p AH æ AM ɾ BJ ɚ AM n AG
patting	pʰ AI æ AM ɾ BJ ɪ AM ŋ AG
pattings	pʰ AI æ AM ɾ BJ ɪ AM ŋ AG z AJ
pay	pʰ AI e AM ɪ AM
pearl	pʰ AI ɚ AM ɫ AE
pearls	pʰ AI ɚ AM ɫ AE z AJ
peculiar	pʰ AI ə̥ AM kʰ AD j̊ AB uː BB l AE j AB ʊ BA ə AM
peel	pʰ AI iː AN ɫ AE
peep	pʰ AI i AM p AH
peg	pʰ AI ɛ AM ɡ AC
penes	pʰ AI i AM n AG i AM z AJ
penis	pʰ AI i AM n AG ɪ AM s AJ
people	pʰ AI i AM p AH ɫ̩
percuss	p AH ɚ AM kʰ AD ʌ AM s AJ
performance	p AH ɚ AM f BE ɔ BA ɹ AB m AF ə AM n AG s AJ
person	pʰ AI ɚ AM s AJ n̩ BM
personality	p AH ɚ AM s AJ ə AM n AG æ AM l AE ɪ AM ɾ BJ i AM
pester	pʰ AI ɛ AM s AJ t AC ɚ AM
pet	pʰ AI ɛ AM ʔ AL t AC
peter	pʰ AI i AM ɾ BJ ɚ AM
petting	pʰ AI ɛ AM ɾ BJ ɪ AM ŋ AG
petty	pʰ AI ɛ AM ɾ BJ i AM
pewter	p AH j AB u BA ɾ BJ ɚ AM
phew	ɸ BE j AB u̥ BA
philadelphia	f BE ɪ AM ɫ AE ə AM d AC ɜ AM ɫ AE f BE i AM ə AM
phlebolith	f BE l AE ɛ AM b AH ə AM l AE ɪ AM θ AJ
phonetic	f BE ə AM n AG ɛ AM ɾ BJ ɪ AM k AC
photo	f BE ŏ ʊ BA ɾ BJ o BA ʊ BA
photograph	f BE ŏ ʊ BA ɾ BJ ə AM ɡ AC ɹ̠ æ AM f BE
photographic	f BE o BA ʊ BA ɾ BJ ə AM ɡ AC ɹ AB æ AM f BE ɪ AM k AC
photosynthesis	f BE ŏ ʊ BA ɾ BJ o BA ʊ BA s AJ ɪ AM n̪ AG θ AJ ə AM s AJ ɪ AM s AJ
pick	pʰ AI ɪ AM k AC
pierre	pʰ AI i AM ə AM ɹ AB
piling	pʰ AI a AM ɪ̯ AB ɫ AE l AE ɪ AM ŋ AG
pill	pʰ AI ɪ AM ɫ AE
pin	pʰ AI ɪ AM n AG
pink	pʰ AI ɪ AM ŋ AG k AC
pit	pʰ AI ɪ AM ʔ AL t AC
pittance	pʰ AI ɪ AM ʔ AL n̩ BM s AJ
place	pʰ AI l̥ AE e AM ɪ AM s AJ
plack	pʰ AI l̥ AE æ AM k AC
plague	pʰ AI l̥ AE e AM ɪ AM ɡ AC
plain	pʰ AI l̥ AE e AM ɪ AM n AG
plan	pʰ AI l̥ AE æ AM n AG
plane	pʰ AI l̥ AE e AM ɪ AM n AG
plant	pʰ AI l̥ AE æ AM n AG t AC
plantigrade	p AH l AE e AM ə̯ AB ɾ̃ CB ə AM ɡ AC ɹ AB e AM ɪ̯ AB d AC
plaque	pʰ AI l̥ AE æ AM k AC
plastic	pʰ AI l AE æ AM s AJ t AC ɪ AM k AC
plate	pʰ AI l̥ AE e AM ɪ AM t AC
play	p AH l̥ AE e AM ɪ AM
please	p AH ɫ̥ AE i AM z AJ
plenty	p AH l AE ɪ AM ɾ̃ CB i AM
pluto	p AH l AE u BA ɾ BJ o BA ʊ BA
poem	pʰ AI o BA ʊ̯ AK ə AM m AF
poet	pʰ AI o BA ʊ̯ AK ɪ̈ AM ʔ AL t̚
poetry	pʰ AI o BA ʊ̯ AK ə AM t AC ɹ AB i AM
poilu	p AH w AK ɑː AN l AE uː BB
polar	pʰ AI o BA ʊ̯ AK l AE ɚ AM
pole	pʰ AI o BA ʊ̯ AK ɫ AE
police	p AH ə AM l AE iː AN s AJ
pool	pʰ AI u BA ɫ AE
popping	pʰ AI ɑ AM p AH ɪ̈ AM ŋ AG
portable	pʰ AI ɔ BA ɹ AB ɾ BJ ɪ̈ AM b AH l̩ BN
portal	pʰ AI ɔː BB ɹ AB ɾ BJ ɫ̩
postal	p AH o BA ʊ BA s AJ t AC l̩ BN
potato	p AH ə̥ AM tʰ AD e AM ɪ AM ɾ BJ ə AM
potent	pʰ AI o BA ʊ̯ AK ʔ AL n̩ BM t AC
power	pʰ AI a AM ʊ̯ AK ɹ AB
pressure	p AH ɹ AB ɛ AM ʃ AJ ɚ AM
pretzel	pʰ AI ɹ AB ɛ AM ʔ AL t AC s AJ ɫ̩
prick	pʰ AI ɹ̠̊ ɪ AM k AC
pride	p AH ɹ̥ʷ a AM ɪ AM d AC
priest	p AH ɹ̥ AB iː AN s AJ t AC
prim	pʰ AI ɹ̠̊ ɪ AM m AF
printer	pʰ AI ɹ AB ɪ AM ɾ̃ CB ɚ AM
prism	pʰ AI ɹ̠̊ ɪ AM z AJ m̩ BL
prison	pʰ AI ɹ̠̊ ɪ AM z AJ n̩ BM
processors	p AH ɹ AB ɑ AM s AJ ɛ AM s AJ ɚ AM z AJ
prodigal	pʰ AI ɹ AB ɑ AM ɾ BJ ɪ AM ɡ AC ɫ̩
produceorial	p AH ɹ AB ɑ AM d AC ə AM s AJ o BA ʊ BA ɹ AB i AM ə AM l AE
pronto	pʰ AI ɹ AB ɑ AM n AG tʰ AD o BA ʊ̯ AK
pronunciation	pʰ AI ɹ AB ə AM n AG ʌ AM n AG s AJ i AM e AM ɪ AM ʃ AJ ə AM n AG
propaganda	p AH ɹ AB ɒ BA p AH ə AM ɡ AC æ AM n AG d AC ə AM
property	p AH ɹ AB ɑ AM p AH ɚ AM ɾ BJ i AM
psittacosis	s AJ i AM ɾ BJ ə AM k AC o BA ʊ BA s AJ ɨ AM s AJ
pulchritude	pʰ AI ʌ AM ɫ AE k AC ɹ AB ə AM t AC uː BB d AC
pull	pʰ AI ʊː BB ɫ AE
punctuate	p AH ʌ AM ŋ AG k AC ʃ AJ uː BB e AM ɪ AM t AC
punter	pʰ AI ʌ̃ː BI ɾ̃ CB ɚ AM
puppy	pʰ AI ɐ BA p AH i AM
purl	pʰ AI ɚ AM ɫ AE
purlin	p AH ɜː AN ɹ AB l AE ɪ AM n AG
purls	pʰ AI ɚ AM ɫ AE z AJ
push	pʷ AH ʊ BA ʃ AJ
put	pʰ AI ʊ BA ʔ AL t AC
putt	pʰ AI ʌ AM t AC
putting	pʰ AI ʌ AM t AC ɪ AM ŋ AG
quaint	kʰ AD w AK e AM ɪ̯ AB n AG t AC
quality	kʰ AD w AK ɑ AM ɫ AE ə AM ɾ BJ i AM
quantity	kʰ AD w AK ɑ AM n AG ɾ BJ ɨ AM ɾ BJ i AM
quantum	kʰ AD w AK ɑ AM n AG tʰ AD ə AM m AF
queen	kʷ AH w AK iː AN n AG
quesadilla	kʰ AD e AM ɪ̯ AB s AJ ə AM d AC i AM j AB ə AM
quick	k AC w̥ AK ɪ AM k AC
quid	kʰ AD w̥ AK ɪ AM d AC
quiff	kʰ AD w̥ AK ɪ AM f BE
quill	kʰ AD w̥ AK ɪ AM l AE
quilt	kʰ AD w̥ AK ɪ AM l AE t AC
quin	kʰ AD w̥ AK ɪ AM n AG
quinn	kʰ AD w̥ AK ɪ AM n AG
quint	kʰ AD w̥ AK ɪ AM n AG t AC
quip	kʰ AD w̥ AK ɪ AM p AH
quit	kʰ AD w̥ AK ɪ AM t AC
quiz	kʰ AD w̥ AK ɪ AM z AJ
radar	ɹ AB e AM ɪ AM ɾ BJ ɚ AM
radio	ɹ AB e AM ɪ AM ɾ BJ i AM o BA ʊ BA
rail	ɹ AB e AM ɪ AM ɫ AE
rajgira	ɾ BJ ɑː AN d AC ʒ AJ ɡ AC i AM r BD ɑː AN
rambo	ɹ AB æ AM m AF b AH ə AM ʊ BA
rating	ɹ AB e AM ɪ AM ɾ BJ ɪ AM ŋ AG
ratty	ɹ AB æ AM ɾ BJ i AM
reading	ɹ AB iː AN ɾ BJ ɪ AM ŋ AG
rebutter	ɹ AB ɪ̈ AM b AH ʌ AM ɾ BJ ɚ AM
recension	ɹ̠ʷ ɪ̈ AM s AJ ɛ̃ BH n AG t̚ ʃ AJ ə̃ BH n AG
reconnoiter	ɹˠ ɛ AM k AC ə AM n AG ɔ BA ɪ̯ AB ɾ BJ ɚ AM
reconnoitre	ɹˠ ɛ AM k AC ə AM n AG ɔ BA ɪ̯ AB ɾ BJ ɚ AM
regular	ɹ AB ɛ AM ɡ AC l̩ BN ɚ AM
relative	ɹ AB ɛ AM l AE ə AM ɾ BJ ɪ AM v BE
relatively	ɹ AB ɛ AM l AE ə AM ɾ BJ ɪ AM v BE l AE i AM
relinquish	ɹ AB ɪ AM l AE ɪ AM ŋ AG k AC w AK ɪ AM ʃ AJ
remote	ɹ AB ɪ AM m AF o BA ʊ BA t AC
republic	ɹ AB ɪ AM p AH ʌ AM b AH l AE ɪ AM k AC
respectable	ɹ AB i AM s AJ p AH ɛ AM k AC t AC ə AM b AH l̩ BN
retail	ɹ̠ʷ i AM tʰ AD e AM ɪ̯ AB ɫ AE
reticent	ɹ AB ɛ AM d AC ə AM s AJ ə AM n AG t AC
revelry	ɹ AB ɛ AM v BE ə AM ɫ AE ɹ AB i AM
reëvoke	ɹ AB iː AN ʔ AL i AM v BE ə AM ʊ BA k AC
rhotic	ɹ̠ʷ ɵ BA ʊ BA ɾ BJ ɪ̈ AM k AC
rider	ɹ̠ a AM ɪ AM ɾ BJ ɚ AM
right	ɹ AB a AM ɪ AM ʔ AL t̚
robotics	ɹ AB o BA ʊ BA b AH ɑ AM ɾ BJ ɪ AM k AC s AJ
rocks	ɹʷ ɔ BA k AC s AJ
rocky	ɹʷ ɒ BA k AC i AM
romantic	ɹ AB o BA ʊ BA m AF æ AM n AG t AC ɪ AM k AC
rose	ɻʷ BE ö̞ ʊ BA z̥ AJ
rot	ɹ AB ɑ AM t AC
roti	ɹ AB ɔ BA ʊ BA ɾ BJ ɪ AM i̯ AB
rotten	ɹ AB ɑ AM ʔ AL n̩ BM
rubbed	ɹ AB ʌˑ b̚ d̥ AC
ruby	ɹ AB uː BB b AH i AM
rule	ɹ AB uː BB ɫ AE
saddle	s AJ æ AM d AC l̩ BN
sail	s AJ e AM ɪ̯ AB ɫ AE
sang	s AJ ɛ AM ŋ AG
sat	ɛ AM s AJ e AM ɪ̯ AB tʰ AD i AM
saturday	s AJ æ AM ɾ BJ ɚ AM ɾ BJ i AM
scale	s AJ k AC e AM ɪ̯ AB ɫ AE
scallion	s AJ k AC æ AM l AE ɪ AM ə AM n AG
schemes	s AJ k AC iː AN m AF z̥ AJ
screech	s AJ k AC ɹ AB iː AN t AC ʃ AJ
scuttle	s AJ k AC ʌ AM ɾ BJ ɫ̩
secretary	s AJ ɛ AM k AC ɹ AB ə AM tʰ AD ɛ AM ɹ AB i AM
security	s AJ ə AM k AC j AB ʊ BA ɹ AB ɪ AM ɾ BJ i AM
semanticity	s AJ ɪ AM m AF æ AM n AG tʰ AD ɪ AM s AJ ɪ̈ AM t AC i AM
senpai	s AJ ɛ AM n AG p AH a AM ɪ̯ AB
sentence	s AJ ɛ AM n AG ʔ AL n̩ BM t AC s AJ
serious	s AJ i AM ə AM ɹ AB i AM ə AM s AJ
servant	s AJ ɚ AM v BE n̩ BM ʔ AL
servo	s AJ ɚ AM v BE o BA ʊ BA
sevendy	s AJ ɛ AM v BE n̩ BM ɾ̃ CB i AM
shi	ʃ AJ a AM ɪ AM
shitty	ʃ AJ ɪ AM ɾ BJ i AM
shouldn't	ʃ AJ ʊ BA n AG ʔ AL
shutter	ʃ AJ ʌ AM ɾ BJ ɚ AM
siberia	s AJ a AM ɪ AM b AH ɪ AM ɹ AB i AM ə AM
siberian	s AJ a AM ɪ AM b AH ɪ AM ɹ AB i AM ə AM n AG
sigmatism	s AJ ɪ AM ɡ AC m AF ʌ AM t AC ɪ AM z AJ m AF
sitter	s AJ ɪ AM ɾ BJ ɚ AM
sixth	s AJ ɪ AM k AC s AJ θ AJ
skillful	s AJ k AC ɪ AM ɫ AE f BE ə AM ɫ AE
skrrt	s AJ k AC r̩ CA ʔ AL
skweee	s AJ k AC w AK iː AN
slaten	s AJ l AE e AM ɪ AM t AC n̩ BM
slight	s AJ l̥ AE l AE ɐ BA ɪ AM ʔ̚
smatter	s AJ m AF æ AM ɾ BJ ɚ AM
snippet	s AJ n AG ɪ AM p AH ɪ̈ AM ʔ AL t̚
snow	s AJ n AG o BA ʊ̯ AK
soil	s AJ ɔ BA ɪ̯ AB ɫ AE
solecism	s AJ o BA ʊ BA l AE ɨ AM s AJ ɪ AM z AJ ə AM m AF
soluble	s AJ ɔ BA ɫ AE j AB ʊ BA b AH ə AM ɫ AE
some	s AJ ɐ BA m AF
something	s AJ ʌ̃ː BI
sophisticate	s AJ ə AM f BE ɪ AM s AJ t AC ɪ AM k AC ə AM t AC
sorta	s AJ ɔ BA ɹ AB ɾ BJ ə AM
spaghetti	s AJ p AH ə AM ɡ AC ɛ AM ɾ BJ i AM
spar	s AJ p AH ɑ AM ˞
splinter	s AJ p AH l AE ɪ AM ɾ̃ CB ɚ AM
spotted	s AJ p AH ɑ AM ɾ BJ ɪ̈ AM d AC
squander	s AJ kʷ AH ɑ AM n AG d AC ɚ AM
squee	s AJ k AC w AK iː AN
standard	s AJ t AC e AM ə AM n AG d AC ɚ AM d AC
standardise	s AJ t AC æ AM n AG d AC ə AM ɹ AB d AC a AM ɪ AM z AJ
started	s AJ t AC ɑ AM ɹ AB ɾ BJ ɪ AM d AC
starter	s AJ t AC ɑ AM ɹ AB ɾ BJ ɚ AM
starting	s AJ t AC ɑ AM ɹ AB ɾ BJ ɪ AM ŋ AG
startup	s AJ t AC ɑ AM ɹ AB ɾ BJ ʌ AM p AH
steel	s AJ t AC iː AN ɫ AE
stiletto	s AJ t AC ə AM l AE ɛ AM ɾ BJ o BA ʊ BA
stirk	s AJ t AC ɚ AM k AC
stope	s AJ t AC o BA ʊ BA p AH
strand	s AJ t AC ɹ AB ɛ AM ə AM n AG d AC
strength	s AJ t̠ AC ɹ̠ ɪ AM ŋ AG k AC θ AJ
strident	s AJ t AC ɹ AB a AM ɪ AM dˀ AL n AG t AC
strong	ʃ AJ t̠ AC ɹ̠ ɔ BA ŋ AG
struggle	s AJ t AC ɹ AB ʌ AM ɡ AC l̩ BN
subhuman	s AJ ʌ AM b AH h AA j AB uː BB m AF ə AM n AG
substance	s AJ ʌ AM b AH s AJ t AC ə AM n AG t AC s AJ
substituent	s AJ ʌ AM b AH s AJ t AC ɪ AM t AC ʃ AJ u BA ə AM n AG t AC
subtle	s AJ ʌ AM ɾ BJ ɫ̩
subway	s AJ ʌ AM b AH w AK e AM ɪ̯ AB
sudden	s AJ ʌ AM d AC n̩ BM
super	s AJ u BA p AH ɚ AM
support	s AJ ə AM pʰ AI ɔ BA ɹ AB t AC
suppose	s AJ ə AM pʰ AI o BA ʊ BA z AJ
sweaty	s AJ w AK ɛ AM ɾ BJ i AM
sweetheart	s AJ w AK i AM ɾʱ CD ɑ AM ɹ AB t̠̚
syllable	s AJ ɪ AM l AE ə AM b AH ɫ AE
symbology	s AJ ɪ AM m AF b AH ɑ AM l AE ə AM d AC ʒ AJ i AM
symphony	s AJ ɪ AM ɱ AF f BE ə AM n AG i AM
syncline	s AJ ɪ AM ŋ AG k AC l AE a AM ɪ AM n AG
syntagms	s AJ ɪ AM n AG t AC æ AM m AF z AJ
t'	ː
tab	tʰ AD æ AM b̥ AH
tackle	tʰ AD æ AM k AC ɫ̩
taco	tʰ AD ɑ AM k AC o BA ʊ BA
take	tʰ AD e AM ɪ̯ AB k AC
talib	tʰ AD æ AM l AE ɪ AM b AH
talked	tʰ AD ɔː BB k AC t AC
tallit	tʰ AD ɑ AM ɫ AE ɪ AM s AJ
tampon	tʰ AD æ AM m AF p AH ɑ AM n AG
tap	tʰ AD æ AM p AH
tape	tʰ AD e AM ɪ̯ AB p AH
tapestry	t AC æ AM p AH ə AM s AJ t AC ʃ AJ ɹ AB i AM
tar	tʰ AD ɑ AM ɻ AJ
target	tʰ AD ɑ AM ɹ AB ɡ AC ɪ AM t̚
taring	t AC ɛ AM ə AM ɹ AB ɪ AM ŋ AG
tarn	t AC ɚ AM n AG
tarter	t AC ɑː AN t AC ə AM ɹ AB
tatsoi	tʰ AD ɑ AM ʔ AL t AC s AJ ɔ BA ɪ AM
tattoo	tʰ AD æ AM tʰ AD u̟ː BB
tea	tʰ AD i AM
teal	t AC iː AN ɫ AE
teared	t AC ɪː AN d AC
tearing	t AC ɪ AM ə AM ɹ AB ɪ AM ŋ AG
tech	tʰ AD ɛ AM k AC
teeter	tʰ AD i AM ɾ BJ ɚ AM
tej	t AC ɛ AM d AC ʒ AJ
telangana	t̪ AC ɛ AM l AE ə AM ŋ AG ɡ AC ɑː AN n AG ə AM
tellurian	tʰ AD ə AM l AE ɚː AN iː AN ɨ̃ BH n AG
temp	tʰ AD ɛ AM m AF p AH
ten	tʰ AD ɛ AM n AG
tenth	tʰ AD ɛ AM n̪ AG θ AJ
teotwawki	t AC i AM ɑ AM t AC w AK ɑ AM k AC i AM
tesselate	tʰ AD ɛ AM s AJ ɫ AE l AE e AM ɪ AM tʰ AD
thagomizer	θ AJ æ AM ɡ AC ə AM m AF a AM ɪ AM z AJ ɚ AM
thank	θ AJ æ AM ŋ AG k AC
theosophy	θ AJ i AM ɒ BA s AJ ə AM f BE i AM
theriac	θ AJ ɛ AM ɹ AB i AM ə AM k AC
thickie	θ AJ ɪ AM k AC i AM
thirty	θ AJ ɚ AM ɾ BJ i AM
thousand	θ AJ a AM ʊ̯ AK z AJ ɪ̈ AM n AG d AC
thread	θ AJ ɾ̪̊ BJ ɛ AM d AC
three	θ AJ ɾ̪̊ BJ i AM
thrice	θ AJ ɾ̪̊ BJ ɑ AM ɪ AM s AJ
thrill	θ AJ ɾ̪̊ BJ ɪ AM ɫ AE
throne	θ AJ ɹ AB o BA ʊ BA n AG
through	θ AJ ɾ̪̊ BJ ʊ BA u BA
throughout	θ AJ ɹ AB uːʷ a AM ʊ BA t AC
throw	θ AJ ɾ̪̊ BJ o BA ʊ BA
timber	t AC ɪˑ m AF b AH ɚː AN
time	tʰ AD a AM ɪ AM m AF
tin	tʰ AD ɪ AM n AG
tiptoe	tʰ AD ɪ AM p AH tʰ AD o BA ʊ̯ AK
tire	tʰ AD a AM ɪ̯ AB ɚ AM
titty	tʰ AD ɪ AM ɾ BJ i AM
to	tʰ AD u̟ BA
today	tʰ AD ʊ BA d AC e AM ɪ AM
tomato	tʰ AD ə̥ AM m AF ɑː AN tʰ AD ə AM ʊ BA
too	tʰ AD u̟ BA
toots	tʰ AD ʊ BA t AC s AJ
top	tʰ AD ɑˀ p AH
toronto	tʰ AD ə AM ɹ AB ɒ BA ɾ̃ CB ə AM
tortilla	t AC ɔ BA ɹ AB tʰ AD i AM j AB ə AM
total	tʰ AD ɔ BA ɾ BJ ɫ AE
towards	tʰ AD ə̥ AM w AK ɔ BA ɹ̠ d̠ AC z AJ
town	tʰ AD a AM ʊ̯ AK n AG
toyota	t AC ɔ BA ɪ̯ AB o BA ʊ̯ AK ɾ BJ ə AM
trace	t AC ʃ AJ ɹ AB e AM ɪ AM s AJ
tracer	t AC ʃ AJ ɹ AB e AM ɪ AM s AJ ɚ AM
traditionally	t AC ɹ AB ɪ AM d AC ɪ AM ʃ AJ n̩ BM l AE i AM
train	t̠ AC ɹ̠̝ʷ e AM ɪ AM n AG
trainee	t AC ʃ AJ ɹ AB e AM ɪ AM n AG i AM
trainees	t AC ʃ AJ ɹ AB e AM ɪ AM n AG i AM z AJ
traitor	tʰ AD ɹ AB e AM ɪ AM ɾ BJ ɚ AM
transcaucasia	t AC ɹ AB æ AM n AG s AJ k AC ɔː BB k AC e AM ɪ AM ʒ AJ ə AM
translator	tʰ AD ɹ AB æ AM n AG z AJ l AE e AM ɪ AM ɾ BJ ɚ AM
trap	t̠ AC ɹ̝̊ ä p AH
tree	t̠ AC ɹ̠̊ʷ i AM
trick	t̠ʰ AD ɹ̠̊ ɪ AM k AC
trig	t̠ʰ AD ɹ̠̊ ɪ AM ɡ AC
trill	t̠ʰ AD ɹ̠̊ ɪ AM l AE
trim	t̠ʰ AD ɹ̠̊ ɪ AM m AF
trip	t̠ʰ AD ɹ̠̊ ɪ AM p AH
true	t AC ʃ AJ ɹ AB ü
trunk	t AC ʃ AJ ɹ AB ʌ AM ŋ AG k AC
trust	t AC ɹ AB ʌ AM s AJ t AC
try	t̠ AC ɹ̠̊ʷ a AM ɪ AM
tsk	ǀ
tucker	tʰ AD ʌ AM k AC ɚ AM
turkish	t AC ɚ AM k AC ɪ AM ʃ AJ
turmeric	tʰ AD ɚ AM m AF ɚ AM ɪ AM k AC
turning	t AC ɚ AM n AG ɪ AM ŋ AG
turtle	tʰ AD ɚ AM ɾ BJ ɫ̩
tut	ǀ
twain	tʰ AD w̥ AK e AM ɪ AM n AG
twat	tʰ AD w̥ AK ɑ AM t AC
twelfth	tʰ AD w̥ AK ɛ AM l̪ AE θ AJ
twelve	t AC w̥ AK ɛ AM ɫ AE v BE
twenny	t AC w AK ʌ AM ɾ̃ CB i AM
twentieth	t AC w̥ AK ɛ AM ɾ̃ CB i AM ə AM θ AJ
twenty	t AC w̥ AK ɛ AM ɾ̃ CB i AM
twerk	t AC w̥ AK ɚ AM k AC
twice	t AC w̥ AK a AM ɪ AM s AJ
twig	tʰ AD w̥ AK ɪ AM ɡ AC
twin	t AC w̥ AK ɪ AM n AG
twink	tʰ AD w̥ AK ɪ AM ŋ AG k AC
twist	t AC w̥ AK ɪ AM s AJ t AC
twit	tʰ AD w̥ AK ɪ AM t AC
twitch	tʰ AD w̥ AK ɪ AM t AC ʃ AJ
twitter	tʰ AD w AK ɪ AM ɾ BJ ɚ AM
two	tʰ AD u̟ BA
twos	tʰ AD u̟ BA z AJ
ugh	ʌ AM
ukraine	j AB u̟ BA k AC ɹ AB e AM ɪ̯ AB n AG
unacceptable	ɐ BA n AG ɪ̞ AM k AC s AJ ɛ AM p AH tʰ AD ə AM b AH ɫ̩
uncle	ʌ AM ŋ AG k AC ɫ̩
under	ʌ AM ɾ̃ CB ɚ AM
understand	ʌ AM ɾ̃ CB ɚ AM s AJ t AC æ AM n AG d AC
undivided	ʌ AM ɾ̃ CB ɪ̈ AM v BE a AM ɪ̯ AB ɾ BJ ɪ̈ AM d AC
unfetter	ʌ AM n AG f BE ɛ AM ɾ BJ ɚ AM
unilateral	j AB ʉː BB n AG ɪ AM l AE æ AM t AC ʃ AJ ɹ AB ɫ̩
unisex	j AB uː BB n AG ɪ AM s AJ ɛ AM k AC s AJ
unite	j AB ʊ BA n AG a AM ɪ̯ AB ʔ AL t̚
united	j AB ʊ BA n AG a AM ɪ̯ AB ɾ BJ ɪ̈ AM d AC
unnerstand	ɜ AM ɽ̃ CB ɻ AJ s AJ t AC æ AM n AG d̚
untac	j AB u BA ɛ AM n AG t AC ɪ AM ɛ AM j AB s AJ iː AN
untaet	j AB u BA ɛ AM n AG t AC i AM ɛ AM j AB ɪ AM t AC iː AN
unutterable	ʌ AM n AG ʌ AM ɾ BJ ɚ AM ɪ̈ AM b AH l̩ BN
up	ʌ AM p̚
upmost	ʌ AM ʔ AL m AF o BA ʊ BA s AJ t AC
usher	ʌ AM ʃ AJ ɚ AM
utter	ʌ AM ɾ BJ ɚ AM
vajazzle	v BE ə AM d AC ʒ AJ æ AM z AJ l̩ BN
vale	v BE e AM ɪ AM ɫ AE
vendetta	v BE ɛ AM n AG d AC ɛ AM ɾ BJ ə AM
veneer	v BE ɨ AM n AG i AM ə̆ BF ɹ AB
venus	v BE i AM n AG ɪ̈ AM s AJ
verbal	v BE ɜ AM ˞ b AH ɫ̩
vermont	v BE ɚ AM m AF ɑ̃ BH ʔ AL
veteran	v BE ɛ AM ɾ BJ ə AM ɹ AB ə AM n AG
veto	v BE iː AN ɾ BJ o BA ʊ BA
vibrator	v BE a AM ɪ̯ AB b AH ɹ AB e AM ɪ̯ AB ɾ BJ ɚ AM
vicissitude	v BE ɨ AM s AJ ɪ AM s AJ ɨ AM t AC j AB uː BB d AC
vicissity	v BE ɪ AM s AJ ɪ AM s AJ ɨ AM t AC i AM
violin	v BE a AM ɪ̯ AB ɪ̈ AM l AE ɪ AM n AG
virtually	v BE ɚ AM t AC ʃ AJ u BA ə AM ɫ AE i AM
vitamin	v BE ʌ AM ɪ AM ɾ BJ ə AM m AF ɪ AM n AG
vlach	v BE l AE ɑː AN k AC
vocab	v BE ə AM ʊ BA k AC æ AM b AH
volatile	v BE ɑ AM l AE ə AM ɾ BJ ɫ̩
waddle	w AK ɑ AM ɾ BJ ɫ̩
wail	w AK e AM ɪ AM ɫ AE
waistband	w AK e AM ɪ AM s AJ t AC b AH æ AM n AG d AC
wait	w AK e AM ɪ̯ AB ʔ AL t AC
waiting	w AK e AM ɪ̯ AB ɾ BJ ɪ AM ŋ AG
wale	w AK e AM ɪ AM ɫ AE
wales	w AK e AM ɪ AM ɫ AE z AJ
wanted	w AK ɑ AM n AG tʰ AD ɪ AM d AC
wasn't	w AK ʌ AM z AJ n̩ BM t AC
water	w AK ɔ BA ɾ BJ ɚ AM
wattle	w AK ɑ AM ɾ BJ l̩ BN
wealth	w AK ɛ AM l̪ AE θ AJ
wean	w AK eː AN n AG
wear	w AK ɛ AM ɹ AB
weeaboos	w AK iː AN a AM b AH yː BB z AJ
weel	w AK iː AN l AE
welp	w AK ɛ AM l AE p̚
went	w AK ɛ AM n AG ʔ AL t̚
westside	w AK ɛ AM s AJ t AC s AJ a AM ɪ AM d AC
wetting	w AK ɛ AM ɾ BJ ɪ AM ŋ AG
what	w AK ʌˀ
what're	w AK ʌ AM ɾ BJ ɚ AM
whet	ʍ BK ɛ AM ʔ AL t̚
whetter	ʍ BK ɛ AM ɾ BJ ɚ AM
whew	ʍ BK ĭ̥ ŭ̥
who're	h AA ʊ BA ɚ AM
whole	h AA o BA ʊ BA ɫ AE
wholemeal	h AA ɔ BA ʊ BA ɫ AE m AF i AM ə AM ɫ AE
wholly	h AA o BA ʊ̯ AK ɫ AE l AE i AM
whuddup	w AK ʌ AM ɾ BJ ʌ AM p AH
width	w AK ɪ AM d̪ AC θ AJ
wilde	w AK a AM ɪ AM ə̯ AB ɫ AE d AC
will	w AK ɪ AM ɫ AE
window	w AK ɪ AM ɾ̃ CB o BA ʊ BA
winter	w AK ɪ AM ɾ̃ CB ɚ AM
winters	w AK ɪ AM ɾ̃ CB ɚ AM z AJ
wintertide	w AK ɪ AM ɾ̃ CB ɚ AM t AC a AM ɪ AM d AC
wintry	w AK ɪ AM ɾ̃ CB ə AM ɹ AB i AM
wisconsin	w AK ə AM s AJ kʰ AD ɑ AM n AG s AJ n̩ BM
witty	w AK ɪ AM ɾ BJ i AM
wolf	w AK ʊ̠ ɫ AE f BE
wool	w AK ʊ̠ ɫ AE
work	w AK ɚ AM k AC
wouldn't	w AK ʊ BA ɾ BJ ə AM n AG t AC
wrake	ɹ AB e AM ɪ̯ AB kʰ AD
wristlet	ɹ AB ɪ AM s AJ l AE ɨ AM ʔ̚
writer	ɹ̠ ă ɪ AM ɾ BJ ɚ AM
written	ɹ AB ɪ AM ʔ AL ɪ AM n AG
wuddup	w AK ʌ AM ɾ BJ ʌ AM p AH
xxx	ʔ AL ɛ AM k AC s AJ ʔ AL ɛ AM k AC s AJ ʔ AL ɛ AM k AC s AJ
y'all's	j AB ɔ BA l AE z AJ
yatt	j AB æ AM t AC
yech	j AB ɛ AM χ AJ
yep	j AB ɛ AM p̚
yeppity	j AB ɛ AM p AH ɨ AM ɾ BJ i AM
yeti	j AB ɛ AM ɾ BJ i AM
yive	j AB ɪ AM v BE
yolngu	j AB oː BB l AE ŋ AG ʊ BA
yum	j AB ʌ AM m AF
yuppity	j AB ʌ AM p AH ɨ AM ɾ BJ i AM
zarina	z AJ ʌ AM ɹʲ i AM n AG ə AM
zemfira	z AJ ɪ AM ɱ AF f BE i AM ɹ AB ə AM
ziti	z AJ i AM ɾ BJ i AM
zooplasty	z AJ o BA ʊ BA ə AM p AH l AE æ AM s AJ t AC i AM
zun	z AJ ʌ AM n AG
übermensch	ʔ AL yː BB b AH ɐ BA m AF ɛ AM n AG ʃ AJ
