'kay	ʔ kʰ e AD ɪ̯ AN
'll	ʊ AF
abode	ʔ ə AD b o AF ʊː AG d̥̚
accend	æ AD k s ɛ AD n d
accommodate	ə AD kʰ ɑ AM m ə AD d e AD ɪ AD t
accommodator	ə AD k ɑ AM m ə AD d e AD ɪ AD t ɚ BL
accordable	ə AD kʰ ɔ AF r ɾ ə AD b ɫ̩
accordantly	ə AD kʰ ɔ AF ɹ BC ɾ ɨ̞ AD n ʔ ɫ i AD
accreditation	ə AD k ɹ BC ɛ AD d ɨ AD ɾ e AD ɪ AD ʃ ə AD n
acidophilus	æ AD s ɪ AD d ɑ AM f ɪ AD l ə AD s
acknowledge	ɨ AD ɡ n ɑː BD l ɨ AD d ʒ
adam	æ AD ɾ ə AD m
added	æ AD ɾ ɪ AD d
additive	æ AD ɾ ə AD ɾ ɪ AD v
adelaide	æ AD d ɜ AD l æ AD ɪ̯ AN d
aelita	a AD ɪ̯ AN l i AD ɾ ə AD
aerose	i AD ɹ BC ə AD ʊ AF z
agglutinin	ə AD ɡ l uː AG ʔ n̩ ɪ AD n
aha	ə AD h AA ɑ AM
alacrity	ə AD l æ AD k ɹ BC ɨ AD t i AD
alder	ɑ AM l d ɚ BL
alders	ɔ AF l d ɚ BL z
alienation	e AD ɪ AD l i AD ə AD n e AD ɪ AD ʃ ə AD n
alignment	ə AD ɫ a AD ɪ AD n m ə AD n t
allergic	ə AD l ɚ BL d ʒ ɪ AD k
allergies	æ AD l ɚ BL d ʒ i AD z
allergy	æ AD l ɚ BL d ʒ i AD
alliteration	ə AD l ɪ AD ɾ ə AD ɹ BC e AD ɪ AD ʃ ə AD n
almanac	ɔ AF l m ə AD n æ AD k
alpha	æ AD ɫ f ə AD
am	ẽ ə̃ː AL m
amazing	ə AD m e AD ɪ̯ AN z ɪ AD ŋ
amity	æ AD m ɪ AD ɾ i AD
amphibious	æ AD m f ɪ AD b i AD ə AD s
analects	æ AD n ə AD l ɛ AD k t s
andrew	æ AD n d ʒ ɹ BC ʊ̈ BG u AF
angst	e AD ɪ AD ŋ k s t
angsts	e AD ɪ AD ŋ k s t s
anselm	æ AD n s ɛ AD l m
antarctica	æ AD ɾ̃ ɑ AM ɹ BC ɾ ɪ AD k ə AD
anthropomorphic	æ̃ AK n̪ θ ɹ̠ ə AD p ə AD m ɔ AF ɹ̠ f ɪ̈ AD k
antre	æ AD n ɾ ɚ BL
app	ʔ æ AD ʔ p̚
appear	ə AD pʰ i AD ɹ BC
apple	æ AD p ɫ̩
appled	æ AD p ɫ̩ d
arbitration	ɑ AM ɹ BC b ə AD t̠ ɹ̠ e AD ɪ AD ʃ n̩
aristotle	ɛ AD r ɪ AD s t ɑ AM ɾ ɫ̩
arlon	ɑː BD ɫ ɔː AG n
article	ɑː BD ɹ BC ɾ ɨ AD k ɫ
artina	ɑ AM ɹ BC tʰ i AD n ə AD
artisanal	ä ɹ BC t ə AD z æ AD n ə AD l
asked	æ AD s t
assertion	ə AD s ɚ BL ʃ n̩
atend	ə AD tʰ ɛ AD n d
attack	ə AD tʰ æ AD k
attar	æ AD t̬ ə AD ɹ BC
attend	ə AD tʰ ɛ AD n d
attic	æ AD ɾ ɪ AD k
attitude	æ AD ɾ ɪ AD t u AF d
attraction	ə AD t ʃ ɹ BC æ AD k ʃ ɪ̈ AD n
attrition	ə AD t ɹ BC ɪ AD ʃ ə AD n
aula	ɔː AG l a AD
authenticity	ɑ AM θ ɛ AD n t ɪ AD s ɪ AD ɾ i AD
auto	ɔ AF ɾ o AF ʊ AF
automate	ɒ AF ɾ o AF ʊ AF m e AD ɪ AD t
automatic	ɔ AF ɾ ə AD m æ AD ɾ ɪ AD k
autumn	ɔ AF ɾ ɪ̈ AD m
availability	ə AD v e AD ɪ AD l ə AD b ɪ AD l ɪ AD t ɪ AD
avocado	ɑ AM v ə AD k ɑ AM ɾ o AF ʊ AF
awara	ɑ AM w AC ʌ AM ɹ BC ʌ AM
ayuh	ˀe ɪ AD ʌˀ
baa	b ɑ AM
back	b æ AD k
bacterial	b æ AD k t ɪ AD ə AD ɹ BC i AD ə AD ɫ
badder	b æ AD ɾ ɚ BL
baedeker	b e AD ɪ AD d ə AD k ə AD ɹ BC
bail	b e AD ɪ̯ AN ə AD ɫ
balancelle	b æ AD l ə AD n s e AD ɫ
baldric	b ɔː AG ɫ d ɹ BC ɪ AD k
bale	b e AD ɪ̯ AN ə AD ɫ
balt	b ɔː AG l t
bar	b ɑ AM ˞
bard	b ɑ AM ɹ BC d
barn	b ɒ AF ə AD n
barrel	b ɛ AD ɚ BL ɹ BC ə AD ɫ
barter	b ɑ AM ɹ BC ɾ ɚ BL
basal	b e AD ɪ AD z ə AD ɫ
bashful	b æ AD ʃ f ʊ AF ɫ
bashkortostan	b ɑ AM ʃ k ɔ AF ɹ BC t o AF ə̯ AN s t ɛ AD ə AD n
bath	b ɑː BD θ
batter	b æ AD ɾ ɚ BL
battle	b æ AD ɾ ɫ̩
batty	b æ AD ɾ i AD
baulk	b ɔ AF ɫ k
bautzen	b a AD ʊ AF t s ə AD n
beagle	b iː AE ɡ ə AD ɫ
beared	b ɛː AE d
beater	b i AD ɾ ɚ BL
beatles	b iː AE ɾ ɫ̩ z
beauty	b j AB u AF ɾ i AD
bedding	b ɛ AD ɾ ɪ AD ŋ
bedight	b ɪ AD d ʌ AM ɪ AD t
beetle	b i AD ɾ ə AD ɫ
befang	b ə AD f æ AD ŋ
belarus	b ɛ AD l ɪ̈ AD ɹ BC u AF s
berlin	b ɚ BL l ɪ AD n
bestride	b ɪ AD s t ɹ BC a AD ɪ AD d
better	b ɛ AD ɾ ɚ BL
betther	b ɛ AD t̪ ɚ BL
betting	b ɛ AD ɾ ɪ AD ŋ
between	b ɪ AD tʰ w AC i AD n
bidet	b ɨ AD d e AD ɪ AD
bike	b ɐ AH ɪ AD k
bill	b ɪ AD ɫ
bing	b i AD ŋ
bird	b ɚ BL ɖ
bitey	b a AD ɪ̯ AN ɾ i AD
bitter	b ɪ AD ɾ ɚ BL
bittersweet	b ɪ AD ɾ ɚ BL s w AC i AD ʔ t̚
bitty	b ɪ AD ɾ i AD
blem	b l ɛ AD m
blicky	b l ɪ AD k i AD
bluntness	b l ʌ AM n ʔ n ɪ AD s
boated	b o AF ʊ̯ BA ɾ ɨ AD d
boating	b o AF ʊ̯ BA ɾ ɪ AD ŋ
boatings	b o AF ʊ̯ BA ɾ ɪ AD ŋ z
bockety	b ɑ AM k ə AD t iː AE
boded	b o AF ʊ̯ BA d ɨ AD d
body	b ɑ AM ɾ i AD
bodybuilder	b ɑː BD ɾ i AD b ɪ AD ɫ ɾ ɚ BL
bother	b ɑ AM ð ɚ BL
bottle	b ɑ AM ɾ ɫ̩
bottler	b ɑ AM ɾ l̩ ɚ BL
bottom	b ɑ AM ɾ ə AD m
bottoms	b ɑ AM ɾ ə AD m s
bountiful	b a AD ʊ̯ BA n ɾ ə AD f ə AD ɫ
boutye	b ɐ AH ʏ AH t ʃ ə AD
brakeforce	b ɹ BC e AD ɪ AD k f ɔː AG ɹ BC s
brattily	b ɹ BC æ AD ɾ ɪ AD l i AD
bratty	b ɹ BC æ AD ɾ i AD
breach	b ɹ BC iː AE t ʃ
break	b ɹʷ e AD ɪ̯ AN k
bricolage	b ɹ BC i AD k o AF ʊ AF l ɑ AM ʒ
brighten	b ɹ BC a AD ɪ̯ AN ʔ n̩
brighter	b ɹ BC a AD ɪ̯ AN ɾ ɚ BL
brighton	b ɹ BC a AD ɪ̯ AN ʔ ə AD n
britain	b ɹ BC ɪ AD ʔ n̩
british	b ɹ BC ɪ AD ʔ ɪ AD ʃ
broha	b ɹ BC o AF ʊ̯ BA h AA ɑ AM
buccopalatal	b ʌ AM kʰ o AF ʊː AG pʰ æː AE l ə AD ɾ ɫ̩
builder	b ɪ AD ɫ ɾ ɚ BL
bumboclaat	b ʌ AM m b ə AD k l ɑ AM t
burglar	b ɚ BL ɡ l ɚ BL
butted	b ʌ AM ɾ ɨ AD d
butter	b ʌ AM ʔ ɚ BL
butterfly	b ʌ AM ɾ ɚ BL f l a AD ɪ AD
butting	b ʌ AM ɾ ɪ AD ŋ
buttings	b ʌ AM ɾ ɪ AD ŋ z
buttock	b ə AD ɾ ə AD k
button	b ʌ AM ʔ n̩
cacao	k ə AD kʰ e AD ɪ̯ AN o AF ʊ̯ BA
cacoepy	k ə AD k ə AD ʊ AF ɪ AD p ɪ AD
cadel	kʰ e AD i AD d l̩
cain	kʰ e AD ɪ AD n
caisson	k e AD ɪ AD s ɑ AM n
cake	kʰ e AD ɪ AD k
calculator	kʰ æ AD ɫ k j AB ə AD l e AD ɪ̯ AN ɾ ɚ BL
calendar	kʰ æ AD l ə AD n d ɚ BL
call	kʰ ɔ AF ɫ
called	k ɔ AF l d
cam	k æ AD m
cambodia	k æ AD m b o AF ʊ AF d i AD ə AD
came	kʰ e AD ɪ̯ AN m
camp	kʰ ɛ AD ə AD m p
can	kʰ ɛ AD ə AD n
canada	kʰ ɛ AD ə AD n ə AD d ə AD
canadia	kʰ ə AD n e AD ɪ̯ AN ɾ i AD ə AD
canadian	kʰ ə AD n e AD ɪ AD ɾ i AD ə AD n
cane	kʰ e AD ɪ AD n
cap	kʰ æ AD p
cap'n	k æ AD ʔ m̩
cappadocia	k æ AD p ə AD d o AF ʊ AF ʃ ə AD
caramba	k a AD ɹ BC a AD m b a AD
carbuncle	kʰ ɑ AM ɹ BC b ʌ AM ŋ k l̩
card	kʰ ɑ AM ɹ BC d
care	k ɛ AD ə̯ AN ɻ
carload	kʰ ɑ AM ɹ BC l o AF ʊ AF d
carton	kʰ ɑ AM ɹ BC ʔ n̩
carving	k ɑ AM ɹ BC v ɪ AD ŋ
casserole	k æ AD s ɚ BL ɔ̹ ɫ
cat	kʰ æ AD t̚
cater	kʰ e AD ɪ̯ AN ɾ ɚ BL
cathedra	k ə AD θ iː AE d ɹ BC ə AD
catty	kʰ æ AD ɾ i AD
caucasian	k ɔː AG k e AD ɪ AD ʒ ə AD n
caught	k̠ʰ oː AG t
cause	kʰ ɒː AG z̥
caused	kʰ ɒ AF z d
cauterize	kʰ ɔ AF ɾ ə AD ɹ BC a AD ɪ AD z
cavity	kʰ æ AD v ɪ AD ɾ i AD
ceili	k e AD ɪ AD l i AD
center	s ɪ AD ɾ̃ ɚ BL
centre	s ɪ AD ɾ̃ ɚ BL
centres	s ɪ AD ɾ̃ ɚ BL s
cereal	s ɪ AD ə AD ɹ BC iː AE ə AD ɫ
certification	s ɚ BL ɾ ɪ AD f ɪ AD k e AD ɪ AD ʃ ə AD n
chance	t ʃʰ ɛ AD ə AD n s t ʃʰ e AD ə AD n s
chaparral	ʃ æ AD p ɚ BL ɹ BC ɛ AD l
char	t ʃ ɑ AM ˞
charnel	t ʃ ɑː BD ɹ BC n ə AD l
chartreuse	ʃ ɑ AM ɹ BC t ɹ BC uː AG z
chastity	t ʃ æ AD s t ɪ AD ɾ i AD
chatted	t ʃ æ AD ɾ ɨ AD d
chatty	t ʃ æ AD ɾ i AD
chaver	h AA ɑ AM v ɛ AD ɹ BC
cheated	t ʃ i AD ɾ ɨ AD d
children	t ʃ ɪ AD l d̠ ɹ̠̝ʷ ə AD n
china	t ʃʰ a AD ɪ̯ AN n ə AD
chitterlings	t ʃ ɪ AD ɾ ɚ BL l ɪ AD ŋ z
choo	t ʃ uː AG
chortle	t ʃ ɔ AF ɹ BC ɾ ɫ̩
cicada	s ɪ̈ AD kʰ ɑ AM ɾ ə AD
circle	s ɚ BL k ə AD ɫ
circuit	s ɚ BL k ə AD t
cital	s a AD ɪ AD d l̩
citation	s a AD ɪ AD tʰ e AD ɪ AD ʃ n̩
cited	s ɐ AH ɪ̯ AN ɾ ɨ AD d
citing	s a AD ɪ̯ AN ɾ ɪ AD ŋ
clay	k l̥ e AD ɪ AD
clean	kʰ l̥ ĩ n
cleanup	k l iː AE n ʌ AM p
click	kʰ l̥ ɪ AD k
cliff	k l̥ʰ ɪ AD f
climb	kˡ l a AD ɪ AD m
clip	k l̥ʰ ɪ AD p
clit	k l̥ʰ ɪ AD t
clutter	k l ʌ AM ɾ ɚ BL
coach	kʰ o AF ʊ̯ BA t ʃ
coated	kʰ o AF ʊ̯ BA ɾ ɨ AD d
coating	kʰ o AF ʊ̯ BA ɾ ɪ AD ŋ
coatings	kʰ o AF ʊ̯ BA ɾ ɪ AD ŋ z
coccus	kʰ ɑ AM k ə AD s
coconut	kʰ o AF ʊ̯ BA k ə AD n ʌ AM t
collaboration	kʰ ə AD l æ AD b ə AD ɹ BC e AD ɪ̯ AN ʃ ə AD n
come	kʰ ʌ AM m
comfort	kʰ ʌ AM ɱ f ɚ BL t
comfortable	kʰ ʌ AM ɱ f tʰ ə̥ AD b ɫ̩
comfy	kʰ ʌ AM ɱ f i AD
comment	kʰ ɑ AM m ɛ AD n t
committee	k ə AD m ɪ AD t i AD
community	k ə AD m j AB u AF n ə AD ɾ i AD
compare	k ə AD m p ɛ AD ɹ BC
comptroller	k ə AD m t ɹ BC o AF ʊ AF l ə AD ɹ BC
computer	k ə AD m pʰ j AB u AF ɾ ɚ BL
concoct	kʰ ə AD ŋ kʰ ɒ AF k t
concoction	kʰ ə AD ŋ kʰ ɑ AM k ʃ ɪ AD n
confer	kʰ ə̥ AD ɱ f ɚ BL
conference	kʰ ɑ AM ɱ f ɹ BC ə AD n s
confident	kʰ ɑ AM ɱ f ə AD d n̩ t
confirmation	kʰ ɑ AM ɱ f ɚ BL m e AD ɪ AD ʃ n̩
conservancy	k ə AD n s ɜː AE v ə AD n s ɪ AD
consider	k ə AD n s ɪ AD ɾ ɚ BL
consigliere	k ɒ AF n s ɪ AD l j AB ɛ AD ɹ BC i AD
consonantal	kʰ ɑ AM n s ə AD n ə AD n ɾ ə AD ɫ
contestant	k ə AD n tʰ ɛ AD s t ə AD n t
conversation	kʰ ɑ AM ɱ v ɚ BL s e AD ɪ AD ʃ n̩
convert	kʰ ə̥ AD ɱ v ɚ BL t
corncob	k ɔ AF ɹ BC n k ɑ AM b
corrode	k ɚ BL ɹ BC o AF ʊ̯ BA d
cot	kʰ ɑ AM t̚
coterie	k o AF ʊ AF ɾ ə AD ɹ BC i AD
cottage	k ɑ AM ɾ ɪ AD d ʒ
cotton	k ɑ AM ʔ n̩
cougar	kʰ u AF ɡ ɚ BL
coulda	kʰ ʊ AF d ə AD
couldn't	k ʊ AF n ʔ
countable	kʰ a AD ʊ AF n ɾ ə AD b ɫ̩
counter	kʰ a AD ʊ̯ BA ɾ̃ ɚ BL
counterintuitive	kʰ a AD ʊ AF ɾ̃ ɚ BL ɪ AD n tʰ u AF ɪ AD ɾ ɪ AD v
country	kʰ ʌ AM n t̠ ɹ̠̊ʷ i AD
cousin	kʰ ɐ AH z ə AD n
coventry	kʰ ɑ AM v ə AD n t ʃ ɹ BC i AD
crayon	kʰ ɹ BC e AD ɪ AD ɑ AM n
craytur	k ɹ BC eː AE t̪ ə AD ɹ BC
creation	k ɹ BC iːʲ e AD ɪ AD ʃ ɘ AD n
creep	kʰ ɹ BC iː AE p
crikey	k ɹ BC ɑ AM e̯ AN k ɪ AD i̯ AN
crocodile	kʰ ɹ BC ɑ AM k ə AD d a AD ɪ AD ɫ
croissant	kʰ ɹ BC ə AD s ɑ AM n t
croton	k ɹ BC o AF ʊ̯ BA ʔ n̩
crumble	k ɹ BC ʌ AM m b ɪ̈ AD l
cryptography	k ɹ̥ BC ɪ AD p tʰ ɒ AF ɡ ɹ BC ə AD f iː AE
cuba	k j AB uː AG b ə AD
cuban	k j AB ʉː BH b ə AD n
cue	k j̥ AB ʉː BH
culprit	kʰ ʌ AM ɫ p ɹ BC ɪ AD t
cum	kʰ ʌ AM m
cunt	kʰ ʌ̃ BE n t
cur	k ɚ BL
cursed	kʰ ɚ BL s ɪ̈ AD d
cursor	kʰ ɜ AD ˞ s ə AD ˞
curtain	k ɚ BL ʔ n̩
cylinder	s ɪ AD l ɪ̈ AD n d ɚ BL
cymbal	s ɪ AD m b ɫ̩
dance	d ɛ AD ə AD n s
dandle	d æ AD n d ə AD ɫ
daniel	d a AD n j AB ə AD l
data	d æ AD ɾ ə AD
daughter	d ɔ AF ɾ ɚ BL
dayouth	d æ AD jː AJ uː AG θ
dayum	d æ̙ j AB ə AD m
dean	d ĩː n
deity	d i AD ə AD ɾ i AD
delightful	d ə AD l a AD ɪ̯ AN t̚ f ə AD ɫ
delta	d ɛ AD ɫ t ə AD
density	d ɛ AD n s ə AD ɾ i AD
dental	d ɛ AD ɾ̃ ɫ̩
denton	d ɪ AD n ʔ n̩
desirable	d ɪ AD z a AD ɪ AD j AB ə AD ɹ BC ə AD b ə AD ɫ
desktop	d ɛ AD s k t ɑ AM p
desktops	d ɛ AD s k t ɑ AM p s
diabolical	d a AD ɪ AD ə AD b ɑ AM l ɪ AD k ə AD ɫ
didn't	d ɪ AD ʔ n̩ t
differential	d ɪ AD f ə AD ɹ BC ə AD n ʃ ə AD ɫ
dildo	d ɪ AD ɫ d o AF ʊ AF
dingaling	d ɪ AD ŋ ə AD l ɪ AD ŋ
dingwad	d ɪ AD ŋ w AC ɑ AM d
dinner	d ɪ AD n ɚ BL
dirty	d ɚ BL ɾ i AD
disburse	d ɪ AD s p ɚ BL s
disentangle	d ɪ AD s ɪ AD n t æ AD ŋ ɡ ə AD ɫ
disentitle	d ɪ AD s ɪ AD n t a AD ɪ AD t ə AD ɫ
disgust	d ɪ AD s k ʌ AM s t
dismal	d ɪ AD z m ə AD ɫ
dismantle	d ɪ AD s m æ̃ AK n ɾ ɫ̩
dispel	d ɪ AD s p ɛ AD ɫ
dispensable	d ɪ AD s pʰ ɛ AD n s ə AD b ɫ̩
dissemble	d ɪ AD s ɛ AD m b ə AD ɫ
distill	d ɪ AD s t ɪ AD ɫ
ditto	d ɪ AD ɾ o AF ʊ AF
dna	d i AD ɛ AD n e AD ɪ AD
dniester	n iː AE s t ə AD
dockize	d ɒ AF k ɑ AM ɪ̯ AN z
dojo	d o AF ʊ̯ BA d ʒ o AF ʊ̯ BA
dole	d o AF ʊ̯ BA ɫ
don't	d o AF ʊ̯ BA ʔ t̚
dope	d o AF ʊ AF p
double	d ʌ AM b ɫ
dower	d a AD ʊ AF ɚ BL
drawn	d ɹ BC ɔː AG n
dream	d̠ ɹ̠ʷ ɪ AD i̯ AN m
dreich	d ɹ BC iː AE x
drill	d ɹ BC ɪ AD ɫ
drink	d̠ ɹ̠ʷ ɪ AD ŋ k
drive	d̠ ɹ̠̝ʷ a AD ɪ AD v
drop	d ʒ ɹ BC ɑ AM p
drown	d̠ ɹ̠ʷ a AD ʊ AF n
drug	d̠ ɹ̠ʷ ʌ AM ɡ
drugs	d ʒ ɹ BC ʌ AM ɡ z
dude	d ʉː BH u̯ BA d
dyadic	d a AD ɪ AD æ AD ɾ ɪ AD k
eaten	iː AE ʔ n
eating	i AD ɾ ɪ AD ŋ
eccentricity	ɛ AD k s ə AD n t ɹ BC ɪ AD s ə AD ɾ i AD
edit	ɛ AD ɾ ɪ AD ʔ t̚
eighty	ʔ e AD ɪ̯ AN ɾ i AD
emphasis	ɛ AD ɱ f ə AD s ɪ AD s
enabled	ɛ AD n e AD ɪ AD b ə AD ɫ d
encouragement	ɪ AD n k ʌ AM ɹ BC ɪ AD d ʒ m ə AD n t
enter	ɪ AD ɾ̃ ɚ BL
entertain	ɛ AD ɾ̃ ɚ BL tʰ e AD ɪ AD n
epigraphy	ʔ ɨ AD pʰ ɪː AE ɡ ɹ BC ə AD f iː AE
epimutation	ɛ AD p ɪ AD m j AB u AF t e AD ɪ AD ʃ ə AD n
epitaph	ɛ AD p ɪ AD t æ AD f
epitomic	ɛ AD p ɪ AD t ɒ AF m ɪ AD k
ersatz	ɛ AD ə AD ɹ BC s ɑː BD t s
essential	ə AD s ɛ AD n t ʃ ə AD l
esteem	ɛ AD s t iː AE m
eugh	ʌ AM x
evidence	ɛ AD v ə AD ɾ ɪ AD n s
ew	ɪ̃ AK ʉ̃ BJ u AF
exigency	ɛ AD ɡ z ɨ AD d ʒ ə AD n s i AD
farrand	f æ AD ɹ BC ə AD n t
fastness	f æ AD s n ə AD s
fatal	f e AD ɪ AD ɾ ɫ̩
fatality	f e AD ɪ̯ AN tʰ æ AD l ɪ AD ɾ i AD
fatally	f e AD ɪ̯ AN ɾ l̩ i AD
fated	f e AD ɪ̯ AN ɾ ɨ AD d
fattening	f æˀ ə AD n ɪ AD ŋ
fatuity	f ə AD t uː AG ɨ AD ɾ i AD
fauces	f ɔː AG s iː AE z
fauxtograph	f oː AG t ə AD ɡ ɹ BC ɑː BD f
fauxtography	f oː AG t ɑ AM ɡ ɹ BC ə AD f i AD
feel	f iː AE ɫ
fence	f ɛ AD n t s
fencer	f ɛ AD n s ɚ BL
fettuccini	f ɛ AD ɾ ə AD t ʃʰ i AD n i AD
feudal	f j AB uː AG d ɫ̩
fiddle	f ɪ AD ɾ l̩
fiddy	f ɪ AD ɾ i AD
fight	f ʌ AM ɪ AD t
fighter	f a AD ɪ̯ AN ɾ ɚ BL
fighty	f ʌ AM ɪ AD ɾ i AD
file	f a AD ɪ̯ AN ɫ
fill	f ɪ AD ɫ
filling	f ɪ AD ɫ l ɪ AD ŋ
film	f ɪ AD ɫ m
fire	f a AD ɪ AD ɚ BL
firm	f ɚ BL m
fitra	f ɪ AD tˤ ɾ a AD
fitz	f ɪ AD t s
flaithiúlach	f l æ AD h AA uː AG l ə AD x
flatter	f l æ AD ɾ ɚ BL
flizz	f l ɪ AD z
flouted	f l a AD ʊ̯ BA ɾ ɨ AD d
flouting	f l a AD ʊ̯ BA ɾ ɪ AD ŋ
flutter	f l ʌ AM ɾ ɚ BL
foot	fʷ ʊ AF t̚
football	fʷ ʊ AF ʔ t̚ b ɑ AM ɫ
fordy	f ɔ AF ɚ̯ ɾ i AD
forest	f ɔ AF ɹ BC ɛ̈ s tʰ
foretell	f ɔː AG t ɛ AD ɫ
forever	f ɚ BL ɛ AD v ɚ BL
fortnight	f ɔ AF ˞ ʔ n ɐ AH ɪ̯ AN t̚
fortunate	f o AF ɹ BC t ʃ ə AD n ə AD tʰ
forty	f ɔ AF ɹ BC ɾ i AD
fountain	f a AD ʊ AF n ʔ n̩
free	f ɹ BC ɪ AD i̯ AN
french	f ɹ̠ ɛ AD n̠ t ʃ
friend	f ɹ̥ BC e AD n d̥
fuck	f ʌ AM kʰ
fuckability	f ʌ AM k ɪ̈ AD b ɪ AD l ɪ̈ AD ɾ i AD
fuel	f j AB u AF w AC ə AD ɫ
full	f ʊ AF ɫ
function	f ʌ AM ŋ k ʃ ɪ̈ AD n
fur	f ɚ BL
furcal	f ɚ BL k ə AD ɫ
furrier	f ɚˑ i AD ɚ BL
furtive	f ɚ BL ɽ ɪ AD v
futtock	f ə AD ɾ ə AD k
gaeltacht	ɡ e AD ɪ AD l t ə AD x t
gangtok	ɡ æ AD ŋ t ɒ AF k
gasoline	ɡ æ AD s ɵ AH l i AD n
gaumy	ɡ ɔː AG m i AD
gawd	ɡ ɔː AG d
genetic	d ʒ ɪ AD n ɛ AD t ɪ AD k
genkan	ɡ ɛ AD ŋ k ɑ AM n
gentle	d ʒ ɛ̃ AK ɾ̃ l̩
gentleman	d ʒ ɛ AD ɾ̃ ɫ̩ m ə AD n
getting	ɡ ɛ AD ɾ ɪ AD ŋ
gewürztraminer	ɡ ə AD v ɚ BL t s t ɹ BC ə AD m iː AE n ɚ BL
ghetto	ɡ ɛ AD ɾ o AF ʊ̯ BA
ghettoize	ɡ ɛ AD ɾ o AF ʊ̯ BA a AD ɪ̯ AN z
glitter	ɡ l ɪ AD ɾ ɚ BL
glizzy	ɡ l ɪ AD z i AD
gmail	d ʒ iː AE m e AD ɪ AD l
goat	ɡ o AF ʊ AF ʔ t̚
goathouse	ɡ o AF ʊ AF ʔ t̚
golden	ɡ ə AD l d ə AD n
good	ɡ ʊ̈ BG d
gotta	ɡ ɑ AM ɾ ə AD
gotten	ɡ ɑ AM ʔ n̩
graffito	ɡ ɹ BC ə AD f i AD ɾ o AF ʊ̯ BA
grandfather	ɡ ɹ̠ʷ ẽˑ ə̯̃ n d f ɑˑ BM ð ɚ BL
grass	ɡ ɹ̠ ɛ AD ə AD s
grated	ɡ ɹ BC e AD ɪ̯ AN ɾ ɪ AD d
gratified	ɡ ɹ BC æː AE ɾ ɨ AD f a AD ɪː AE d̚
grating	ɡ ɹ BC e AD ɪ̯ AN ɾ ɪ AD ŋ
greater	ɡ ɹ BC e AD ɪ AD ɾ ɚ BL
grivna	ɡ ɹ BC ɪ AD v n ɑ AM
grow	ɡ ɹ BC o AF ʊ̯ BA
grows	ɡ ɹ BC o AF ʊ̯ BA z
guesstimate	ɡ ɜ AD s t ɪ̈ AD m e AD ɪ̯ AN ʔ t̚
guileless	ɡ a AD ɪ AD ɫ l ə AD s
guttle	ɡ ʌ AM ɾ l̩
guttural	ɡ ʌ AM ɾ ɚ BL ɫ̩
gyros	d ʒ a AD ɪ AD ɹ BC o AF ʊ AF z
h	æ AD ɪ AD t ʃ
habitat	h AA æ AD b ɪ AD t æ AD ʔ
hadith	h AA a AD d iː AE θ
hail	h AA e AD ɪ̯ AN ɫ
hang	h AA e AD ɪ AD ŋ
hangnail	h AA e AD ɪ AD ŋ n e AD ɪ̯ AN ɫ
happening	h AA æ AD p n ɪ AD n
hawaii	h AA ʊ̈ BG w AC ɔ AF j AB i AD
he	ç i AD
heading	h AA ɛ AD ɾ ɪ AD ŋ
health	h AA ɛ AD l̪ θ
hearse	h AA ɚ BL s
heartbeat	h AA ɑ AM ɹ BC ʔ b i AD ʔ
heat	ç i AD t
hew	ç j AB uː AG
hibernation	h AA a AD ɪ AD b ɚ BL n e AD ɪ AD ʃ n̩
high	h AA a AD ɪ̯ AN
hill	h AA ɪ AD ɫ
hiller	h AA ɪ AD ɫ l ɚ BL
him	ɪ̈ AD m
hinoki	h AA i AD n o AF k i AD
hinter	h AA ɪ AD ɾ̃ ɚ BL
hitherto	h AA ɪ AD ð ɚ BL tʰ u AF
hmm	m̥ m̩
hmmm	m̥ m̩ː
hold	h AA o AF ə AD ɫ d
holding	h AA ə AD ʊ AF ɫ d ɪ AD ŋ
hole	h AA o AF ʊ AF ɫ
homophobe	h AA ə AD ʊ AF m ə AD f ə AD ʊ AF b
hon	m̥ ɑ AM n
honyock	h AA ɒ AF ŋ j AB ɒ AF k
hood	h AA ʊ̈ BG d
hooter	h AA u AF ɾ ɚ BL
horus	h AA ɔː AG ɹ BC ə AD s
hotel	h AA oː AG t e AD l
houston	j̊ AB uː AG s t ɨ AD n
hrivna	ɦ AA ɹ BC ɪ AD u̯ BA nʲ ɑ AM
hubris	ç j AB u̟ː BN b ɹʷ ɪ AD s
hue	ç u AF
huge	ç u̟ː BN d ʒ
huguenot	ɕ u AF ɡ ə AD n ɒ AF t
huh	h AA ə̃ AK
human	ç j AB u̟ BG m ə AD n
humanist	ç uː AG m ə AD n ɪ AD s t
humanity	h AA j AB u AF m æ AD n ɪ AD ɾ i AD
humongous	ç u̟ː BN m ʊ AF ŋ ɡ ə AD s
humph	h AA ʌ AM m f
hunter	h AA ʌ AM ɾ̃ ɚ BL
hurry	h AA ɚ BL ɹ BC i AD
hydra	h AA a AD ɪ̯ AN d ʒ ɹ BC ə AD
hydropsy	h AA a AD ɪ̯ AN d ɹ BC ɑ AM p s i AD
hyperhidrosis	h AA a AD ɪ AD p ə AD ɹ BC h AA a AD ɪ AD d ɹ BC o AF ʊ AF s ɪ AD s
hypotenuse	h AA a AD ɪ AD p ɑ AM ʔ ə AD n uː AG s
háček	ɦ AA ɑː BD t ʃ ɛ AD k
iced	a AD ɪ̯ AN s t
illegal	ɪ AD ɫ l i AD ɡ ə AD ɫ
illegitimate	ɪ AD l ɨ AD d ʒ ɪ AD ɾ ə AD m ɨ AD t
illusion	ɪ AD l uː AG ʒ ə AD n
imma	aː AE m ə AD
inamorata	ɪ AD n æ AD m ə AD ɹ BC ɑː BD ɾ ə AD
incel	ɪ AD n s ɛ AD ɫ
incidental	ɪ AD n s ɪ AD d ɛ AD ɾ̃ ə AD l
incommunicado	ɪ AD n k ə AD m j AB u AF n ɨ AD k ɑː BD d o AF ʊ AF
incredible	ɪ̈ AD ŋ k ɹ̥ʷ ɛ AD ɾ ə AD b ɫ̩
inexorably	ɪ AD n ɛ AD ɡ z ə AD ɹ BC ə AD b l i AD
inference	ɪ AD ɱ f ɹ BC ə AD n s
inhalation	ɪ AD n ɦ AA ə AD l e AD ɪ AD ʃ n̩
insolvency	ɪ AD n s ɒ AF l v n̩ s i AD
installation	ɪ AD n s t ə AD l e AD ɪ AD ʃ ə AD n
insufferable	ɪ AD n s ʌ AM f ɹ BC ə AD b l̩
interchangeable	ɪ AD ɾ̃ ɚ BL t ʃ e AD ɪ AD n d ʒ ə AD b l̩
interloper	ɪ AD ɾ̃ ɚ BL l o AF ʊ̯ BA p ɚ BL
international	ɪ AD ɾ̃ ɚ BL n æ AD ʃ ə AD n ə AD ɫ
interstate	ɪ AD ɾ̃ ɚ BL s t e AD ɪ̯ AN t
investigate	ɪ AD n v e AD s t ɪ AD ɡ e AD ɪ̯ AN t
ipa	a AD ɪ AD pʰ iː AE e AD ɪ AD
ireland	ʌ AM ɪ AD ɚ BL l ə AD n d
it	ɪ̈ AD t
italy	ɪ AD ɾ ə AD l i AD
item	a AD ɪ̯ AN ɾ ə AD m
ith	a AD ɪ̯ AN θ
jabberwocky	d ʒ æ AD b ɚ BL w AC ɑ AM k i AD
jar	d ʒ ɑ AM ɹ BC
jump	d ʒ ʌ AM m p
juniper	d ʒ u AF n ɪ̈ AD p ɚ BL
jupiter	d ʒ u AF p ɪ AD ɾ ɚ BL
jury	d ʒ ʊ AF ə AD ɹ̠ i AD
k	kʰ e AD ɪ AD
kana	kʰ ɑː BD n ə AD
kardashian	kʰ ɑ AM ɹ BC d æ AD ʃ i AD ə AD n
karma	k ə AD ɾ m ə AD
katana	k ɪ̈ AD tʰ ɑ AM n ə AD
katy	kʰ e AD ɪ̯ AN ɾ i AD
kebnekaise	k ɛ AD b n ə AD k a AD i AD s ə AD
keloid	k iː AE l ɔ AF ɪ AD d
kelvin	kʰ ɛ AD l v ɨ AD n
kettle	kʰ ɛ AD ɾ ɫ̩
key	kʲʰ iː AE
kick	kʰ ɪ AD k
kiddie	kʰ ɪ AD ɾ i AD
killer	kʰ ɪ AD ɫ l ɚ BL
kimono	k ɪ̈ AD m o AF ʊ̯ BA n ə AD
kimonoed	k ɪ̈ AD m o AF ʊ̯ BA n ɪ̈ AD d
kindergarten	kʰ ɪ AD ɾ̃ ə AD ɹ BC ɡ ɑː BD ɹ BC ʔ n̩
kirton	k ɚ BL ʔ n̩
kiss	kʰ ɪ AD s
kitten	k ɪ AD ʔ n̩
kitty	kʰ ɪ AD ɾ i AD
knar	n ɑ AM ˞
koizumi	kʰ ɔ AF i̯ AN z u AF m i AD
korea	kʰ ɵ AH ɹ BC i AD ə AD
l	ɫ
la	ɛ AD ɫ l e AD j AB
ladder	l æ AD ɾ ɚ BL
lambrusco	l æ AD m b ɹ BC ʊ AF s k o AF ʊ AF
land	ɫ e AD ə̯ AN n d
lander	l æ AD n d ɚ BL
language	l e AD ɪ AD ŋ ɡ w AC ɪ AD d ʒ
lar	l ɑ AM ˞
largely	l ɑː BD d ʒ l i AD
later	l e AD ɪ̯ AN ɾ ɚ BL
latin	l æ AD ʔ n̩
latter	l æ AD ɾ ɚ BL
laundry	l ɑ AM n d ɹ BC i AD
learner	l ɚ BL n ɚ BL
leeway	l iː AE w AC e AD ɪ AD
li'l	l ɪ AD ɫ̩
liable	l a AD ɪ̯ AN ə AD b ɫ̩
light	ɫ ɐ AH ɪ̯ AN ʔ
lighter	l a AD ɪ AD ɾ ɚ BL
lightning	l ʌ AM ɪ̯ AN ʔ n ɪ AD ŋ
lincolnshire	l i AD ŋ kʰ ə̆ AI n ʃ ɚ BL
listen	l ɪ AD s n̩
liter	l i AD ɾ ɚ BL
literally	l ɪ AD ɾ ɚ BL ə AD l i AD
literary	ɫ ɪ AD ɾ ə AD ɹ BC ɛ AD ə AD ɹ BC i AD
litre	l i AD ɾ ɚ BL
litter	l ɪ AD ɾ ɚ BL
little	ɫ ɪ AD ɾ ɫ
littlest	l ɪ AD ɾ l̩ ə AD s t̚
loiter	l ɔ AF j AB ɾ ɚ BL
lubricious	l u AF b ɹ BC ɪ AD ʃ ə AD s
luddite	l ʌ AM ɾ ʌ AM i AD t
lulls	ɫ ʌ AM ɫ z
lunch	l ʌ̃ BE n t ʃ
lycra	l a AD ɪ AD k ɹ BC ə AD
m'kay	ŋ k e AD ɪ AD
ma'am	m ɛ AD ə AD m
madder	m æ AD ɾ ə AD ɹ BC
mail	m e AD ɪ̯ AN ɫ
make	m e AD ɪ AD kʲ
malinois	m æ AD l ɪ AD n w AC ɑː BD
mamaliga	m ə AD m ə AD l i AD ɡ ə AD
man	m ẽ ə̃ AK n
mar	m ɑ AM ˞
marten	m ɑ AM ɹ BC ʔ n̩
martyr	m ɑ AM ɹ BC ɾ ɚ BL
mat	m æ AD ʔ t̚
matter	m æ AD ɾ ɚ BL
mawky	m ɔː AG k i AD
maybe	m e AD ɪ̯ AN b i AD
meal	m iː AE ʟ̩
medal	m ɛ AD ɾ ɫ̩
meehan	m iː AE h AA æ̝ː n
meeting	m i AD ɾ ɪ AD ŋ
melodic	m ɨ AD l ɑ AM ɾ ɪ AD k
mersh	m ɚ BL ʃ
merveilleuse	m ɛ AD ʁ v ɛ AD j AB ø AH z
merveilleux	m ɛ AD ʁ v ɛ AD j AB ø AH
meta	m ɛ AD ɾ ə AD
metal	m ɛ AD ɾ ɫ̩
metathesis	m ɛ AD tʰ æ AD θ ə AD s ɪ AD s
meteor	m i AD ɾ i AD ɚ BL
meter	m i AD ɾ ɚ BL
methoxphenidine	m ɛː AE θ ɑ AM k s f ɛː AE n ɨ AD ɾ ĩː n
metic	m ɛ AD ɾ ə AD k
metre	m iː AE ɾ ɚ BL
mhm	m̩ m̥ m̩
mi'kmaq	m ɪ AD ɡ ə AD m ɒ AF q
michael	m ɐ AH ɪ AD kʰ ɫ̩
michigander	m ɪ AD ʃ ə AD ɡ æ AD n d ɚ BL
middle	m ɪ AD ɾ ɫ̩
middleman	m ɪ AD d ɫ̩ m æ AD n
midst	m ɪ AD t s t
mighty	m ʌ AM ɪ AD ɾ i AD
mike	m ɐ AH ɪ AD ʔ k̚
mikey	m ɐ AH ɪ AD kʰ iː AE
mile	m a AD ɪ̯ AN ɫ
milkshake	m ɪ AD ɫ k ʃ e AD ɪ AD k
mill	m ɪ AD ɫ
minnesota	m ɪ AD n ɪ AD s o AF ʊ AF ɾ ə AD
minnesotan	m ɪ AD n ə AD s o AF ʊ AF ʔ n̩
minter	m ɪ AD ɾ̃ ɚ BL
mirth	m ɚ BL θ
mister	m ɪ AD s t ɚ BL
mmm	m̩
model	m ɑ AM ɾ ɫ
molasses	m ɵ AH l æ AD s ɨ AD z
moms	m ɑ AM m z
month	m ʌ AM n̪ θ
mosquitoey	m ə AD s k i AD ɾ o AF ʊ AF i AD
motlopi	m o AF ʊ AF ʔ l o AF ʊ AF p i AD
motorcycle	m o AF ʊ AF ɾ ɚ BL s a AD ɪ AD k l̩
mountain	m æ̃ AK ʊ̯̃ n ʔ n̩
mountaineer	m æ̃ AK ʊ̯̃ n ʔ n̩ i AD ə AD ɹ BC
muddy	m ʌ AM d i AD
multiplayer	m ʌ AM ɫ t i AD p l e AD ɪ̯ AN ɚ BL
multiplier	m ʌ AM ɫ t ɪ AD p l a AD ɪ AD ɚ BL
murr	m ɚ BL
mustard	m ʌ AM s t ɚ BL d
mutton	m ʌ AM ʔ n̩
myrrh	m ɚ BL
myrtle	m ɚ BL ɾ ɫ
nah	n ɑː BD
nail	n e AD ɪ̯ AN ɫ
nares	n æ AD ɹ BC iː AE z
narration	n ɛ AD ɚ BL ɹ BC e AD ɪ AD ʃ n̩
nauruan	n ɑː BD uː AG ɹ BC uː AG n̩
neato	n i AD ɾ o AF ʊ̯ BA
neutral	n uː AG t ʃ ɹ BC ə AD l
nevada	n ə AD v ɑ AM ɾ ə AD
never	n ɛ AD v ɚ̹
newcastle	n j AB u AF kʰ æ AD s ɫ̩
newcomer	n j AB u AF kʰ ʌ AM m ɚ BL
ng	ŋ
niggard	n ɪ AD ɡ ɚ BL d
niggered	n ɪ AD ɡ ɚ BL d
nightmare	n ʌ AM ɪ AD ʔ m ɛ AD ə AD ɹ BC
nighttime	n a AD ɪ AD ʔ t a AD ɪ AD m
nilotic	n a AD ɪ AD l ɑ AM ɾ ɪ AD k
nine	n a AD ɪ̯ AN n
nippon	n ɪ AD pʰ ɑ AM n
nitrate	n a AD ɪ̯ AN tʰ ɹ BC e AD ɪ̯ AN t
nitrogen	n ɐ AH ɪ AD tʰ ɹ BC ə AD d ʒ ə AD n
nizz	n ɪ AD z
nonce	n ɒ AF n t s
nope	n o AF ʊ AF p̚
notice	n o AF ʊ AF ɾ ɪ AD s
nut	n ɐ AH t
o'malley	ɵ AH m æ AD l i AD
october	ɑ AM k tʰ o AF ʊ AF b ɚ BL
odder	ʔ ɑ AM ɾ ɚ BL
oil	ɔ AF ɪ AD ɫ
olden	ɔ AF l d ə AD n
olive	ʔ ɑː BD ɫ l ɨ AD v̥
oni	o AF ʊ AF n iː AE
oppose	ʔ ə AD pʰ o AF ʊː AG z̥
order	ɔ AF ɹ BC ɾ ɚ BL
origami	ɔ AF ɹ BC ɪ̈ AD ɡ ɑ AM m i AD
otaku	o̞ AF ʊ̯ BA tʰ ɑ AM kʰ u AF
otter	ʔ ɑ AM ɾ ɚ BL
our	ɑ AM ˞
outer	a AD ʊ AF ɾ ɚ BL
pack	pʰ æ AD k
package	pʰ a AD k ɛ AD d ʒ
paddle	pʰ æ AD ɾ ɫ̩
paddy	pʰ æ AD ɾ i AD
padre	pʰ ɑ AM d ɹ BC e AD ɪ̯ AN
pah	pʼ aʰ
pail	pʰ e AD ɪ̯ AN ɫ
pale	pʰ e AD ɪ̯ AN ɫ
pansentience	p æ AD n s ɛ AD n t ʃ i AD ə AD n s
pantry	p æ AD nʰ ɹ̥ BC i AD
par	pʰ ɑ AM ˞
parcel	pʰ ɑː BD s ə AD ɫ
park	p ɒ AF ə AD k
parole	p ə AD ɹ BC ə AD ʊ AF ɫ
parse	pʰ ɑ AM ɹ BC z
partay	pʰ ɑ AM ɹ BC tʰ e AD ɪ̯ AN
partner	p ɑ AM ɹ BC ʔ n ɚ BL
party	pʰ ɑ AM ɹ BC ɾ i AD
pascal	pʰ æ AD s kʰ æ AD ɫ
pass	pʰ ɛ AD ə AD s
passion	pʰ æ AD ʃ ə AD n
pat	pʰ æˀ t̚
patent	pʰ æ̝ ʔ n̩ t
path	pʰ ɛ AD ə AD θ
patrick	pʰ æ AD t̠ ɹ̠̊ʷ ɪ AD k̚
pattern	p æ AD ɾ ɚ BL n
patting	pʰ æ AD ɾ ɪ AD ŋ
pattings	pʰ æ AD ɾ ɪ AD ŋ z
pay	pʰ e AD ɪ AD
pearl	pʰ ɚ BL ɫ
pearls	pʰ ɚ BL ɫ z
peculiar	pʰ ə̥ AD kʰ j̊ AB uː AG l j AB ʊ AF ə AD
peel	pʰ iː AE ɫ
peep	pʰ i AD p
peg	pʰ ɛ AD ɡ
penes	pʰ i AD n i AD z
penis	pʰ i AD n ɪ AD s
people	pʰ i AD p ɫ̩
percuss	p ɚ BL kʰ ʌ AM s
performance	p ɚ BL f ɔ AF ɹ BC m ə AD n s
person	pʰ ɚ BL s n̩
personality	p ɚ BL s ə AD n æ AD l ɪ AD ɾ i AD
pester	pʰ ɛ AD s t ɚ BL
pet	pʰ ɛ AD ʔ t
peter	pʰ i AD ɾ ɚ BL
petting	pʰ ɛ AD ɾ ɪ AD ŋ
petty	pʰ ɛ AD ɾ i AD
pewter	p j AB u AF ɾ ɚ BL
phew	ɸ j AB u̥ AF
philadelphia	f ɪ AD ɫ ə AD d ɜ AD ɫ f i AD ə AD
phlebolith	f l ɛ AD b ə AD l ɪ AD θ
phonetic	f ə AD n ɛ AD ɾ ɪ AD k
photo	f ŏ ʊ AF ɾ o AF ʊ AF
photograph	f ŏ ʊ AF ɾ ə AD ɡ ɹ̠ æ AD f
photographic	f o AF ʊ AF ɾ ə AD ɡ ɹ BC æ AD f ɪ AD k
photosynthesis	f ŏ ʊ AF ɾ o AF ʊ AF s ɪ AD n̪ θ ə AD s ɪ AD s
pick	pʰ ɪ AD k
pierre	pʰ i AD ə AD ɹ BC
piling	pʰ a AD ɪ̯ AN ɫ l ɪ AD ŋ
pill	pʰ ɪ AD ɫ
pin	pʰ ɪ AD n
pink	pʰ ɪ AD ŋ k
pit	pʰ ɪ AD ʔ t
pittance	pʰ ɪ AD ʔ n̩ s
place	pʰ l̥ e AD ɪ AD s
plack	pʰ l̥ æ AD k
plague	pʰ l̥ e AD ɪ AD ɡ
plain	pʰ l̥ e AD ɪ AD n
plan	pʰ l̥ æ AD n
plane	pʰ l̥ e AD ɪ AD n
plant	pʰ l̥ æ AD n t
plantigrade	p l e AD ə̯ AN ɾ̃ ə AD ɡ ɹ BC e AD ɪ̯ AN d
plaque	pʰ l̥ æ AD k
plastic	pʰ l æ AD s t ɪ AD k
plate	pʰ l̥ e AD ɪ AD t
play	p l̥ e AD ɪ AD
please	p ɫ̥ i AD z
plenty	p l ɪ AD ɾ̃ i AD
pluto	p l u AF ɾ o AF ʊ AF
poem	pʰ o AF ʊ̯ BA ə AD m
poet	pʰ o AF ʊ̯ BA ɪ̈ AD ʔ t̚
poetry	pʰ o AF ʊ̯ BA ə AD t ɹ BC i AD
poilu	p w AC ɑː BD l uː AG
polar	pʰ o AF ʊ̯ BA l ɚ BL
pole	pʰ o AF ʊ̯ BA ɫ
police	p ə AD l iː AE s
pool	pʰ u AF ɫ
popping	pʰ ɑ AM p ɪ̈ AD ŋ
portable	pʰ ɔ AF ɹ BC ɾ ɪ̈ AD b l̩
portal	pʰ ɔː AG ɹ BC ɾ ɫ̩
postal	p o AF ʊ AF s t l̩
potato	p ə̥ AD tʰ e AD ɪ AD ɾ ə AD
potent	pʰ o AF ʊ̯ BA ʔ n̩ t
power	pʰ a AD ʊ̯ BA ɹ BC
pressure	p ɹ BC ɛ AD ʃ ɚ BL
pretzel	pʰ ɹ BC ɛ AD ʔ t s ɫ̩
prick	pʰ ɹ̠̊ ɪ AD k
pride	p ɹ̥ʷ a AD ɪ AD d
priest	p ɹ̥ BC iː AE s t
prim	pʰ ɹ̠̊ ɪ AD m
printer	pʰ ɹ BC ɪ AD ɾ̃ ɚ BL
prism	pʰ ɹ̠̊ ɪ AD z m̩
prison	pʰ ɹ̠̊ ɪ AD z n̩
processors	p ɹ BC ɑ AM s ɛ AD s ɚ BL z
prodigal	pʰ ɹ BC ɑ AM ɾ ɪ AD ɡ ɫ̩
produceorial	p ɹ BC ɑ AM d ə AD s o AF ʊ AF ɹ BC i AD ə AD l
pronto	pʰ ɹ BC ɑ AM n tʰ o AF ʊ̯ BA
pronunciation	pʰ ɹ BC ə AD n ʌ AM n s i AD e AD ɪ AD ʃ ə AD n
propaganda	p ɹ BC ɒ AF p ə AD ɡ æ AD n d ə AD
property	p ɹ BC ɑ AM p ɚ BL ɾ i AD
psittacosis	s i AD ɾ ə AD k o AF ʊ AF s ɨ AD s
pulchritude	pʰ ʌ AM ɫ k ɹ BC ə AD t uː AG d
pull	pʰ ʊː AG ɫ
punctuate	p ʌ AM ŋ k ʃ uː AG e AD ɪ AD t
punter	pʰ ʌ̃ː BF ɾ̃ ɚ BL
puppy	pʰ ɐ AH p i AD
purl	pʰ ɚ BL ɫ
purlin	p ɜː AE ɹ BC l ɪ AD n
purls	pʰ ɚ BL ɫ z
push	pʷ ʊ AF ʃ
put	pʰ ʊ AF ʔ t
putt	pʰ ʌ AM t
putting	pʰ ʌ AM t ɪ AD ŋ
quaint	kʰ w AC e AD ɪ̯ AN n t
quality	kʰ w AC ɑ AM ɫ ə AD ɾ i AD
quantity	kʰ w AC ɑ AM n ɾ ɨ AD ɾ i AD
quantum	kʰ w AC ɑ AM n tʰ ə AD m
queen	kʷ w AC iː AE n
quesadilla	kʰ e AD ɪ̯ AN s ə AD d i AD j AB ə AD
quick	k w̥ AC ɪ AD k
quid	kʰ w̥ AC ɪ AD d
quiff	kʰ w̥ AC ɪ AD f
quill	kʰ w̥ AC ɪ AD l
quilt	kʰ w̥ AC ɪ AD l t
quin	kʰ w̥ AC ɪ AD n
quinn	kʰ w̥ AC ɪ AD n
quint	kʰ w̥ AC ɪ AD n t
quip	kʰ w̥ AC ɪ AD p
quit	kʰ w̥ AC ɪ AD t
quiz	kʰ w̥ AC ɪ AD z
radar	ɹ BC e AD ɪ AD ɾ ɚ BL
radio	ɹ BC e AD ɪ AD ɾ i AD o AF ʊ AF
rail	ɹ BC e AD ɪ AD ɫ
rajgira	ɾ ɑː BD d ʒ ɡ i AD r ɑː BD
rambo	ɹ BC æ AD m b ə AD ʊ AF
rating	ɹ BC e AD ɪ AD ɾ ɪ AD ŋ
ratty	ɹ BC æ AD ɾ i AD
reading	ɹ BC iː AE ɾ ɪ AD ŋ
rebutter	ɹ BC ɪ̈ AD b ʌ AM ɾ ɚ BL
recension	ɹ̠ʷ ɪ̈ AD s ɛ̃ AK n t̚ ʃ ə̃ AK n
reconnoiter	ɹˠ ɛ AD k ə AD n ɔ AF ɪ̯ AN ɾ ɚ BL
reconnoitre	ɹˠ ɛ AD k ə AD n ɔ AF ɪ̯ AN ɾ ɚ BL
regular	ɹ BC ɛ AD ɡ l̩ ɚ BL
relative	ɹ BC ɛ AD l ə AD ɾ ɪ AD v
relatively	ɹ BC ɛ AD l ə AD ɾ ɪ AD v l i AD
relinquish	ɹ BC ɪ AD l ɪ AD ŋ k w AC ɪ AD ʃ
remote	ɹ BC ɪ AD m o AF ʊ AF t
republic	ɹ BC ɪ AD p ʌ AM b l ɪ AD k
respectable	ɹ BC i AD s p ɛ AD k t ə AD b l̩
retail	ɹ̠ʷ i AD tʰ e AD ɪ̯ AN ɫ
reticent	ɹ BC ɛ AD d ə AD s ə AD n t
revelry	ɹ BC ɛ AD v ə AD ɫ ɹ BC i AD
reëvoke	ɹ BC iː AE ʔ i AD v ə AD ʊ AF k
rhotic	ɹ̠ʷ ɵ AH ʊ AF ɾ ɪ̈ AD k
rider	ɹ̠ a AD ɪ AD ɾ ɚ BL
right	ɹ BC a AD ɪ AD ʔ t̚
robotics	ɹ BC o AF ʊ AF b ɑ AM ɾ ɪ AD k s
rocks	ɹʷ ɔ AF k s
rocky	ɹʷ ɒ AF k i AD
romantic	ɹ BC o AF ʊ AF m æ AD n t ɪ AD k
rose	ɻʷ ö̞ ʊ AF z̥
rot	ɹ BC ɑ AM t
roti	ɹ BC ɔ AF ʊ AF ɾ ɪ AD i̯ AN
rotten	ɹ BC ɑ AM ʔ n̩
rubbed	ɹ BC ʌˑ b̚ d̥
ruby	ɹ BC uː AG b i AD
rule	ɹ BC uː AG ɫ
saddle	s æ AD d l̩
sail	s e AD ɪ̯ AN ɫ
sang	s ɛ AD ŋ
sat	ɛ AD s e AD ɪ̯ AN tʰ i AD
saturday	s æ AD ɾ ɚ BL ɾ i AD
scale	s k e AD ɪ̯ AN ɫ
scallion	s k æ AD l ɪ AD ə AD n
schemes	s k iː AE m z̥
screech	s k ɹ BC iː AE t ʃ
scuttle	s k ʌ AM ɾ ɫ̩
secretary	s ɛ AD k ɹ BC ə AD tʰ ɛ AD ɹ BC i AD
security	s ə AD k j AB ʊ AF ɹ BC ɪ AD ɾ i AD
semanticity	s ɪ AD m æ AD n tʰ ɪ AD s ɪ̈ AD t i AD
senpai	s ɛ AD n p a AD ɪ̯ AN
sentence	s ɛ AD n ʔ n̩ t s
serious	s i AD ə AD ɹ BC i AD ə AD s
servant	s ɚ BL v n̩ ʔ
servo	s ɚ BL v o AF ʊ AF
sevendy	s ɛ AD v n̩ ɾ̃ i AD
shi	ʃ a AD ɪ AD
shitty	ʃ ɪ AD ɾ i AD
shouldn't	ʃ ʊ AF n ʔ
shutter	ʃ ʌ AM ɾ ɚ BL
siberia	s a AD ɪ AD b ɪ AD ɹ BC i AD ə AD
siberian	s a AD ɪ AD b ɪ AD ɹ BC i AD ə AD n
sigmatism	s ɪ AD ɡ m ʌ AM t ɪ AD z m
sitter	s ɪ AD ɾ ɚ BL
sixth	s ɪ AD k s θ
skillful	s k ɪ AD ɫ f ə AD ɫ
skrrt	s k r̩ ʔ
skweee	s k w AC iː AE
slaten	s l e AD ɪ AD t n̩
slight	s l̥ l ɐ AH ɪ AD ʔ̚
smatter	s m æ AD ɾ ɚ BL
snippet	s n ɪ AD p ɪ̈ AD ʔ t̚
snow	s n o AF ʊ̯ BA
soil	s ɔ AF ɪ̯ AN ɫ
solecism	s o AF ʊ AF l ɨ AD s ɪ AD z ə AD m
soluble	s ɔ AF ɫ j AB ʊ AF b ə AD ɫ
some	s ɐ AH m
something	s ʌ̃ː BF
sophisticate	s ə AD f ɪ AD s t ɪ AD k ə AD t
sorta	s ɔ AF ɹ BC ɾ ə AD
spaghetti	s p ə AD ɡ ɛ AD ɾ i AD
spar	s p ɑ AM ˞
splinter	s p l ɪ AD ɾ̃ ɚ BL
spotted	s p ɑ AM ɾ ɪ̈ AD d
squander	s kʷ ɑ AM n d ɚ BL
squee	s k w AC iː AE
standard	s t e AD ə AD n d ɚ BL d
standardise	s t æ AD n d ə AD ɹ BC d a AD ɪ AD z
started	s t ɑ AM ɹ BC ɾ ɪ AD d
starter	s t ɑ AM ɹ BC ɾ ɚ BL
starting	s t ɑ AM ɹ BC ɾ ɪ AD ŋ
startup	s t ɑ AM ɹ BC ɾ ʌ AM p
steel	s t iː AE ɫ
stiletto	s t ə AD l ɛ AD ɾ o AF ʊ AF
stirk	s t ɚ BL k
stope	s t o AF ʊ AF p
strand	s t ɹ BC ɛ AD ə AD n d
strength	s t̠ ɹ̠ ɪ AD ŋ k θ
strident	s t ɹ BC a AD ɪ AD dˀ n t
strong	ʃ t̠ ɹ̠ ɔ AF ŋ
struggle	s t ɹ BC ʌ AM ɡ l̩
subhuman	s ʌ AM b h AA j AB uː AG m ə AD n
substance	s ʌ AM b s t ə AD n t s
substituent	s ʌ AM b s t ɪ AD t ʃ u AF ə AD n t
subtle	s ʌ AM ɾ ɫ̩
subway	s ʌ AM b w AC e AD ɪ̯ AN
sudden	s ʌ AM d n̩
super	s u AF p ɚ BL
support	s ə AD pʰ ɔ AF ɹ BC t
suppose	s ə AD pʰ o AF ʊ AF z
sweaty	s w AC ɛ AD ɾ i AD
sweetheart	s w AC i AD ɾʱ ɑ AM ɹ BC t̠̚
syllable	s ɪ AD l ə AD b ɫ
symbology	s ɪ AD m b ɑ AM l ə AD d ʒ i AD
symphony	s ɪ AD ɱ f ə AD n i AD
syncline	s ɪ AD ŋ k l a AD ɪ AD n
syntagms	s ɪ AD n t æ AD m z
t'	ː
tab	tʰ æ AD b̥
tackle	tʰ æ AD k ɫ̩
taco	tʰ ɑ AM k o AF ʊ AF
take	tʰ e AD ɪ̯ AN k
talib	tʰ æ AD l ɪ AD b
talked	tʰ ɔː AG k t
tallit	tʰ ɑ AM ɫ ɪ AD s
tampon	tʰ æ AD m p ɑ AM n
tap	tʰ æ AD p
tape	tʰ e AD ɪ̯ AN p
tapestry	t æ AD p ə AD s t ʃ ɹ BC i AD
tar	tʰ ɑ AM ɻ
target	tʰ ɑ AM ɹ BC ɡ ɪ AD t̚
taring	t ɛ AD ə AD ɹ BC ɪ AD ŋ
tarn	t ɚ BL n
tarter	t ɑː BD t ə AD ɹ BC
tatsoi	tʰ ɑ AM ʔ t s ɔ AF ɪ AD
tattoo	tʰ æ AD tʰ u̟ː BN
tea	tʰ i AD
teal	t iː AE ɫ
teared	t ɪː AE d
tearing	t ɪ AD ə AD ɹ BC ɪ AD ŋ
tech	tʰ ɛ AD k
teeter	tʰ i AD ɾ ɚ BL
tej	t ɛ AD d ʒ
telangana	t̪ ɛ AD l ə AD ŋ ɡ ɑː BD n ə AD
tellurian	tʰ ə AD l ɚː BK iː AE ɨ̃ AK n
temp	tʰ ɛ AD m p
ten	tʰ ɛ AD n
tenth	tʰ ɛ AD n̪ θ
teotwawki	t i AD ɑ AM t w AC ɑ AM k i AD
tesselate	tʰ ɛ AD s ɫ l e AD ɪ AD tʰ
thagomizer	θ æ AD ɡ ə AD m a AD ɪ AD z ɚ BL
thank	θ æ AD ŋ k
theosophy	θ i AD ɒ AF s ə AD f i AD
theriac	θ ɛ AD ɹ BC i AD ə AD k
thickie	θ ɪ AD k i AD
thirty	θ ɚ BL ɾ i AD
thousand	θ a AD ʊ̯ BA z ɪ̈ AD n d
thread	θ ɾ̪̊ ɛ AD d
three	θ ɾ̪̊ i AD
thrice	θ ɾ̪̊ ɑ AM ɪ AD s
thrill	θ ɾ̪̊ ɪ AD ɫ
throne	θ ɹ BC o AF ʊ AF n
through	θ ɾ̪̊ ʊ AF u AF
throughout	θ ɹ BC uːʷ a AD ʊ AF t
throw	θ ɾ̪̊ o AF ʊ AF
timber	t ɪˑ m b ɚː BK
time	tʰ a AD ɪ AD m
tin	tʰ ɪ AD n
tiptoe	tʰ ɪ AD p tʰ o AF ʊ̯ BA
tire	tʰ a AD ɪ̯ AN ɚ BL
titty	tʰ ɪ AD ɾ i AD
to	tʰ u̟ BG
today	tʰ ʊ AF d e AD ɪ AD
tomato	tʰ ə̥ AD m ɑː BD tʰ ə AD ʊ AF
too	tʰ u̟ BG
toots	tʰ ʊ AF t s
top	tʰ ɑˀ p
toronto	tʰ ə AD ɹ BC ɒ AF ɾ̃ ə AD
tortilla	t ɔ AF ɹ BC tʰ i AD j AB ə AD
total	tʰ ɔ AF ɾ ɫ
towards	tʰ ə̥ AD w AC ɔ AF ɹ̠ d̠ z
town	tʰ a AD ʊ̯ BA n
toyota	t ɔ AF ɪ̯ AN o AF ʊ̯ BA ɾ ə AD
trace	t ʃ ɹ BC e AD ɪ AD s
tracer	t ʃ ɹ BC e AD ɪ AD s ɚ BL
traditionally	t ɹ BC ɪ AD d ɪ AD ʃ n̩ l i AD
train	t̠ ɹ̠̝ʷ e AD ɪ AD n
trainee	t ʃ ɹ BC e AD ɪ AD n i AD
trainees	t ʃ ɹ BC e AD ɪ AD n i AD z
traitor	tʰ ɹ BC e AD ɪ AD ɾ ɚ BL
transcaucasia	t ɹ BC æ AD n s k ɔː AG k e AD ɪ AD ʒ ə AD
translator	tʰ ɹ BC æ AD n z l e AD ɪ AD ɾ ɚ BL
trap	t̠ ɹ̝̊ ä p
tree	t̠ ɹ̠̊ʷ i AD
trick	t̠ʰ ɹ̠̊ ɪ AD k
trig	t̠ʰ ɹ̠̊ ɪ AD ɡ
trill	t̠ʰ ɹ̠̊ ɪ AD l
trim	t̠ʰ ɹ̠̊ ɪ AD m
trip	t̠ʰ ɹ̠̊ ɪ AD p
true	t ʃ ɹ BC ü
trunk	t ʃ ɹ BC ʌ AM ŋ k
trust	t ɹ BC ʌ AM s t
try	t̠ ɹ̠̊ʷ a AD ɪ AD
tsk	ǀ
tucker	tʰ ʌ AM k ɚ BL
turkish	t ɚ BL k ɪ AD ʃ
turmeric	tʰ ɚ BL m ɚ BL ɪ AD k
turning	t ɚ BL n ɪ AD ŋ
turtle	tʰ ɚ BL ɾ ɫ̩
tut	ǀ
twain	tʰ w̥ AC e AD ɪ AD n
twat	tʰ w̥ AC ɑ AM t
twelfth	tʰ w̥ AC ɛ AD l̪ θ
twelve	t w̥ AC ɛ AD ɫ v
twenny	t w AC ʌ AM ɾ̃ i AD
twentieth	t w̥ AC ɛ AD ɾ̃ i AD ə AD θ
twenty	t w̥ AC ɛ AD ɾ̃ i AD
twerk	t w̥ AC ɚ BL k
twice	t w̥ AC a AD ɪ AD s
twig	tʰ w̥ AC ɪ AD ɡ
twin	t w̥ AC ɪ AD n
twink	tʰ w̥ AC ɪ AD ŋ k
twist	t w̥ AC ɪ AD s t
twit	tʰ w̥ AC ɪ AD t
twitch	tʰ w̥ AC ɪ AD t ʃ
twitter	tʰ w AC ɪ AD ɾ ɚ BL
two	tʰ u̟ BG
twos	tʰ u̟ BG z
ugh	ʌ AM
ukraine	j AB u̟ BG k ɹ BC e AD ɪ̯ AN n
unacceptable	ɐ AH n ɪ̞ AD k s ɛ AD p tʰ ə AD b ɫ̩
uncle	ʌ AM ŋ k ɫ̩
under	ʌ AM ɾ̃ ɚ BL
understand	ʌ AM ɾ̃ ɚ BL s t æ AD n d
undivided	ʌ AM ɾ̃ ɪ̈ AD v a AD ɪ̯ AN ɾ ɪ̈ AD d
unfetter	ʌ AM n f ɛ AD ɾ ɚ BL
unilateral	j AB ʉː BH n ɪ AD l æ AD t ʃ ɹ BC ɫ̩
unisex	j AB uː AG n ɪ AD s ɛ AD k s
unite	j AB ʊ AF n a AD ɪ̯ AN ʔ t̚
united	j AB ʊ AF n a AD ɪ̯ AN ɾ ɪ̈ AD d
unnerstand	ɜ AD ɽ̃ ɻ s t æ AD n d̚
untac	j AB u AF ɛ AD n t ɪ AD ɛ AD j AB s iː AE
untaet	j AB u AF ɛ AD n t i AD ɛ AD j AB ɪ AD t iː AE
unutterable	ʌ AM n ʌ AM ɾ ɚ BL ɪ̈ AD b l̩
up	ʌ AM p̚
upmost	ʌ AM ʔ m o AF ʊ AF s t
usher	ʌ AM ʃ ɚ BL
utter	ʌ AM ɾ ɚ BL
vajazzle	v ə AD d ʒ æ AD z l̩
vale	v e AD ɪ AD ɫ
vendetta	v ɛ AD n d ɛ AD ɾ ə AD
veneer	v ɨ AD n i AD ə̆ AI ɹ BC
venus	v i AD n ɪ̈ AD s
verbal	v ɜ AD ˞ b ɫ̩
vermont	v ɚ BL m ɑ̃ BE ʔ
veteran	v ɛ AD ɾ ə AD ɹ BC ə AD n
veto	v iː AE ɾ o AF ʊ AF
vibrator	v a AD ɪ̯ AN b ɹ BC e AD ɪ̯ AN ɾ ɚ BL
vicissitude	v ɨ AD s ɪ AD s ɨ AD t j AB uː AG d
vicissity	v ɪ AD s ɪ AD s ɨ AD t i AD
violin	v a AD ɪ̯ AN ɪ̈ AD l ɪ AD n
virtually	v ɚ BL t ʃ u AF ə AD ɫ i AD
vitamin	v ʌ AM ɪ AD ɾ ə AD m ɪ AD n
vlach	v l ɑː BD k
vocab	v ə AD ʊ AF k æ AD b
volatile	v ɑ AM l ə AD ɾ ɫ̩
waddle	w AC ɑ AM ɾ ɫ̩
wail	w AC e AD ɪ AD ɫ
waistband	w AC e AD ɪ AD s t b æ AD n d
wait	w AC e AD ɪ̯ AN ʔ t
waiting	w AC e AD ɪ̯ AN ɾ ɪ AD ŋ
wale	w AC e AD ɪ AD ɫ
wales	w AC e AD ɪ AD ɫ z
wanted	w AC ɑ AM n tʰ ɪ AD d
wasn't	w AC ʌ AM z n̩ t
water	w AC ɔ AF ɾ ɚ BL
wattle	w AC ɑ AM ɾ l̩
wealth	w AC ɛ AD l̪ θ
wean	w AC eː AE n
wear	w AC ɛ AD ɹ BC
weeaboos	w AC iː AE a AD b yː BH z
weel	w AC iː AE l
welp	w AC ɛ AD l p̚
went	w AC ɛ AD n ʔ t̚
westside	w AC ɛ AD s t s a AD ɪ AD d
wetting	w AC ɛ AD ɾ ɪ AD ŋ
what	w AC ʌˀ
what're	w AC ʌ AM ɾ ɚ BL
whet	ʍ BB ɛ AD ʔ t̚
whetter	ʍ BB ɛ AD ɾ ɚ BL
whew	ʍ BB ĭ̥ ŭ̥
who're	h AA ʊ AF ɚ BL
whole	h AA o AF ʊ AF ɫ
wholemeal	h AA ɔ AF ʊ AF ɫ m i AD ə AD ɫ
wholly	h AA o AF ʊ̯ BA ɫ l i AD
whuddup	w AC ʌ AM ɾ ʌ AM p
width	w AC ɪ AD d̪ θ
wilde	w AC a AD ɪ AD ə̯ AN ɫ d
will	w AC ɪ AD ɫ
window	w AC ɪ AD ɾ̃ o AF ʊ AF
winter	w AC ɪ AD ɾ̃ ɚ BL
winters	w AC ɪ AD ɾ̃ ɚ BL z
wintertide	w AC ɪ AD ɾ̃ ɚ BL t a AD ɪ AD d
wintry	w AC ɪ AD ɾ̃ ə AD ɹ BC i AD
wisconsin	w AC ə AD s kʰ ɑ AM n s n̩
witty	w AC ɪ AD ɾ i AD
wolf	w AC ʊ̠ ɫ f
wool	w AC ʊ̠ ɫ
work	w AC ɚ BL k
wouldn't	w AC ʊ AF ɾ ə AD n t
wrake	ɹ BC e AD ɪ̯ AN kʰ
wristlet	ɹ BC ɪ AD s l ɨ AD ʔ̚
writer	ɹ̠ ă ɪ AD ɾ ɚ BL
written	ɹ BC ɪ AD ʔ ɪ AD n
wuddup	w AC ʌ AM ɾ ʌ AM p
xxx	ʔ ɛ AD k s ʔ ɛ AD k s ʔ ɛ AD k s
y'all's	j AB ɔ AF l z
yatt	j AB æ AD t
yech	j AB ɛ AD χ
yep	j AB ɛ AD p̚
yeppity	j AB ɛ AD p ɨ AD ɾ i AD
yeti	j AB ɛ AD ɾ i AD
yive	j AB ɪ AD v
yolngu	j AB oː AG l ŋ ʊ AF
yum	j AB ʌ AM m
yuppity	j AB ʌ AM p ɨ AD ɾ i AD
zarina	z ʌ AM ɹʲ i AD n ə AD
zemfira	z ɪ AD ɱ f i AD ɹ BC ə AD
ziti	z i AD ɾ i AD
zooplasty	z o AF ʊ AF ə AD p l æ AD s t i AD
zun	z ʌ AM n
übermensch	ʔ yː BH b ɐ AH m ɛ AD n ʃ
