a	a AK
aba	a AK b AH a AK
abade	a AK b AH a AK d AC e AK
abadegai	a AK b AH a AK d AC e AK ɡ AC a AK i AK
abadesa	a AK b AH a AK d AC e AK s̺ AI a AK
abadia	a AK b AH a AK d AC i AK a AK
abadiano	a AK b AH a AK d AC j AB a AK n AG o AL
abagune	a AK b AH a AK ɡ AC u AL n AG e AK
abako	a AK b AH a AK k AC o AL
abantaila	a AK b AH a AK n AG t AC a AK ʎ AE a AK
abendu	a AK b AH e AK n AG d AC u AL
abentura	a AK b AH e AK n AG t AC u AL ɾ BC a AK
abenturazale	a AK b AH e AK n AG t AC u AL ɾ BC a AK s̻ AI a AK l AE e AK
aberastasun	a AK b AH e AK ɾ BC a AK s̺ AI t AC a AK s̺ AI u AL n AG
aberats	a AK b AH e AK ɾ BC a AK t AC s̺ AI
abere	a AK b AH e AK ɾ BC e AK
aberri	a AK b AH e AK r AM i AK
abertzale	a AK b AH e AK r AM t AC s̻ AI a AK l AE e AK
abertzaletasun	a AK b AH e AK r AM t AC s̻ AI a AK l AE e AK t AC a AK s AI u AL n AG
abes	a AK b AH e AK s̺ AI
abesbatza	a AK b AH e AK s̺ AI b AH a AK t AC s̻ AI a AK
abeslari	a AK b AH e AK s AI l AE a AK ɾ BC i AK
abeste	a AK b AH e AK s̺ AI t AC e AK
abesten	a AK b AH e AK s̺ AI t AC e AK n AG
abesti	a AK b AH e AK s̺ AI t AC i AK
abestu	a AK b AH e AK s̺ AI t AC u AL
abestuko	a AK b AH e AK s̺ AI t AC u AL k AC o AL
abizen	a AK b AH i AK s̻ AI e AK n AG
abkhazera	a AK b AH x AI a AK s̻ AI e AK ɾ BC a AK
abkhazia	a AK b AH x AI a AK s̻ AI j AB a AK
abkhaziar	a AK b AH x AI a AK s̻ AI j AB a AK r AM
aboitiz	a AK b AH o AL i AK t AC i AK s̻ AI
abstraktu	a AK b AH s̺ AI t AC r AM a AK k AC t AC u AL
abundi	a AK b AH u AL n AG d AC i AK
abundio	a AK b AH u AL n AG d AC j AB o AL
aburu	a AK b AH u AL ɾ BC u AL
abuztu	a AK b AH u AL s̻ AI t AC u AL
adar	a AK d AC a AK r AM
adibide	a AK d AC i AK b AH i AK d AC e AK
adibidez	a AK d AC i AK b AH i AK d AC e AK s̻ AI
adimen	a AK d AC i AK m AF e AK n AG
adiskidetasun	a AK d AC i AK s̺ AI k AC i AK d AC e AK t AC a AK s̺ AI u AL n AG
aditu	a AK d AC i AK t AC u AL
aditz	a AK d AC i AK t AC s̻ AI
adolba	a AK d AC o AL l AE b AH a AK
adore	a AK d AC o AL ɾ BC e AK
ados	a AK d AC o AL s̺ AI
adoste	a AK d AC o AL s̺ AI t AC e AK
adosten	a AK d AC o AL s̺ AI t AC e AK n AG
adostu	a AK d AC o AL s̺ AI t AC u AL
adostuko	a AK d AC o AL s̺ AI t AC u AL k AC o AL
afari	a AK f AN a AK ɾ BC i AK
afganistan	a AK f AN ɡ AC a AK n AG i AK s̺ AI t AC a AK n AG
afganistandar	a AK f AN ɡ AC a AK n AG i AK s̺ AI t AC a AK n AG d AC a AK r AM
agate	a AK ɡ AC a AK t AC e AK
agirre	a AK ɡ AC i AK r AM e AK
agor	a AK ɡ AC o AL r AM
agorril	a AK ɡ AC o AL r AM i AK ʎ AE
agur	a AK ɡ AC u AL r AM
ahabe	ã h AA ã b AH e AK
ahabia	a AK ɦ AA a AK b AH j AB a AK
ahai	a AK h̃ BD a AK i AK
ahal	a AK ɦ AA a AK l AE
ahate	a AK ɦ AA a AK t AC e AK
ahatz	a AK h AA a AK t AC s̻ AI
ahazte	a AK h AA a AK s̻ AI t AC e AK
ahazten	a AK h AA a AK s̻ AI t AC e AK n AG
ahaztu	a AK s̻ AI t AC u AL
ahaztuko	a AK s̻ AI t AC u AL k AC o AL
ahuntz	a AK ɦ AA u AL n AG t AC s̻ AI
ainara	a AK i AK n AG a AK ɾ BC a AK
ainarba	a AK ɲ AG a AK r AM b AH a AK
ainhoa	a AK i AK n AG o AL a AK
aintzane	a AK i AK n AG t AC s̻ AI a AK n AG e AK
aise	a AK i AK s̺ AI e AK
aita	a AK i AK t AC a AK
aitatxi	a AK i AK t AC a AK t AC ʃ AI i AK
aitona	a AK i AK t AC o AL n AG a AK
aitor	a AK i AK t AC o AL r AM
aitzur	a AK i AK t AC s̻ AI u AL r AM
aizkolari	a AK i AK s̻ AI k AC o AL l AE a AK ɾ BC i AK
aizkora	a AK i AK s̻ AI k AC o AL ɾ BC a AK
aizto	a AK i AK s̻ AI t AC o AL
akelarre	a AK k AC e AK l AE a AK r AM e AK
aker	a AK k AC e AK r AM
akordeoi	a AK k AC o AL r AM d AC e AK o AL i AK
akrobata	a AK k AC r AM o AL b AH a AK t AC a AK
aktiba	a AK k AC t AC i AK b AH a AK
aktibatu	a AK k AC t AC i AK b AH a AK t AC u AL
aktibatuko	a AK k AC t AC i AK b AH a AK t AC u AL k AC o AL
aktibatze	a AK k AC t AC i AK b AH a AK t AC s̻ AI e AK
aktibatzen	a AK k AC t AC i AK b AH a AK t AC s̻ AI e AK n AG
aktore	a AK k AC t AC o AL ɾ BC e AK
alaba	a AK l AE a AK b AH a AK
alai	a AK l AE a AK i AK
albaitari	a AK l AE b AH a AK i AK t AC a AK ɾ BC i AK
albania	a AK l AE b AH a AK n AG j AB a AK
albaniar	a AK l AE b AH a AK n AG j AB a AK r AM
albaniera	a AK l AE b AH a AK n AG j AB e AK ɾ BC a AK
alda	a AK l AE d AC a AK
aldatu	a AK l AE d AC a AK t AC u AL
aldatuko	a AK l AE d AC a AK t AC u AL k AC o AL
aldatze	a AK l AE d AC a AK t AC s̻ AI e AK
aldatzen	a AK l AE d AC a AK t AC s̻ AI e AK n AG
alde	a AK l AE d AC e AK
aldizkari	a AK l AE d AC i AK s̻ AI k AC a AK ɾ BC i AK
aleman	a AK l AE e AK m AF a AK n AG
alemanera	a AK l AE e AK m AF a AK n AG e AK ɾ BC a AK
alemania	a AK l AE e AK m AF a AK n AG j AB a AK
alemaniar	a AK l AE e AK m AF a AK n AG j AB a AK r AM
alkandora	a AK l AE k AC a AK n AG d AC o AL ɾ BC a AK
alkandorak	a AK l AE k AC a AK n AG d AC o AL ɾ BC a AK k AC
alkandorek	a AK l AE k AC a AK n AG d AC o AL ɾ BC e AK k AC
alkate	a AK l AE k AC a AK t AC e AK
alkohol	a AK l AE k AC o AL ɦ AA o AL l AE
alkohola	a AK l AE k AC o AL ɦ AA o AL l AE a AK
alkoholan	a AK l AE k AC o AL ɦ AA o AL l AE a AK n AG
alkoholen	a AK l AE k AC o AL ɦ AA o AL l AE e AK n AG
alkoholi	a AK l AE k AC o AL ɦ AA o AL l AE i AK
alkoholik	a AK l AE k AC o AL ɦ AA o AL l AE i AK k AC
altxoin	a AK l AE t AC ʃ AI o AL i AK ɲ AG
altxor	a AK l AE t AC ʃ AI o AL r AM
aluminio	a AK l AE u AL m AF i AK n AG j AB o AL
ama	a AK m AF a AK
amaraun	a AK m AF a AK ɾ BC a AK u AL n AG
amatasun	a AK m AF a AK t AC a AK s̺ AI u AL n AG
amesgaizto	a AK m AF e AK s̺ AI ɡ AC a AK i AK s̻ AI t AC o AL
amets	a AK m AF e AK t AC s̺ AI
ametz	a AK m AF e AK t AC s̻ AI
anana	a AK n AG a AK n AG a AK
andaia	a AK n AG d AC a AK j AB a AK
ander	a AK n AG d AC e AK r AM
andereño	a AK n AG d AC e AK ɾ BC e AK ɲ AG o AL
andorra	a AK n AG d AC o AL r AM a AK
andorratar	a AK n AG d AC o AL r AM a AK t AC a AK r AM
andorratarra	a AK n AG d AC o AL r AM a AK t AC a AK r AM a AK
andorratarrak	a AK n AG d AC o AL r AM a AK t AC a AK r AM a AK k AC
andorratarraren	a AK n AG d AC o AL r AM a AK t AC a AK r AM a AK ɾ BC e AK n AG
andorratarrari	a AK n AG d AC o AL r AM a AK t AC a AK r AM a AK ɾ BC i AK
andorratarrei	a AK n AG d AC o AL r AM a AK t AC a AK r AM e AK i AK
andorratarrek	a AK n AG d AC o AL r AM a AK t AC a AK r AM e AK k AC
andorratarren	a AK n AG d AC o AL r AM a AK t AC a AK r AM e AK n AG
andorratarri	a AK n AG d AC o AL r AM a AK t AC a AK r AM i AK
angola	a AK n AG ɡ AC o AL l AE a AK
animalia	a AK n AG i AK m AF a AK l AE i AK a AK
anime	a AK n AG i AK m AF e AK
anker	a AK n AG k AC e AK r AM
antartika	a AK n AG t AC a AK r AM t AC i AK k AC a AK
antigua	a AK n AG t AC i AK ɡ AC w AJ a AK
antton	a AK n AG t AC ʃ AI o AL n AG
antxeta	a AK n AG t AC ʃ AI e AK t AC a AK
antxieta	a AK n AG t AC ʃ AI j AB e AK t AC a AK
antzara	a AK n AG t AC s̻ AI a AK ɾ BC a AK
apaiz	a AK p AH a AK i AK s̻ AI
apaizgai	a AK p AH a AK i AK s̻ AI ɡ AC a AK i AK
apar	a AK p AH a AK r AM
apez	a AK p AH e AK s̻ AI
apiril	a AK p AH i AK ɾ BC i AK ʎ AE
apo	a AK p AH o AL
aprobetxategi	a AK p AH r AM o AL b AH e AK t AC ʃ AI a AK t AC e AK ɡ AC i AK
araba	a AK ɾ BC a AK b AH a AK
arabiera	a AK ɾ BC a AK b AH j AB e AK ɾ BC a AK
arabisagar	a AK ɾ BC a AK b AH i AK s̺ AI a AK ɡ AC a AK r AM
aramu	a AK ɾ BC a AK m AF u AL
aran	a AK ɾ BC a AK n AG
aranondo	a AK ɾ BC a AK n AG o AL n AG d AC o AL
arbola	a AK r AM b AH o AL l AE a AK
ardi	a AK r AM d AC i AK
ardo	a AK r AM d AC o AL
arellano	a AK ɾ BC e AK ʎ AE a AK n AG o AL
argi	a AK r AM ɡ AC i AK
argitsu	a AK r AM ɡ AC i AK t AC s̺ AI u AL
aristotele	a AK ɾ BC i AK s̺ AI t AC o AL t AC e AK l AE e AK
aritz	a AK ɾ BC i AK t AC s̻ AI
armenia	a AK r AM m AF e AK n AG j AB a AK
armeniar	a AK r AM m AF e AK n AG j AB a AK r AM
armeniera	a AK r AM m AF e AK n AG j AB e AK ɾ BC a AK
armiarma	a AK r AM m AF i AK a AK r AM m AF a AK
arotz	a AK ɾ BC o AL t AC s̻ AI
aroztegi	a AK ɾ BC o AL s̻ AI t AC e AK ɡ AC i AK
arrain	a AK r AM a AK i AK ɲ AG
arrano	a AK r AM a AK n AG o AL
arrantzale	a AK r AM a AK n AG t AC s̻ AI a AK l AE e AK
arratoi	a AK r AM a AK t AC o AL i AK
arraun	a AK r AM a AK u AL n AG
arrigorriaga	a AK r AM i AK ɡ AC o AL r AM j AB a AK ɡ AC a AK
arroda	a AK r AM o AL d AC a AK
arrosa	a AK r AM o AL s̺ AI a AK
arrunt	a AK r AM u AL n AG t AC
artaburu	a AK r AM t AC a AK b AH u AL ɾ BC u AL
arte	a AK r AM t AC e AK
arto	a AK r AM t AC o AL
artseniko	a AK r AM t AC s̺ AI e AK n AG i AK k AC o AL
artxipelago	a AK r AM t AC ʃ AI i AK p AH e AK l AE a AK ɡ AC o AL
artzain	a AK r AM t AC s̻ AI a AK i AK ɲ AG
askatasun	a AK s̺ AI k AC a AK t AC a AK s̺ AI u AL n AG
aske	a AK s̺ AI k AC e AK
asko	a AK s̺ AI k AC o AL
aste	a AK s̺ AI t AC e AK
astearte	a AK s̺ AI t AC e AK a AK r AM t AC e AK
asteazken	a AK s̺ AI t AC e AK a AK s̻ AI k AC e AK n AG
asteburu	a AK s̺ AI t AC e AK b AH u AL ɾ BC u AL
astelehen	a AK s̺ AI t AC e AK l AE e AK n AG
asto	a AK s̺ AI t AC o AL
asturiera	a AK s̺ AI t AC u AL ɾ BC j AB e AK ɾ BC a AK
asun	a AK s̺ AI u AL n AG
atena	a AK t AC e AK n AG a AK
atxeki	a AK t AC ʃ AI e AK k AC i AK
atxekiko	a AK t AC ʃ AI e AK k AC i AK k AC o AL
atxekitzen	a AK t AC ʃ AI e AK k AC i AK t AC s̻ AI e AK n AG
atzelari	a AK t AC s̻ AI e AK l AE a AK ɾ BC i AK
atzo	a AK t AC s̻ AI o AL
aukera	a AK u AL k AC e AK ɾ BC a AK
aukeratu	a AK u AL k AC e AK ɾ BC a AK t AC u AL
aukeratuko	a AK u AL k AC e AK ɾ BC a AK t AC u AL k AC o AL
aukeratze	a AK u AL k AC e AK ɾ BC a AK t AC s̻ AI e AK
aukeratzen	a AK u AL k AC e AK ɾ BC a AK t AC s̻ AI e AK n AG
aurki	a AK u AL r AM k AC i AK
aurkitu	a AK u AL r AM k AC i AK t AC u AL
aurkituko	a AK u AL r AM k AC i AK t AC u AL k AC o AL
aurkitze	a AK u AL r AM k AC i AK t AC s̻ AI e AK
aurkitzen	a AK u AL r AM k AC i AK t AC s̻ AI e AK n AG
aurpegi	a AK u AL r AM p AH e AK ɡ AC i AK
aurre	a AK u AL r AM e AK
australia	a AK u AL s̺ AI t AC r AM a AK l AE j AB a AK
austria	a AK u AL s̺ AI t AC r AM j AB a AK
austriar	a AK u AL s̺ AI t AC r AM j AB a AK r AM
azaro	a AK s̻ AI a AK ɾ BC o AL
azerbaijan	a AK s̻ AI e AK r AM b AH a AK i AK j AB a AK n AG
azerbaijandar	a AK s̻ AI e AK r AM b AH a AK i AK j AB a AK n AG d AC a AK r AM
azerbaijanera	a AK s̻ AI e AK r AM b AH a AK i AK j AB a AK n AG e AK ɾ BC a AK
azeri	a AK s̻ AI e AK ɾ BC i AK
azkar	a AK s̻ AI k AC a AK r AM
azkonar	a AK s̻ AI k AC o AL n AG a AK r AM
azoka	a AK s̻ AI o AL k AC a AK
azukre	a AK s̻ AI u AL k AC r AM e AK
b	b AH e AK
badia	b AH a AK d AC i AK a AK
bagenbiltza	b AH a AK ɡ AC e AK n AG b AH i AK l AE t AC s̻ AI a AK
bagentoz	b AH a AK ɡ AC e AK n AG t AC o AL s̻ AI
bageunde	b AH a AK ɡ AC e AK u AL n AG d AC e AK
bagil	b AH a AK ɡ AC i AK ʎ AE
bagina	b AH a AK ɡ AC i AK ɲ AG a AK
bagintez	b AH a AK ɡ AC i AK n AG t AC e AK s̻ AI
bahenbil	b AH a AK h AA e AK n AG b AH i AK l AE
bahendi	b AH a AK h AA e AK n AG d AC i AK
bahengo	b AH a AK h AA e AK n AG ɡ AC o AL
bahentor	b AH a AK h AA e AK n AG t AC o AL r AM
bai	b AH a AK i AK
baita	b AH a AK i AK t AC a AK
bakarrik	b AH a AK k AC a AK r AM i AK k AC
bake	b AH a AK k AC e AK
baketu	b AH a AK k AC e AK t AC u AL
baketuko	b AH a AK k AC e AK t AC u AL k AC o AL
baketze	b AH a AK k AC e AK t AC s̪ AI e AK
baketzen	b AH a AK k AC e AK t AC s̻ AI e AK n AG
bakteriofago	b AH a AK k AC t AC e AK ɾ BC j AB o AL f AN a AK ɡ AC o AL
balebil	b AH a AK l AE e AK b AH i AK l AE
balebiltza	b AH a AK l AE e AK b AH i AK l AE t AC s̪ AI a AK
baledi	b AH a AK l AE e AK d AC i AK
balego	b AH a AK l AE e AK ɡ AC o AL
baletor	b AH a AK l AE e AK t AC o AL r AM
baletoz	b AH a AK l AE e AK t AC o AL s̻ AI
baleude	b AH a AK l AE e AK u AL d AC e AK
balitez	b AH a AK l AE i AK t AC e AK s̻ AI
bana	b AH a AK n AG a AK
banatu	b AH a AK n AG a AK t AC u AL
banatuko	b AH a AK n AG a AK t AC u AL k AC o AL
banatze	b AH a AK n AG a AK t AC s̪ AI e AK
banatzen	b AH a AK n AG a AK t AC s̻ AI e AK n AG
banenbil	b AH a AK n AG e AK n AG b AH i AK l AE
banendi	b AH a AK n AG e AK n AG d AC i AK
banengo	b AH a AK n AG e AK n AG ɡ AC o AL
banentor	b AH a AK n AG e AK n AG t AC o AL r AM
banentorkio	b AH a AK n AG e AK n AG t AC o AL r AM k AC i AK o AL
banintz	b AH a AK n AG i AK n AG t AC s̻ AI
banpiro	b AH a AK m AF p AH i AK ɾ BC o AL
barantaila	b AH a AK ɾ BC a AK n AG t AC a AK ʎ AE a AK
barazkari	b AH a AK ɾ BC a AK s̻ AI k AC a AK ɾ BC i AK
barbuda	b AH a AK r AM b AH u AL d AC a AK
bare	b AH a AK ɾ BC e AK
bariku	b AH a AK ɾ BC i AK k AC u AL
barna	b AH a AK r AM n AG a AK
barrabil	b AH a AK r AM a AK b AH i AK ʎ AE
barre	b AH a AK r AM e AK
barren	b AH a AK r AM e AK n AG
barrena	b AH a AK r AM e AK n AG a AK
bart	b AH a AK r AM t AC
basajaun	b AH a AK s̺ AI a AK x AI a AK u AL n AG
baserri	b AH a AK s̺ AI e AK r AM i AK
baserritar	b AH a AK s̺ AI e AK r AM i AK t AC a AK r AM
baserritartu	b AH a AK s̺ AI e AK r AM i AK t AC a AK r AM t AC u AL
baserritartuko	b AH a AK s̺ AI e AK r AM i AK t AC a AK r AM t AC u AL k AC o AL
baserritartze	b AH a AK s̺ AI e AK r AM i AK t AC a AK r AM t AC s̪ AI e AK
baserritartzen	b AH a AK s̺ AI e AK r AM i AK t AC a AK r AM t AC s̻ AI e AK n AG
baso	b AH a AK s̺ AI o AL
basurde	b AH a AK s̺ AI u AL r AM d AC e AK
bat	b AH a AK t AC
bata	b AH a AK t AC a AK
batak	b AH a AK t AC a AK k AC
batean	b AH a AK t AC e AK a AK n AG
batek	b AH a AK t AC e AK k AC
baten	b AH a AK t AC e AK n AG
batera	b AH a AK t AC e AK ɾ BC a AK
batez	b AH a AK t AC e AK s̪ AI
bati	b AH a AK t AC i AK
batzuetan	b AH a AK t AC s̻ AI u AL e AK t AC a AK n AG
bazenbiltza	b AH a AK s̻ AI e AK n AG b AH i AK l AE t AC s̻ AI a AK
bazenbiltzate	b AH a AK s̻ AI e AK n AG b AH i AK l AE t AC s̻ AI a AK t AC e AK
bazentoz	b AH a AK s̻ AI e AK n AG t AC o AL s̻ AI
bazentozte	b AH a AK s̻ AI e AK n AG t AC o AL s̻ AI t AC e AK
bazeunde	b AH a AK s̻ AI e AK u AL n AG d AC e AK
bazeundete	b AH a AK s̻ AI e AK u AL n AG d AC e AK t AC e AK
bazintez	b AH a AK s̻ AI i AK n AG t AC e AK s̻ AI
bazintezte	b AH a AK s̻ AI i AK n AG t AC e AK s̻ AI t AC e AK
be	b AH e AK
bebil	b AH e AK b AH i AK l AE
bebiltza	b AH e AK b AH i AK l AE t AC s̻ AI a AK
bederatzi	b AH e AK d AC e AK ɾ BC a AK t AC s̻ AI i AK
bedi	b AH e AK d AC i AK
begi	b AH e AK ɡ AC i AK
begira	b AH e AK ɡ AC i AK ɾ BC a AK
begiratu	b AH e AK ɡ AC i AK ɾ BC a AK t AC u AL
begiratuko	b AH e AK ɡ AC i AK ɾ BC a AK t AC u AL k AC o AL
begiratze	b AH e AK ɡ AC i AK ɾ BC a AK t AC s̪ AI e AK
begiratzen	b AH e AK ɡ AC i AK ɾ BC a AK t AC s̻ AI e AK n AG
bego	b AH e AK ɡ AC o AL
behar	b AH e AK ɦ AA a AK r AM
behartsu	b AH e AK ɦ AA a AK r AM t AC s̺ AI u AL
behi	b AH e AK ɦ AA i AK
beki	b AH e AK k AC i AK
bekie	b AH e AK k AC i AK e AK
bele	b AH e AK l AE e AK
belgika	b AH e AK l AE ɡ AC i AK k AC a AK
belgikar	b AH e AK l AE ɡ AC i AK k AC a AK r AM
beltx	b AH e AK l AE t AC ʃ AI
beltz	b AH e AK l AE t AC s̻ AI
belz	b AH e AK l AE s̻ AI
berde	b AH e AK r AM d AC e AK
berilio	b AH e AK ɾ BC i AK l AE j AB o AL
bero	b AH e AK ɾ BC o AL
berpiztu	b AH e AK r AM p AH i AK s̻ AI t AC u AL
berri	b AH e AK r AM i AK
berriro	b AH e AK r AM i AK ɾ BC o AL
besape	b AH e AK s̺ AI a AK p AH e AK
beso	b AH e AK s̺ AI o AL
beti	b AH e AK t AC i AK
betor	b AH e AK t AC o AL r AM
betoz	b AH e AK t AC o AL s̻ AI
beude	b AH e AK u AL d AC e AK
bi	b AH i AK
bide	b AH i AK d AC e AK
bidegorri	b AH i AK d AC e AK ɡ AC o AL r AM i AK
bielorrusia	b AH j AB e AK l AE o AL r AM u AL s̺ AI j AB a AK
bielorrusiera	b AH j AB e AK l AE o AL r AM u AL s̺ AI j AB e AK ɾ BC a AK
bigarren	b AH i AK ɡ AC a AK r AM e AK n AG
bihar	b AH i AK h AA a AK r AM
bihotz	b AH i AK ɦ AA o AL t AC s̻ AI
bikoitz	b AH i AK k AC o AL i AK t AC s̻ AI
bikote	b AH i AK k AC o AL t AC e AK
bilatu	b AH i AK ʎ AE a AK t AC u AL
bilbo	b AH i AK l AE b AH o AL
bildil	b AH i AK l AE d AC i AK ʎ AE
bira	b AH i AK ɾ BC a AK
birika	b AH i AK ɾ BC i AK k AC a AK
bitez	b AH i AK t AC e AK s̻ AI
bizar	b AH i AK s AI a AK r AM
boro	b AH o AL ɾ BC o AL
bosgarren	b AH o AL s̺ AI ɡ AC a AK r AM e AK n AG
boskoitz	b AH o AL s̺ AI k AC o AL i AK t AC s̻ AI
bosniera	b AH o AL s̺ AI n AG j AB e AK ɾ BC a AK
bost	b AH o AL s̺ AI t AC
bosten	b AH o AL s̺ AI t AC e AK n AG
bozkatu	b AH o AL s̻ AI k AC a AK t AC u AL
bretoiera	b AH r AM e AK t AC o AL i AK e AK ɾ BC a AK
bulgaria	b AH u AL l AE ɡ AC a AK ɾ BC j AB a AK
bulgarian	b AH u AL l AE ɡ AC a AK ɾ BC j AB a AK n AG
bulgariera	b AH u AL l AE ɡ AC a AK ɾ BC j AB e AK ɾ BC a AK
burdina	b AH u AL r AM d AC i AK ɲ AG a AK
burdinbide	b AH u AL r AM d AC i AK m AF b AH i AK d AC e AK
burdingintza	b AH u AL r AM d AC i AK n AG ɡ AC i AK n AG t AC s̻ AI a AK
buru	b AH u AL ɾ BC u AL
buruil	b AH u AL ɾ BC u AL ʎ AE
burukomin	b AH u AL ɾ BC u AL k AC o AL m AF i AK ɲ AG
burumuin	b AH u AL ɾ BC u AL m AF u AL ɲ AG
büü	b AH y AL y AL
c	s̻ AI e AK
d	d AC e AK
da	d AC a AK
dabil	d AC a AK b AH i AK l AE
dabilela	d AC a AK b AH i AK ʎ AE e AK l AE a AK
dabilke	d AC a AK b AH i AK l AE k AC e AK
dabiltza	d AC a AK b AH i AK l AE t AC s̻ AI a AK
dabiltzala	d AC a AK b AH i AK l AE t AC s̻ AI a AK l AE a AK
dabilzke	d AC a AK b AH i AK l AE s̻ AI k AC e AK
dadila	d AC a AK d AC i AK ʎ AE a AK
dadin	d AC a AK d AC i AK ɲ AG
dagi	d AC a AK ɡ AC i AK
dagit	d AC a AK ɡ AC i AK t AC
dago	d AC a AK ɡ AC o AL
dagoela	d AC a AK ɡ AC o AL e AK l AE a AK
dagoke	d AC a AK ɡ AC o AL k AC e AK
dagonil	d AC a AK ɡ AC o AL n AG i AK ʎ AE
daiteke	d AC a AK i AK t AC e AK k AC e AK
daitez	d AC a AK i AK t AC e AK s̻ AI
daitezela	d AC a AK i AK t AC e AK s̻ AI e AK l AE a AK
daitezke	d AC a AK i AK t AC e AK s̻ AI k AC e AK
daki	d AC a AK k AC i AK
dakik	d AC a AK k AC i AK k AC
dakin	d AC a AK k AC i AK n AG
dakit	d AC a AK k AC i AK t AC
daniera	d AC a AK n AG j AB e AK ɾ BC a AK
danimarka	d AC a AK n AG i AK m AF a AK r AM k AC a AK
darama	d AC a AK ɾ BC a AK m AF a AK
darik	d AC a AK ɾ BC i AK k AC
darin	d AC a AK ɾ BC i AK n AG
dator	d AC a AK t AC o AL r AM
datorke	d AC a AK t AC o AL r AM k AC e AK
datorrela	d AC a AK t AC o AL r AM e AK l AE a AK
datoz	d AC a AK t AC o AL s̻ AI
datozela	d AC a AK t AC o AL s̻ AI e AK l AE a AK
datozke	d AC a AK t AC o AL s̻ AI k AC e AK
datxekie	d AC a AK t AC ʃ AI e AK k AC i AK e AK
datxekigu	d AC a AK t AC ʃ AI e AK k AC i AK ɡ AC u AL
datxekik	d AC a AK t AC ʃ AI e AK k AC i AK k AC
datxekin	d AC a AK t AC ʃ AI e AK k AC i AK n AG
datxekio	d AC a AK t AC ʃ AI e AK k AC i AK o AL
datxekit	d AC a AK t AC ʃ AI e AK k AC i AK t AC
datxekizu	d AC a AK t AC ʃ AI e AK k AC i AK s̻ AI u AL
datxekizue	d AC a AK t AC ʃ AI e AK k AC i AK s̻ AI u AL e AK
datxezkie	d AC a AK t AC ʃ AI e AK s̻ AI k AC i AK e AK
datxezkigu	d AC a AK t AC ʃ AI e AK s̻ AI k AC i AK ɡ AC u AL
datxezkik	d AC a AK t AC ʃ AI e AK s̻ AI k AC i AK k AC
datxezkin	d AC a AK t AC ʃ AI e AK s̻ AI k AC i AK n AG
datxezkio	d AC a AK t AC ʃ AI e AK s̻ AI k AC i AK o AL
datxezkit	d AC a AK t AC ʃ AI e AK s̻ AI k AC i AK t AC
datxezkizu	d AC a AK t AC ʃ AI e AK k AC i AK s̻ AI u AL
datxezkizue	d AC a AK t AC ʃ AI e AK s̻ AI k AC i AK s̻ AI u AL e AK
datza	d AC a AK t AC s̻ AI a AK
daude	d AC a AK u AL d AC e AK
daudeke	d AC a AK u AL d AC e AK k AC e AK
daudela	d AC a AK u AL d AC e AK l AE a AK
dautza	d AC a AK u AL t AC s̻ AI a AK
de	d AC e AK
deabru	d AC e AK a AK b AH r AM u AL
dei	d AC e AK i AK
deia	d AC e AK i AK a AK
deien	d AC e AK i AK e AK n AG
deira	d AC e AK i AK ɾ BC a AK
deiri	d AC e AK i AK ɾ BC i AK
deitara	d AC e AK i AK t AC a AK ɾ BC a AK
deitura	d AC e AK i AK t AC u AL ɾ BC a AK
deiz	d AC e AK i AK s̻ AI
dira	d AC i AK ɾ BC a AK
doa	d AC o AL a AK
domeka	d AC o AL m AF e AK k AC a AK
donostia	d AC o AL n AG o AL s̺ AI t AC j AB a AK
dortoka	d AC o AL r AM t AC o AL k AC a AK
dromedario	d AC r AM o AL m AF e AK d AC a AK ɾ BC j AB o AL
e	e AK
ebiakoitz	e AK b AH i AK a AK k AC o AL i AK t AC s̻ AI
edan	e AK d AC a AK n AG
edari	e AK d AC a AK ɾ BC i AK
eder	e AK d AC e AK r AM
edin	e AK d AC i AK n AG
eduki	e AK d AC u AL k AC i AK
edukiko	e AK d AC u AL k AC i AK k AC o AL
edukitze	e AK d AC u AL k AC i AK t AC s̪ AI e AK
edukitzen	e AK d AC u AL k AC i AK t AC s̻ AI e AK n AG
edun	e AK d AC u AL n AG
efe	e AK f AN e AK
egin	e AK ɡ AC i AK ɲ AG
egingo	e AK ɡ AC i AK n AG ɡ AC o AL
egitasmo	e AK ɡ AC i AK t AC a AK s̺ AI m AF o AL
egite	e AK ɡ AC i AK t AC e AK
egiten	e AK ɡ AC i AK t AC e AK n AG
egon	e AK ɡ AC o AL n AG
egongo	e AK ɡ AC o AL n AG ɡ AC o AL
egote	e AK ɡ AC o AL t AC e AK
egoten	e AK ɡ AC o AL t AC e AK n AG
eguazten	e AK ɡ AC u AL a AK s̻ AI t AC e AK n AG
egubakoitz	e AK ɡ AC u AL b AH a AK k AC o AL i AK t AC s̻ AI
eguen	e AK ɡ AC u AL e AK n AG
egun	e AK ɡ AC u AL n AG
egur	e AK ɡ AC u AL r AM
eguzkitsu	e AK ɡ AC u AL s̻ AI k AC i AK t AC s̺ AI u AL
ehe	e AK h̃ BD e AK
ehiza	e AK ɦ AA i AK s̻ AI a AK
ekain	e AK k AC a AK i AK ɲ AG
ekaiztsu	e AK k AC a AK i AK s̻ AI t AC s̺ AI u AL
ekark	e AK k AC a AK r AM k AC
ekarna	e AK k AC a AK r AM n AG a AK
ekarri	e AK k AC a AK r AM i AK
ekialde	e AK k AC i AK a AK l AE d AC e AK
ele	e AK l AE e AK
elefante	e AK l AE e AK f AN a AK n AG t AC e AK
eliza	e AK l AE i AK s̻ AI a AK
elkar	e AK l AE k AC a AK r AM
elkarlan	e AK l AE k AC a AK ɾ BC l AE a AK n AG
elkarrekin	e AK l AE k AC a AK r AM e AK k AC i AK ɲ AG
eltxo	e AK l AE t AC ʃ AI o AL
emagaldu	e AK m AF a AK ɡ AC a AK l AE d AC u AL
eman	e AK m AF a AK n AG
eme	e AK m AF e AK
enara	e AK n AG a AK ɾ BC a AK
ene	e AK n AG e AK
enegan	e AK n AG e AK ɡ AC a AK n AG
enigmatiko	e AK n AG i AK ɡ AC m AF a AK t AC i AK k AC o AL
entzun	e AK n AG t AC s̻ AI u AL n AG
epail	e AK p AH a AK ʎ AE
eper	e AK p AH e AK r AM
erabili	e AK ɾ BC a AK b AH i AK ʎ AE i AK
erakutsi	e AK ɾ BC a AK k AC u AL t AC s̺ AI i AK
eraman	e AK ɾ BC a AK m AF a AK n AG
erbi	e AK r AM b AH i AK
erdara	e AK r AM d AC a AK ɾ BC a AK
erdi	e AK r AM d AC i AK
ereiaro	e AK ɾ BC e AK i AK a AK ɾ BC o AL
erion	e AK ɾ BC j AB o AL n AG
erlategi	e AK r AM l AE a AK t AC e AK ɡ AC i AK
erlauntza	e AK r AM l AE a AK u AL n AG t AC s̻ AI a AK
ermita	e AK r AM m AF i AK t AC a AK
erne	e AK r AM n AG e AK
eroan	e AK ɾ BC o AL a AK n AG
eroango	e AK ɾ BC o AL a AK n AG ɡ AC o AL
eroate	e AK ɾ BC o AL a AK t AC e AK
eroaten	e AK ɾ BC o AL a AK t AC e AK n AG
erori	e AK ɾ BC o AL ɾ BC i AK
eros	e AK ɾ BC o AL s̺ AI
erosi	e AK ɾ BC o AL s̺ AI i AK
erosiek	e AK ɾ BC o AL s̺ AI i AK e AK k AC
erosien	e AK ɾ BC o AL s̺ AI i AK e AK n AG
erosiok	e AK ɾ BC o AL s̺ AI i AK o AL k AC
erosion	e AK ɾ BC o AL s̺ AI i AK o AL n AG
erostak	e AK ɾ BC o AL s̺ AI t AC a AK k AC
erostan	e AK ɾ BC o AL s̺ AI t AC a AK n AG
erran	e AK r AM a AK n AG
errauts	e AK r AM a AK u AL t AC s̺ AI
erraz	e AK r AM a AK s̻ AI
erre	e AK r AM e AK
erreferentzia	e AK r AM e AK f AN e AK ɾ BC e AK n AG t AC s̻ AI j AB a AK
erregina	e AK r AM e AK ɡ AC i AK ɲ AG a AK
errepide	e AK r AM e AK p AH i AK d AC e AK
errez	e AK r AM e AK s̻ AI
errota	e AK r AM o AL t AC a AK
erru	e AK r AM u AL
errumania	e AK r AM u AL m AF a AK n AG i AK a AK
errumaniar	e AK r AM u AL m AF a AK n AG j AB a AK r AM
errumaniera	e AK r AM u AL m AF a AK n AG j AB e AK ɾ BC a AK
errusia	e AK r AM u AL s̺ AI j AB a AK
errusiar	e AK r AM u AL s̺ AI j AB a AK r AM
errusiera	e AK r AM u AL s̺ AI j AB e AK ɾ BC a AK
esan	e AK s̺ AI a AK n AG
ese	e AK s̺ AI e AK
esker	e AK s̺ AI k AC e AK r AM
eskozia	e AK s̺ AI k AC o AL s̻ AI j AB a AK
eskribitu	e AK s̺ AI k AC r AM i AK b AH i AK t AC u AL
esku	e AK s̺ AI k AC u AL
eskubila	e AK s̺ AI k AC u AL b AH i AK ʎ AE a AK
eslovakia	e AK s̺ AI l AE o AL b AH a AK k AC j AB a AK
eslovakiar	e AK s̺ AI l AE o AL b AH a AK k AC j AB a AK r AM
eslovakiera	e AK s̺ AI l AE o AL b AH a AK k AC j AB e AK ɾ BC a AK
eslovenia	e AK s̺ AI l AE o AL b AH e AK n AG j AB a AK
esloveniar	e AK s̺ AI l AE o AL b AH e AK n AG j AB a AK r AM
esloveniera	e AK s̺ AI l AE o AL b AH e AK n AG j AB e AK ɾ BC a AK
espainia	e AK s̺ AI p AH a AK ɲ AG j AB a AK
espainiar	e AK s̺ AI p AH a AK ɲ AG j AB a AK r AM
esperanto	e AK s̺ AI p AH e AK ɾ BC a AK n AG t AC o AL
espresuki	e AK s̺ AI p AH r AM e AK s̺ AI u AL k AC i AK
estonia	e AK s̺ AI t AC o AL n AG j AB a AK
estoniako	e AK s̺ AI t AC o AL n AG j AB a AK k AC o AL
estonian	e AK s̺ AI t AC o AL n AG j AB a AK n AG
estoniar	e AK s̺ AI t AC o AL n AG j AB a AK r AM
estoniera	e AK s̺ AI t AC o AL n AG j AB e AK ɾ BC a AK
estralurtar	e AK s̺ AI t AC r AM a AK l AE u AL r AM t AC a AK r AM
eta	e AK t AC a AK
eten	e AK t AC e AK n AG
etete	e AK t AC e AK t AC e AK
etor	e AK t AC o AL r AM
etorri	e AK t AC o AL r AM i AK
etorriko	e AK t AC o AL r AM i AK k AC o AL
etortze	e AK t AC o AL r AM t AC s̪ AI e AK
etortzen	e AK t AC o AL r AM t AC s̻ AI e AK n AG
etsai	e AK t AC s̺ AI a AK i AK
etxe	e AK t AC ʃ AI e AK
etzango	e AK t AC s̻ AI a AK n AG ɡ AC o AL
etzate	e AK t AC s̪ AI a AK t AC e AK
etzaten	e AK t AC s̻ AI a AK t AC e AK n AG
etzi	e AK t AC s̻ AI i AK
euli	e AK u AL l AE i AK
euskadi	e AK u AL s̺ AI k AC a AK d AC i AK
euskal	e AK u AL s̺ AI k AC a AK l AE
euskaldun	e AK u AL s̺ AI k AC a AK l AE d AC u AL n AG
euskaltegi	e AK w AJ s̺ AI k AC a AK l AE t AC e AK ɡ AC i AK
euskara	e AK u AL s̺ AI k AC a AK ɾ BC a AK
euskera	e AK u AL s̺ AI k AC e AK ɾ BC a AK
euzkadi	e AK u AL s̻ AI k AC a AK d AC i AK
ez	e AK s̻ AI
ezagut	e AK s̻ AI a AK ɡ AC u AL t AC
ezagutu	e AK s̻ AI a AK ɡ AC u AL t AC u AL
ezagutuko	e AK s̻ AI a AK ɡ AC u AL t AC u AL k AC o AL
ezagutze	e AK s̪ AI a AK ɡ AC u AL t AC s̪ AI e AK
ezagutzen	e AK s̻ AI a AK ɡ AC u AL t AC s̻ AI e AK n AG
ezker	e AK s̻ AI k AC e AK r AM
ezkerra	e AK s̻ AI k AC e AK r AM a AK
ezko	e AK s̻ AI k AC o AL
ezkongabe	e AK s̻ AI k AC o AL n AG ɡ AC a AK b AH e AK
ezkutatu	e AK s̻ AI k AC u AL t AC a AK t AC u AL
ezpel	e AK s̻ AI p AH e AK l AE
eztarri	e AK s̻ AI t AC a AK r AM i AK
ezti	e AK s̻ AI t AC i AK
eñe	e AK ɲ AG e AK
f	e AK f AN e AK
finlandia	f AN i AK n AG l AE a AK n AG d AC j AB a AK
finlandiar	f AN i AK n AG l AE a AK n AG d AC j AB a AK r AM
finlandiera	f AN i AK n AG l AE a AK n AG d AC j AB e AK ɾ BC a AK
flatulentzia	f AN l AE a AK t AC u AL l AE e AK n AG t AC s̻ AI j AB a AK
fluor	f AN l AE u AL o AL r AM
frantses	f AN r AM a AK n AG t AC s̺ AI e AK s̺ AI
frantzia	f AN r AM a AK n AG t AC s̻ AI j AB a AK
frantziar	f AN r AM a AK n AG t AC s̻ AI j AB a AK r AM
g	ɡ AC e AK
gabiltza	ɡ AC a AK b AH i AK l AE t AC s̻ AI a AK
gabiltzan	ɡ AC a AK b AH i AK l AE t AC s̻ AI a AK n AG
gabilzke	ɡ AC a AK b AH i AK l AE s̻ AI k AC e AK
gai	ɡ AC a AK i AK
gailu	ɡ AC a AK ʎ AE u AL
gaitez	ɡ AC a AK i AK t AC e AK s̻ AI
gaitezke	ɡ AC a AK i AK t AC e AK s̻ AI k AC e AK
gaizki	ɡ AC a AK i AK s̻ AI k AC i AK
gaizto	ɡ AC a AK i AK s̻ AI t AC o AL
galdu	ɡ AC a AK l AE d AC u AL
gales	ɡ AC a AK l AE e AK s̺ AI
galesera	ɡ AC a AK l AE e AK s̺ AI e AK ɾ BC a AK
galiziar	ɡ AC a AK l AE i AK s̻ AI j AB a AK r AM
galtzairu	ɡ AC a AK l AE t AC s̻ AI a AK i AK ɾ BC u AL
galtzak	ɡ AC a AK l AE t AC s̻ AI a AK k AC
galtzarbe	ɡ AC a AK l AE t AC s̻ AI a AK r AM b AH e AK
galtzari	ɡ AC a AK l AE t AC s̻ AI a AK ɾ BC i AK
galtzerdi	ɡ AC a AK l AE t AC s̻ AI e AK r AM d AC i AK
galtzetin	ɡ AC a AK l AE t AC s̻ AI e AK t AC i AK ɲ AG
gamelu	ɡ AC a AK m AF e AK l AE u AL
gara	ɡ AC a AK ɾ BC a AK
garagar	ɡ AC a AK ɾ BC a AK ɡ AC a AK r AM
garagardo	ɡ AC a AK ɾ BC a AK ɡ AC a AK r AM d AC o AL
garagarril	ɡ AC a AK ɾ BC a AK ɡ AC a AK r AM i AK ʎ AE
garai	ɡ AC a AK ɾ BC a AK i AK
garbantzu	ɡ AC a AK r AM b AH a AK n AG t AC s̻ AI u AL
garesti	ɡ AC a AK ɾ BC e AK s̺ AI t AC i AK
garil	ɡ AC a AK ɾ BC i AK ʎ AE
gasteiz	ɡ AC a AK s̺ AI t AC e AK i AK s̻ AI
gatazka	ɡ AC a AK t AC a AK s̻ AI k AC a AK
gatoz	ɡ AC a AK t AC o AL s̻ AI
gatozen	ɡ AC a AK t AC o AL s̻ AI e AK n AG
gatozke	ɡ AC a AK t AC o AL s̻ AI k AC e AK
gatxezkie	ɡ AC a AK t AC ʃ AI e AK s̻ AI k AC i AK e AK
gatxezkik	ɡ AC a AK t AC ʃ AI e AK s̻ AI k AC i AK k AC
gatxezkin	ɡ AC a AK t AC ʃ AI e AK s̻ AI k AC i AK n AG
gatxezkio	ɡ AC a AK t AC ʃ AI e AK s̻ AI k AC i AK o AL
gatxezkizu	ɡ AC a AK t AC ʃ AI e AK s̻ AI k AC i AK s̻ AI u AL
gatxezkizue	ɡ AC a AK t AC ʃ AI e AK s̻ AI k AC i AK s̻ AI u AL e AK
gatz	ɡ AC a AK t AC s̻ AI
gau	ɡ AC a AK u AL
gaude	ɡ AC a AK u AL d AC e AK
gaudeke	ɡ AC a AK u AL d AC e AK k AC e AK
gauden	ɡ AC a AK u AL d AC e AK n AG
gauenara	ɡ AC a AK u AL e AK n AG a AK ɾ BC a AK
gaupasa	ɡ AC a AK w AJ p AH a AK s̺ AI a AK
gaur	ɡ AC a AK u AL r AM
gautza	ɡ AC a AK u AL t AC s̻ AI a AK
gauza	ɡ AC a AK u AL s̻ AI a AK
gazi	ɡ AC a AK s̻ AI i AK
gaztaina	ɡ AC a AK s̻ AI t AC a AK ɲ AG a AK
gazte	ɡ AC a AK s̻ AI t AC e AK
gaztela	ɡ AC a AK s̻ AI t AC e AK l AE a AK
gaztelania	ɡ AC a AK s̻ AI t AC e AK l AE a AK n AG i AK a AK
gaztelera	ɡ AC a AK s̻ AI t AC e AK l AE e AK ɾ BC a AK
ge	ɡ AC e AK
genbiltzan	ɡ AC e AK n AG b AH i AK l AE t AC s̻ AI a AK n AG
genbilzke	ɡ AC e AK n AG b AH i AK l AE s̻ AI k AC e AK
genbilzkeen	ɡ AC e AK n AG b AH i AK l AE s̻ AI k AC e AK e AK n AG
genkizkien	ɡ AC e AK n AG k AC i AK s̻ AI k AC i AK e AK n AG
genkizkion	ɡ AC e AK n AG k AC i AK s̻ AI k AC i AK o AL n AG
gentozen	ɡ AC e AK n AG t AC o AL s̻ AI e AK n AG
gentozke	ɡ AC e AK n AG t AC o AL s̻ AI k AC e AK
gentozkeen	ɡ AC e AK n AG t AC o AL s̻ AI k AC e AK e AK n AG
gentxezkiake	ɡ AC e AK n AG t AC ʃ AI e AK s̻ AI k AC i AK a AK k AC e AK
gentxezkian	ɡ AC e AK n AG t AC ʃ AI e AK s̻ AI k AC i AK a AK n AG
gentxezkieke	ɡ AC e AK n AG t AC ʃ AI e AK s̻ AI k AC i AK e AK k AC e AK
gentxezkien	ɡ AC e AK n AG t AC ʃ AI e AK s̻ AI k AC i AK e AK n AG
gentxezkinake	ɡ AC e AK n AG t AC ʃ AI e AK s̻ AI k AC i AK n AG a AK k AC e AK
gentxezkinan	ɡ AC e AK n AG t AC ʃ AI e AK s̻ AI k AC i AK n AG a AK n AG
gentxezkioke	ɡ AC e AK n AG t AC ʃ AI e AK s̻ AI k AC i AK o AL k AC e AK
gentxezkion	ɡ AC e AK n AG t AC ʃ AI e AK s̻ AI k AC i AK o AL n AG
gentxezkizueke	ɡ AC e AK n AG t AC ʃ AI e AK s̻ AI k AC i AK s̻ AI u AL e AK k AC e AK
gentxezkizuen	ɡ AC e AK n AG t AC ʃ AI e AK s̻ AI k AC i AK s̻ AI u AL e AK n AG
gentxezkizuke	ɡ AC e AK n AG t AC ʃ AI e AK s̻ AI k AC i AK s̻ AI u AL k AC e AK
gentxezkizun	ɡ AC e AK n AG t AC ʃ AI e AK s̻ AI k AC i AK s̻ AI u AL n AG
georgia	ɡ AC e AK o AL r AM ɡ AC j AB a AK
georgiar	ɡ AC e AK o AL r AM ɡ AC j AB a AK r AM
georgiera	ɡ AC e AK o AL r AM ɡ AC j AB e AK ɾ BC a AK
gerezi	ɡ AC e AK ɾ BC e AK s̻ AI i AK
gero	ɡ AC e AK ɾ BC o AL
gerra	ɡ AC e AK r AM a AK
geu	ɡ AC e AK u̯ AJ
geundeke	ɡ AC e AK u AL n AG d AC e AK k AC e AK
geundekeen	ɡ AC e AK u AL n AG d AC e AK k AC e AK e AK n AG
geunden	ɡ AC e AK u AL n AG d AC e AK n AG
geuntzake	ɡ AC e AK u AL n AG t AC s̻ AI a AK k AC e AK
geuntzan	ɡ AC e AK u AL n AG t AC s̻ AI a AK n AG
geure	ɡ AC e AK w AJ ɾ BC e AK
gezi	ɡ AC e AK s̻ AI i AK
ghana	ɡ AC a AK n AG a AK
ghanan	ɡ AC a AK n AG a AK n AG
gibel	ɡ AC i AK b AH e AK l AE
giltza	ɡ AC i AK l AE t AC s̻ AI a AK
giltzurrun	ɡ AC i AK l AE t AC s̻ AI u AL r AM u AL n AG
ginen	ɡ AC i AK ɲ AG e AK n AG
gintezen	ɡ AC i AK n AG t AC e AK s̻ AI e AK n AG
gintezke	ɡ AC i AK n AG t AC e AK s̻ AI k AC e AK
gintezkeen	ɡ AC i AK n AG t AC e AK s̻ AI k AC e AK e AK n AG
gipuzkoa	ɡ AC i AK p AH u AL s̻ AI k AC o AL a AK
gipuzkoan	ɡ AC i AK p AH u AL s̻ AI k AC o AL a AK n AG
gizon	ɡ AC i AK s̻ AI o AL n AG
goaz	ɡ AC o AL a AK s̻ AI
gogo	ɡ AC o AL ɡ AC o AL
gontz	ɡ AC o AL n AG t AC s̻ AI
gora	ɡ AC o AL ɾ BC a AK
gorotzil	ɡ AC o AL ɾ BC o AL t AC s̻ AI i AK ʎ AE
gorri	ɡ AC o AL r AM i AK
gorrimin	ɡ AC o AL r AM i AK m AF i AK ɲ AG
gorrimotel	ɡ AC o AL r AM i AK m AF o AL t AC e AK l AE
gorringo	ɡ AC o AL r AM i AK n AG ɡ AC o AL
gosaldu	ɡ AC o AL s̺ AI a AK l AE d AC u AL
gozo	ɡ AC o AL s̻ AI o AL
grezia	ɡ AC r AM e AK s̻ AI j AB a AK
gris	ɡ AC r AM i AK s̺ AI
gu	ɡ AC u AL
guda	ɡ AC u AL d AC a AK
guk	ɡ AC u AL k AC
gune	ɡ AC u AL n AG e AK
guneka	ɡ AC u AL n AG e AK k AC a AK
gurdi	ɡ AC u AL r AM d AC i AK
gure	ɡ AC u AL ɾ BC e AK
guri	ɡ AC u AL ɾ BC i AK
gurpil	ɡ AC u AL r AM p AH i AK ʎ AE
h	h AA a AK t AC ʃ AI e AK
habe	h AA a AK b AH e AK
habil	h AA a AK b AH i AK l AE
habilke	h AA a AK b AH i AK l AE k AC e AK
hadi	h AA a AK d AC i AK
hadin	h AA a AK d AC i AK n AG
hago	h AA a AK ɡ AC o AL
hagoke	h AA a AK ɡ AC o AL k AC e AK
haiei	h AA a AK j AB e AK i AK
haiek	h AA a AK j AB e AK k AC
haien	h AA a AK j AB e AK n AG
haiteke	h AA a AK j AB t AC e AK k AC e AK
haitz	ɦ AA a AK i AK t AC s̻ AI
haiz	h AA a AK j AB s̪ AI
hakar	h AA a AK k AC a AK ɾ BC
hakien	h AA a AK k AC i AK e AK n AG
hala	ɦ AA a AK l AE a AK
hamabi	h AA a AK m AF a AK b AH i AK
hamabost	h AA a AK m AF a AK b AH o AL s̺ AI t AC
hamaika	h AA a AK m AF a AK i AK k AC a AK
hamairu	h AA a AK m AF a AK i AK ɾ BC u AL
hamalau	h AA a AK m AF a AK l AE a AK u AL
hamar	h AA a AK m AF a AK r AM
haren	h AA a AK ɾ BC e AK n AG
hari	h AA a AK ɾ BC i AK
haritz	h AA a AK ɾ BC i AK t AC s̻ AI
haritzezko	ɦ AA a AK ɾ BC i AK t AC s̻ AI e AK s̻ AI k AC o AL
harizki	h AA a AK r AM i AK s AI k AC i AK
hark	h AA a AK r AM k AC
harri	ɦ AA a AK r AM i AK
hartan	h AA a AK r AM t AC a AK n AG
hartara	h AA a AK r AM t AC a AK ɾ BC a AK
hartarat	h AA a AK r AM t AC a AK ɾ BC a AK t AC
hartz	ɦ AA a AK r AM t AC s̻ AI
hator	h AA a AK t AC o AL ɾ BC
hatorke	h AA a AK t AC o AL r AM k AC e AK
hatxe	h AA a AK t AC ʃ AI e AK
hatxekie	h AA a AK t AC ʃ AI e AK k AC i AK e AK
hatxekigu	h AA a AK t AC ʃ AI e AK k AC i AK ɡ AC u AL
hatxekio	h AA a AK t AC ʃ AI e AK k AC i AK o AL
hatxekit	h AA a AK t AC ʃ AI e AK k AC i AK t AC
hatza	h AA a AK t AC s̪ AI a AK
hau	h AA a AK w AJ
hauei	h AA a AK w AJ e AK i AK
hauek	h AA a AK w AJ e AK k AC
hauen	h AA a AK w AJ e AK n AG
hauka	h AA a AK w AJ k AC a AK
haukat	h AA a AK w AJ k AC a AK t AC
hazil	a AK s̺ AI i AK l AE
hebreera	ɦ AA e AK b AH r AM e AK e AK ɾ BC a AK
hegal	ɦ AA e AK ɡ AC a AK l AE
hego	ɦ AA e AK ɡ AC o AL
helio	h AA e AK l AE j AB o AL
hemen	ɦ AA e AK m AF e AK n AG
henbilen	h AA e AK n AG b AH i AK ʎ AE e AK n AG
henbilke	h AA e AK n AG b AH i AK l AE k AC e AK
henbilkeen	h AA e AK n AG b AH i AK l AE k AC e AK e AK n AG
hendin	h AA e AK n AG d AC i AK n AG
hengoen	h AA e AK n AG ɡ AC o AL e AK n AG
hengoke	h AA e AK n AG ɡ AC o AL k AC e AK
hengokeen	h AA e AK n AG ɡ AC o AL k AC e AK e AK n AG
henkien	h AA e AK n AG k AC i AK e AK n AG
henkion	h AA e AK n AG k AC i AK o AL n AG
hentorke	h AA e AK n AG t AC o AL r AM k AC e AK
hentorkeen	h AA e AK n AG t AC o AL r AM k AC e AK
hentorren	h AA e AK n AG t AC o AL r AM e AK n AG
hentxekidake	h AA e AK n AG t AC ʃ AI e AK k AC i AK d AC a AK k AC e AK
hentxekidan	h AA e AK n AG t AC ʃ AI e AK k AC i AK d AC a AK n AG
hentxekieke	h AA e AK n AG t AC ʃ AI e AK k AC i AK e AK k AC e AK
hentxekien	h AA e AK n AG t AC ʃ AI e AK k AC i AK e AK n AG
hentxekiguke	h AA e AK n AG t AC ʃ AI e AK k AC i AK ɡ AC u AL k AC e AK
hentxekigun	h AA e AK n AG t AC ʃ AI e AK k AC i AK ɡ AC u AL n AG
hentxekioke	h AA e AK n AG t AC ʃ AI e AK k AC i AK o AL k AC e AK
hentxekion	h AA e AK n AG t AC ʃ AI e AK k AC i AK o AL n AG
hentzake	h AA e AK n AG t AC s̪ AI a AK k AC e AK
hentzan	h AA e AK n AG t AC s̪ AI a AK n AG
heren	h AA e AK ɾ BC e AK n AG
herenegun	ɦ AA e AK ɾ BC e AK n AG e AK ɡ AC u AL n AG
heroan	h AA e AK ɾ BC o AL a AK n AG
herri	h AA e AK r AM i AK
heu	h AA e AK u̯ AJ
heuk	h AA e AK w AJ k AC
heure	h AA e AK w AJ ɾ BC e AK
hezur	ɦ AA e AK s̻ AI u AL r AM
hezurdura	ɦ AA e AK s̻ AI u AL r AM d AC u AL ɾ BC a AK
hezurtegi	ɦ AA e AK s̻ AI u AL r AM t AC e AK ɡ AC i AK
hi	i AK
hidrogeno	i AK d AC r AM o AL x AI e AK n AG o AL
hiena	ɦ AA j AB e AK n AG a AK
higan	i AK ɡ AC a AK n AG
hik	i AK k AC
hil	ɦ AA i AK ʎ AE
hinteke	i AK n AG t AC e AK k AC e AK
hintekeen	i AK n AG t AC e AK k AC e AK e AK n AG
hire	i AK ɾ BC e AK
hiregan	i AK ɾ BC e AK ɡ AC a AK n AG
hiri	i AK ɾ BC i AK
hirigintza	ɦ AA i AK ɾ BC i AK ɡ AC i AK n AG t AC s̻ AI a AK
hiru	ɦ AA i AK ɾ BC u AL
hirugarren	i AK ɾ BC u AL ɡ AC a AK r AM e AK n AG
hirukoitz	i AK ɾ BC u AL k AC o AL i AK t AC s̻ AI
hitan	i AK t AC a AK n AG
hoa	o AL a AK
hodei	ɦ AA o AL d AC e AK i AK
hogei	ɦ AA o AL ɡ AC e AK i AK
honek	o AL n AG e AK k AC
honen	o AL n AG e AK n AG
honi	o AL n AG i AK
hori	o AL ɾ BC i AK
horrek	o AL r AM e AK k AC
horren	o AL r AM e AK n AG
horri	o AL r AM i AK
hostaro	o AL s AI t AC a AK ɾ BC o AL
hots	ɦ AA o AL t AC s̺ AI
hotz	o AL t AC s̻ AI
hozkailu	o AL s̻ AI k AC a AK ʎ AE u AL
hungaria	ɦ AA u AL n AG ɡ AC a AK ɾ BC j AB a AK
hungariako	ɦ AA u AL n AG ɡ AC a AK ɾ BC j AB a AK k AC o AL
hungarian	ɦ AA u AL n AG ɡ AC a AK ɾ BC j AB a AK n AG
hungariar	ɦ AA u AL n AG ɡ AC a AK ɾ BC j AB a AK r AM
hungariera	ɦ AA u AL n AG ɡ AC a AK ɾ BC j AB e AK ɾ BC a AK
hur	ɦ AA u AL r AM
hura	u AL ɾ BC a AK
huts	u AL t AC s̺ AI
hutsik	ɦ AA u AL t AC s̺ AI i AK k AC
i	i AK
ia	i AK a AK
iaz	i AK a AK s̻ AI
ibai	i AK b AH a AK i AK
ibili	i AK b AH i AK ʎ AE i AK
idatzi	i AK d AC a AK t AC s̻ AI i AK
idazle	i AK d AC a AK s̻ AI l AE e AK
ido	i AK d AC o AL
igande	i AK ɡ AC a AK n AG d AC e AK
igaz	i AK ɡ AC a AK s̻ AI
igel	i AK ɡ AC e AK l AE
igo	i AK ɡ AC o AL
igorri	i AK ɡ AC o AL r AM i AK
iharduki	i AK ɦ AA a AK r AM d AC u AL k AC i AK
ikasgai	i AK k AC a AK s̺ AI ɡ AC a AK i AK
ikasi	i AK k AC a AK s̺ AI i AK
ikatz	i AK k AC a AK t AC s̻ AI
iker	i AK k AC e AK r AM
ikertu	i AK k AC e AK r AM t AC u AL
ikus	i AK k AC u AL s̺ AI
ikusi	i AK k AC u AL s̺ AI i AK
ikusiko	i AK k AC u AL s̺ AI i AK k AC o AL
ikuste	i AK k AC u AL s̺ AI t AC e AK
ikusten	i AK k AC u AL s̺ AI t AC e AK n AG
ilargi	i AK ʎ AE a AK r AM ɡ AC i AK
ilbeltz	i AK l AE b AH e AK l AE t AC s̻ AI
ilen	i AK ʎ AE e AK n AG
independentzia	i AK n AG d AC e AK p AH e AK n AG d AC e AK n AG t AC s̻ AI j AB a AK
indonesiera	i AK n AG d AC o AL n AG e AK s̺ AI j AB e AK ɾ BC a AK
ingalaterra	i AK n AG ɡ AC a AK l AE a AK t AC e AK r AM a AK
ingelera	i AK n AG ɡ AC e AK l AE e AK ɾ BC a AK
ingeles	i AK n AG ɡ AC e AK l AE e AK s̺ AI
internazional	i AK n AG t AC e AK r AM n AG a AK s̻ AI j AB o AL n AG a AK l AE
intsektu	i AK n AG t AC s̺ AI e AK k AC t AC u AL
intxaur	i AK n AG t AC ʃ AI a AK u AL r AM
inurri	i AK ɲ AG u AL r AM i AK
ipar	i AK p AH a AK r AM
irail	i AK ɾ BC a AK ʎ AE
irakatsi	i AK ɾ BC a AK k AC a AK t AC s̺ AI i AK
irakin	i AK ɾ BC a AK k AC i AK ɲ AG
irakurri	i AK ɾ BC a AK k AC u AL r AM i AK
iraun	i AK ɾ BC a AK u AL n AG
iritzi	i AK ɾ BC i AK t AC s̻ AI i AK
irla	i AK r AM l AE a AK
irlanda	i AK r AM l AE a AK n AG d AC a AK
irudi	i AK ɾ BC u AL d AC i AK
irudiko	i AK ɾ BC u AL d AC i AK k AC o AL
iruña	i AK ɾ BC u AL ɲ AG a AK
iruñea	i AK ɾ BC u AL ɲ AG e AK a AK
islandia	i AK s̺ AI l AE a AK n AG d AC j AB a AK
islandiar	i AK s̺ AI l AE a AK n AG d AC j AB a AK r AM
islandiera	i AK s̺ AI l AE a AK n AG d AC j AB e AK ɾ BC a AK
ispilu	i AK s̺ AI p AH i AK ʎ AE u AL
italia	i AK t AC a AK l AE j AB a AK
italian	i AK t AC a AK l AE j AB a AK n AG
italiar	i AK t AC a AK l AE j AB a AK r AM
italiera	i AK t AC a AK l AE j AB e AK ɾ BC a AK
ito	i AK t AC o AL
itsu	i AK t AC s̺ AI u AL
itsusi	i AK t AC s̺ AI u AL s̺ AI i AK
iturri	i AK t AC u AL r AM i AK
itzuli	i AK t AC s̻ AI u AL l AE i AK
itzultzaile	i AK t AC s̻ AI u AL l AE t AC s̻ AI a AK ʎ AE e AK
ixa	i AK ʃ AI a AK
izan	i AK s̻ AI a AK n AG
izeba	i AK s̻ AI e AK b AH a AK
izeko	i AK s̻ AI e AK k AC o AL
izen	i AK s AI e AK n AG
izokin	i AK s̻ AI o AL k AC i AK ɲ AG
izotz	i AK s̻ AI o AL t AC s̻ AI
izotzil	i AK s̻ AI o AL t AC s̻ AI i AK ʎ AE
izurde	i AK s̻ AI u AL r AM d AC e AK
jakin	ʒ AI a AK k AC i AK n AG
jan	x AI a AK n AG
janari	x AI a AK n AG a AK ɾ BC i AK
japonia	x AI a AK p AH o AL n AG j AB a AK
japoniera	x AI a AK p AH o AL n AG j AB e AK ɾ BC a AK
jardun	ʒ AI a AK r AM d AC u AL n AG
jarraiki	ʒ AI a AK r AM a AK j AB t AC e AK
joan	x AI o AL a AK n AG
jokatu	x AI o AL k AC a AK t AC u AL
jorrail	ʝ AI o AL r AM a AK ʎ AE
jugoslavia	j AB u AL ɡ AC o AL s̺ AI l AE a AK b AH j AB a AK
jugoslavian	j AB u AL ɡ AC o AL s̺ AI l AE a AK b AH j AB a AK n AG
k	k AC a AK
ka	k AC a AK
kaixo	k AC a AK j AB ʃ̺ AI o AL
kako	k AC a AK k AC o AL
kamerun	k AC a AK m AF e AK ɾ BC u AL n AG
kameu	k AC a AK m AF e AK u AL
kanpai	k AC a AK m AF p AH a AK i AK
karbono	k AC a AK r AM b AH o AL n AG o AL
karlistada	k AC a AK r AM l AE i AK s̺ AI t AC a AK d AC a AK
karlistaldi	k AC a AK r AM l AE i AK s̺ AI t AC a AK l AE d AC i AK
karmele	k AC a AK r AM m AF e AK l AE e AK
katagorri	k AC a AK t AC a AK ɡ AC o AL r AM i AK
kate	k AC a AK t AC e AK
katu	k AC a AK t AC u AL
kazakhera	k AC a AK s̻ AI a AK x AI e AK ɾ BC a AK
kazakhstan	k AC a AK s̻ AI a AK x AI s̺ AI t AC a AK n AG
ke	k AC e AK
kemen	k AC e AK m AF e AK n AG
ketsu	k AC e AK t AC s̺ AI u AL
kirol	k AC i AK ɾ BC o AL l AE
kirolari	k AC i AK ɾ BC o AL l AE a AK ɾ BC i AK
kiroldegi	k AC i AK ɾ BC o AL l AE d AC e AK ɡ AC i AK
koaderno	k AC w AJ a AK d AC e AK r AM n AG o AL
kobre	k AC o AL b AH r AM e AK
koronabirus	k AC o AL ɾ BC o AL n AG a AK b AH i AK ɾ BC u AL s̺ AI
korsikera	k AC o AL r AM s̺ AI i AK k AC e AK ɾ BC a AK
koru	k AC o AL ɾ BC u AL
kroazia	k AC r AM o AL a AK s̻ AI j AB a AK
kroaziar	k AC r AM o AL a AK s̻ AI j AB a AK r AM
kroaziera	k AC r AM o AL a AK s̻ AI j AB e AK ɾ BC a AK
ku	k AC u AL
kukutxeztul	k AC u AL k AC u AL t AC ʃ AI e AK s̺ AI t AC u AL l AE
l	e AK l AE e AK
labar	l AE a AK b AH a AK r AM
labe	l AE a AK b AH e AK
labezomorro	l AE a AK b AH e AK s̻ AI o AL m AF o AL r AM o AL
labezomorroa	l AE a AK b AH e AK s̪ AI o AL m AF o AL r AM o AL a AK
labezomorroak	l AE a AK b AH e AK s̪ AI o AL m AF o AL r AM o AL a AK k AC
labezomorroarenganantz	l AE a AK b AH e AK s̪ AI o AL m AF o AL r AM o AL a AK ɾ BC e AK n AG ɡ AC a AK n AG a AK n AG t AC s̪ AI
labezomorroek	l AE a AK b AH e AK s̺ AI o AL m AF o AL r AM o AL e AK k AC
labezomorroenganantz	l AE a AK b AH e AK s̪ AI o AL m AF o AL r AM o AL e AK n AG ɡ AC a AK n AG a AK n AG t AC s̪ AI
labezomorrok	l AE a AK b AH e AK s̪ AI o AL m AF o AL r AM o AL k AC
labezomorrorenganako	l AE a AK b AH e AK s̪ AI o AL m AF o AL r AM o AL ɾ BC e AK n AG ɡ AC a AK n AG a AK k AC o AL
labezomorrorenganantz	l AE a AK b AH e AK s̪ AI o AL m AF o AL r AM o AL ɾ BC e AK n AG ɡ AC a AK n AG a AK n AG t AC s̪ AI
labezomorrorengandik	l AE a AK b AH e AK s̪ AI o AL m AF o AL r AM o AL ɾ BC e AK n AG ɡ AC a AK n AG d AC i AK k AC
labezomorrorik	l AE a AK b AH e AK s̪ AI o AL m AF o AL r AM o AL ɾ BC i AK k AC
labezomorrotzat	l AE a AK b AH e AK s̪ AI o AL m AF o AL r AM o AL t AC s̪ AI a AK t AC
labur	l AE a AK b AH u AL r AM
laga	l AE a AK ɡ AC a AK
lagun	l AE a AK ɡ AC u AL n AG
lagundu	l AE a AK ɡ AC u AL n AG d AC u AL
laino	l AE a AK ɲ AG o AL
lari	l AE a AK ɾ BC i AK
larunbat	l AE a AK ɾ BC u AL n AG b AH a AK t AC
lastail	l AE a AK s AI t AC a AK ʎ AE
laster	l AE a AK s̺ AI t AC e AK r AM
lau	l AE a AK u AL
lauburu	l AE a AK u AL b AH u AL ɾ BC u AL
laugarren	l AE a AK u AL ɡ AC a AK r AM e AK n AG
laukoitz	l AE a AK u AL k AC o AL i AK t AC s̻ AI
laurden	l AE a AK u AL r AM d AC e AK n AG
lebilke	l AE e AK b AH i AK l AE k AC e AK
lebilzke	l AE e AK b AH i AK l AE s̪ AI k AC e AK
legoke	l AE e AK ɡ AC o AL k AC e AK
lehen	l AE e AK h AA e AK n AG
lehendakari	l AE e AK ɦ AA e AK n AG d AC a AK k AC a AK ɾ BC i AK
lera	l AE e AK ɾ BC a AK
lerak	l AE e AK ɾ BC a AK k AC
leraren	l AE e AK ɾ BC a AK ɾ BC e AK n AG
lerari	l AE e AK ɾ BC a AK ɾ BC i AK
lerei	l AE e AK ɾ BC e AK i AK
lerek	l AE e AK ɾ BC e AK k AC
letonia	l AE e AK t AC o AL n AG j AB a AK
letoniera	l AE e AK t AC o AL n AG j AB e AK ɾ BC a AK
letorke	l AE e AK t AC o AL r AM k AC e AK
letozke	l AE e AK t AC o AL s̪ AI k AC e AK
letxekiake	l AE e AK t AC ʃ AI e AK k AC i AK a AK k AC e AK
letxekidake	l AE e AK t AC ʃ AI e AK k AC i AK d AC a AK k AC e AK
letxekieke	l AE e AK t AC ʃ AI e AK k AC i AK e AK k AC e AK
letxekiguke	l AE e AK t AC ʃ AI e AK k AC i AK ɡ AC u AL k AC e AK
letxekinake	l AE e AK t AC ʃ AI e AK k AC i AK n AG a AK k AC e AK
letxekioke	l AE e AK t AC ʃ AI e AK k AC i AK o AL k AC e AK
letxekizueke	l AE e AK t AC ʃ AI e AK k AC i AK s̪ AI u AL e AK k AC e AK
letxekizuke	l AE e AK t AC ʃ AI e AK k AC i AK s̪ AI u AL k AC e AK
letxezkiake	l AE e AK t AC ʃ AI e AK s̪ AI k AC i AK a AK k AC e AK
letxezkidake	l AE e AK t AC ʃ AI e AK s̪ AI k AC i AK d AC a AK k AC e AK
letxezkieke	l AE e AK t AC ʃ AI e AK s̪ AI k AC i AK e AK k AC e AK
letxezkiguke	l AE e AK t AC ʃ AI e AK s̪ AI k AC i AK ɡ AC u AL k AC e AK
letxezkinake	l AE e AK t AC ʃ AI e AK s̪ AI k AC i AK n AG a AK k AC e AK
letxezkioke	l AE e AK t AC ʃ AI e AK s̪ AI k AC i AK o AL k AC e AK
letxezkizueke	l AE e AK t AC ʃ AI e AK s̪ AI k AC i AK s̪ AI u AL e AK k AC e AK
letxezkizuke	l AE e AK t AC ʃ AI e AK s̪ AI k AC i AK s̪ AI u AL k AC e AK
letzake	l AE e AK t AC s̪ AI a AK k AC e AK
leudeke	l AE e AK w AJ d AC e AK k AC e AK
leutzake	l AE e AK w AJ t AC s̪ AI a AK k AC e AK
lipschitzar	l AE i AK p AH ʃ AI i AK t AC s̻ AI j AB a AK r AM
liteke	l AE i AK t AC e AK k AC e AK
litezke	l AE i AK t AC e AK s̪ AI k AC e AK
litio	l AE i AK t AC j AB o AL
lituania	l AE i AK t AC w AJ a AK n AG j AB a AK
lituaniera	l AE i AK t AC w AJ a AK n AG j AB e AK ɾ BC a AK
lizar	l AE i AK s AI a AK r AM
lizarki	l AE i AK s AI a AK r AM k AC i AK
lorail	l AE o AL ɾ BC a AK ʎ AE
lotazil	l AE o AL t AC a AK s̻ AI i AK l AE
lotu	l AE o AL t AC u AL
lur	l AE u AL r AM
lurra	l AE u AL r AM a AK
luze	l AE u AL s̻ AI e AK
m	e AK m AF e AK
madril	m AF a AK d AC r AM i AK ʎ AE
maiatz	m AF a AK i AK a AK t AC s̻ AI
maitatu	m AF a AK i AK t AC a AK t AC u AL
makaronesia	m AF a AK k AC a AK ɾ BC o AL n AG e AK s̺ AI j AB a AK
maltera	m AF a AK l AE t AC e AK ɾ BC a AK
mapa	m AF a AK p AH a AK
marasma	m AF a AK ɾ BC a AK s AI m AF a AK
maroko	m AF a AK ɾ BC o AL k AC o AL
marroi	m AF a AK r AM o AL i AK
marti	m AF a AK r AM t AC i AK
martitzen	m AF a AK r AM t AC i AK t AC s̻ AI e AK n AG
martxo	m AF a AK r AM t AC ʃ AI o AL
mazedoniera	m AF a AK s̻ AI e AK d AC o AL n AG j AB e AK ɾ BC a AK
mendebal	m AF e AK n AG d AC e AK b AH a AK l AE
mendi	m AF e AK n AG d AC i AK
merkatu	m AF e AK r AM k AC a AK t AC u AL
merkatü	m AF e AK r AM k AC a AK t AC y AL
merkhatü	m AF e AK r AM kʰ AD a AK t AC y AL
mesede	m AF e AK s̺ AI e AK d AC e AK
mesedez	m AF e AK s̺ AI e AK d AC e AK s̻ AI
milesker	m AF i AK ʎ AE e AK s̺ AI k AC e AK r AM
mintzatu	m AF i AK n AG t AC s̻ AI a AK t AC u AL
misantropo	m AF i AK s AI a AK n AG t AC r AM o AL p AH o AL
moldavia	m AF o AL l AE d AC a AK b AH j AB a AK
moldavian	m AF o AL l AE d AC a AK b AH j AB a AK n AG
mongoliera	m AF o AL n AG ɡ AC o AL l AE j AB e AK ɾ BC a AK
motz	m AF o AL t AC s̻ AI
mutil	m AF u AL t AC i AK ʎ AE
n	e AK n AG e AK
nabil	n AG a AK b AH i AK l AE
nabilen	n AG a AK b AH i AK ʎ AE e AK n AG
nabilke	n AG a AK b AH i AK l AE k AC e AK
nadin	n AG a AK d AC i AK n AG
nago	n AG a AK ɡ AC o AL
nagoen	n AG a AK ɡ AC o AL e AK n AG
nagoke	n AG a AK ɡ AC o AL k AC e AK
naiteke	n AG a AK j AB t AC e AK k AC e AK
naiz	n AG a AK i AK s̻ AI
naizateke	n AG a AK i AK s̻ AI a AK t AC e AK k AC e AK
nakar	n AG a AK k AC a AK ɾ BC
nakie	n AG a AK k AC i AK e AK
naski	n AG a AK s̺ AI k AC i AK
nator	n AG a AK t AC o AL ɾ BC
natorke	n AG a AK t AC o AL r AM k AC e AK
natorkio	n AG a AK t AC o AL r AM k AC i AK o AL
natorkioke	n AG a AK t AC o AL r AM k AC i AK o AL k AC e AK
natorkion	n AG a AK t AC o AL r AM k AC i AK o AL n AG
natorren	n AG a AK t AC o AL r AM e AK n AG
natxekie	n AG a AK t AC ʃ AI e AK k AC i AK e AK
natxekik	n AG a AK t AC ʃ AI e AK k AC i AK k AC
natxekin	n AG a AK t AC ʃ AI e AK k AC i AK n AG
natxekio	n AG a AK t AC ʃ AI e AK k AC i AK o AL
natxekizu	n AG a AK t AC ʃ AI e AK k AC i AK s̪ AI u AL
natxekizue	n AG a AK t AC ʃ AI e AK k AC i AK s̪ AI u AL e AK
natza	n AG a AK t AC s̪ AI a AK
nauka	n AG a AK w AJ k AC a AK
nederlandera	n AG e AK d AC e AK r AM l AE a AK n AG d AC e AK ɾ BC a AK
neguil	n AG e AK ɡ AC u AL i AK ʎ AE
nekatu	n AG e AK k AC a AK t AC u AL
nenbilen	n AG e AK n AG b AH i AK ʎ AE e AK n AG
nenbilke	n AG e AK n AG b AH i AK l AE k AC e AK
nenbilkeen	n AG e AK n AG b AH i AK l AE k AC e AK e AK n AG
nendin	n AG e AK n AG d AC i AK n AG
nengoen	n AG e AK n AG ɡ AC o AL e AK n AG
nengoke	n AG e AK n AG ɡ AC o AL k AC e AK
nengokeen	n AG e AK n AG ɡ AC o AL k AC e AK e AK n AG
nenkien	n AG e AK n AG k AC i AK e AK n AG
nenkion	n AG e AK n AG k AC i AK o AL n AG
nentorke	n AG e AK n AG t AC o AL r AM k AC e AK
nentorkeen	n AG e AK n AG t AC o AL r AM k AC e AK e AK n AG
nentorkioke	n AG e AK n AG t AC o AL r AM k AC i AK o AL k AC e AK
nentorkiokeen	n AG e AK n AG t AC o AL r AM k AC i AK o AL k AC e AK e AK n AG
nentorkion	n AG e AK n AG t AC o AL r AM k AC i AK o AL n AG
nentorren	n AG e AK n AG t AC o AL r AM e AK n AG
nentxekiake	n AG e AK n AG t AC ʃ AI e AK k AC i AK a AK k AC e AK
nentxekian	n AG e AK n AG t AC ʃ AI e AK k AC i AK a AK n AG
nentxekieke	n AG e AK n AG t AC ʃ AI e AK k AC i AK e AK k AC e AK
nentxekien	n AG e AK n AG t AC ʃ AI e AK k AC i AK e AK n AG
nentxekinake	n AG e AK n AG t AC ʃ AI e AK k AC i AK n AG a AK k AC e AK
nentxekinan	n AG e AK n AG t AC ʃ AI e AK k AC i AK n AG a AK n AG
nentxekioke	n AG e AK n AG t AC ʃ AI e AK k AC i AK o AL k AC e AK
nentxekion	n AG a AK t AC ʃ AI e AK k AC i AK o AL n AG
nentxekizueke	n AG e AK n AG t AC ʃ AI e AK k AC i AK s̪ AI u AL e AK k AC e AK
nentxekizuen	n AG e AK n AG t AC ʃ AI e AK k AC i AK s̪ AI u AL e AK n AG
nentxekizuke	n AG e AK n AG t AC ʃ AI e AK k AC i AK s̪ AI u AL k AC e AK
nentxekizun	n AG e AK n AG t AC ʃ AI e AK k AC i AK s̪ AI u AL n AG
nentzake	n AG e AK n AG t AC s̪ AI a AK k AC e AK
nentzan	n AG e AK n AG t AC s̪ AI a AK n AG
neon	n AG e AK o AL n AG
neska	n AG e AK s̺ AI k AC a AK
neskenegun	n AG e AK s AI k AC e AK n AG e AK ɡ AC u AL n AG
neu	n AG e AK u̯ AJ
neuk	n AG e AK w AJ k AC
neurri	n AG e AK u AL r AM i AK
ni	n AG i AK
nigan	n AG i AK ɡ AC a AK n AG
nik	n AG i AK k AC
ninteke	n AG i AK n AG t AC e AK k AC e AK
nintekeen	n AG i AK n AG t AC e AK k AC e AK e AK n AG
nintzateke	n AG i AK n AG t AC s̻ AI a AK t AC e AK k AC e AK
nintzatekeen	n AG i AK n AG t AC s̻ AI a AK t AC e AK k AC e AK e AK n AG
nintzen	n AG i AK n AG t AC s̻ AI e AK n AG
nire	n AG i AK ɾ BC e AK
niregan	n AG i AK ɾ BC e AK ɡ AC a AK n AG
nitan	n AG i AK t AC a AK n AG
nitrogeno	n AG i AK t AC r AM o AL x AI e AK n AG o AL
noa	n AG o AL a AK
nola	n AG o AL l AE a AK
non	n AG o AL n AG
nor	n AG o AL r AM
nora	n AG o AL ɾ BC a AK
nori	n AG o AL ɾ BC i AK
nork	n AG o AL r AM k AC
nortzuk	n AG o AL r AM t AC s̪ AI u AL k AC
norvegia	n AG o AL r AM b AH e AK ɡ AC j AB a AK
norvegiera	n AG o AL r AM b AH e AK ɡ AC j AB e AK ɾ BC a AK
o	o AL
oheratu	o AL ɦ AA e AK ɾ BC a AK t AC u AL
oilaur	o AL ʎ AE a AK u AL r AM
oin	o AL ɲ AG
oinarri	o AL ɲ AG a AK r AM i AK
oka	o AL k AC a AK
okin	o AL k AC i AK ɲ AG
okzitaniera	o AL k AC s̻ AI i AK t AC a AK n AG j AB e AK ɾ BC a AK
olerkari	o AL l AE e AK r AM k AC a AK ɾ BC i AK
olerkaritza	o AL l AE e AK r AM k AC a AK ɾ BC i AK t AC s̪ AI a AK
olerki	o AL l AE e AK r AM k AC i AK
on	o AL n AG
ondo	o AL n AG d AC o AL
onil	o AL n AG i AK ʎ AE
ontzi	o AL n AG t AC s̻ AI i AK
ordenatu	o AL r AM d AC e AK n AG a AK t AC u AL
ordots	o AL r AM d AC o AL t AC s̺ AI
orein	o AL ɾ BC e AK ɲ AG
oreka	o AL ɾ BC e AK k AC a AK
orri	o AL r AM i AK
orril	o AL r AM i AK ʎ AE
ortzegun	o AL r AM t AC s̻ AI e AK ɡ AC u AL n AG
ortzi	o AL r AM t AC s̻ AI i AK
ortzirale	o AL r AM t AC s̻ AI i AK ɾ BC a AK l AE e AK
osaba	o AL s̺ AI a AK b AH a AK
ostegun	o AL s̺ AI t AC e AK ɡ AC u AL n AG
ostiral	o AL s̺ AI t AC i AK ɾ BC a AK l AE
otsail	o AL t AC s̺ AI a AK ʎ AE
otso	o AL t AC s̺ AI o AL
oxigeno	o AL k AC s̺ AI i AK x AI e AK n AG o AL
ozpin	o AL s̻ AI p AH i AK ɲ AG
oztin	o AL s̻ AI t AC i AK ɲ AG
oñati	o AL ɲ AG a AK t AC i AK
p	p AH e AK
pago	p AH a AK ɡ AC o AL
pandemia	p AH a AK n AG d AC e AK m AF j AB a AK
patata	p AH a AK t AC a AK t AC a AK
patxaran	p AH a AK t AC ʃ AI a AK ɾ BC a AK n AG
pauso	p AH a AK u AL s̺ AI o AL
pe	p AH e AK
penintsula	p AH e AK n AG i AK n AG t AC s̺ AI u AL l AE a AK
pintxo	p AH i AK n AG t AC ʃ AI o AL
piraña	p AH i AK ɾ BC a AK ɲ AG a AK
piztu	p AH i AK s̻ AI t AC u AL
poeta	p AH o AL e AK t AC a AK
polen	p AH o AL l AE e AK n AG
polit	p AH o AL l AE i AK t AC
politikari	p AH o AL l AE i AK t AC i AK k AC a AK ɾ BC i AK
polje	p AH o AL ʎ AE e AK
polonia	p AH o AL l AE o AL n AG j AB a AK
polonian	p AH o AL l AE o AL n AG j AB a AK n AG
poloniera	p AH o AL l AE o AL n AG j AB e AK ɾ BC a AK
portugalera	p AH o AL r AM t AC u AL ɡ AC a AK l AE e AK ɾ BC a AK
portuges	p AH o AL r AM t AC u AL ɡ AC e AK s̺ AI
potasio	p AH o AL t AC a AK s̺ AI j AB o AL
pozoi	p AH o AL s̻ AI o AL i AK
pozoidun	p AH o AL s̻ AI o AL i AK d AC u AL n AG
pozoidura	p AH o AL s̻ AI o AL i AK d AC u AL ɾ BC a AK
pozoitasun	p AH o AL s̻ AI o AL i AK t AC a AK s̺ AI u AL n AG
pozoitsu	p AH o AL s̻ AI o AL i AK t AC s̺ AI u AL
pozoitu	p AH o AL s̻ AI o AL i AK t AC u AL
q	k AC u AL
r	e AK r AM e AK
rabbi	r AM a AK b AH i AK
s	e AK s̺ AI e AK
sagar	s̺ AI a AK ɡ AC a AK r AM
sagardo	s̺ AI a AK ɡ AC a AK r AM d AC o AL
sagarrondo	s̺ AI a AK ɡ AC a AK r AM o AL n AG d AC o AL
saguzar	s̺ AI a AK ɡ AC u AL s̻ AI a AK r AM
saldu	s̺ AI a AK l AE d AC u AL
sartalde	s̺ AI a AK r AM t AC a AK l AE d AC e AK
sartu	s̺ AI a AK r AM t AC u AL
satan	s̺ AI a AK t AC a AK n AG
sator	s̺ AI a AK t AC o AL r AM
sei	s̺ AI e AK i AK
seigarren	s̺ AI e AK i AK ɡ AC a AK r AM e AK n AG
seikoitz	s̺ AI e AK i AK k AC o AL i AK t AC s̻ AI
sein	s̺ AI e AK i̯ AB ɲ AG
seiren	s̺ AI e AK i AK ɾ BC e AK n AG
sekretu	s̺ AI e AK k AC r AM e AK t AC u AL
seme	s̺ AI e AK m AF e AK
serbia	s̺ AI e AK r AM b AH j AB a AK
serbiera	s̺ AI e AK r AM b AH j AB e AK ɾ BC a AK
serbokroaziera	s̺ AI e AK r AM b AH o AL k AC r AM o AL a AK s̻ AI j AB e AK ɾ BC a AK
setemere	s AI e AK t AC e AK m AF e AK ɾ BC e AK
siziliera	s̺ AI i AK s̻ AI i AK l AE j AB e AK ɾ BC a AK
soin	s̺ AI o AL ɲ AG
somaliera	s̺ AI o AL m AF a AK l AE j AB e AK ɾ BC a AK
sorgin	s̺ AI o AL r AM ɡ AC i AK ɲ AG
sortalde	s̺ AI o AL r AM t AC a AK l AE d AC e AK
suedia	s̺ AI w AJ e AK d AC j AB a AK
suediera	s̺ AI w AJ e AK d AC j AB e AK ɾ BC a AK
sufre	s̺ AI u AL f AN ɾ BC e AK
suitza	s̺ AI w AJ i AK t AC s̻ AI a AK
t	t AC e AK
taberna	t AC a AK b AH e AK r AM n AG a AK
tailandiera	t AC a AK i AK l AE a AK n AG d AC j AB e AK ɾ BC a AK
tarte	t AC a AK r AM t AC e AK
tarteka	t AC a AK r AM t AC e AK k AC a AK
tatami	t AC a AK t AC a AK m AF i AK
tauromakia	t AC a AK u AL ɾ BC o AL m AF a AK k AC j AB a AK
te	t AC e AK
telezabor	t AC e AK l AE e AK s̻ AI a AK b AH o AL r AM
tigre	t AC i AK ɡ AC r AM e AK
tigrea	t AC i AK ɡ AC r AM e AK a AK
tigreari	t AC i AK ɡ AC r AM e AK a AK ɾ BC i AK
tigrez	t AC i AK ɡ AC r AM e AK s̻ AI
tipula	t AC i AK p AH u AL l AE a AK
tobera	t AC o AL b AH e AK ɾ BC a AK
toki	t AC o AL k AC i AK
tunisia	t AC u AL n AG i AK s̺ AI j AB a AK
tunisian	t AC u AL n AG i AK s̺ AI j AB a AK n AG
turkia	t AC u AL r AM k AC i AK a AK
turkiera	t AC u AL r AM k AC i AK e AK ɾ BC a AK
txakaviera	t AC ʃ AI a AK k AC a AK b AH j AB e AK ɾ BC a AK
txakur	t AC ʃ AI a AK k AC u AL r AM
txakurkume	t AC ʃ AI a AK k AC u AL r AM k AC u AL m AF e AK
txapel	t AC ʃ AI a AK p AH e AK l AE
txekiera	t AC ʃ AI e AK k AC j AB e AK ɾ BC a AK
txerri	t AC ʃ AI e AK r AM i AK
txetnik	t AC ʃ AI e AK t AC n AG i AK k AC
tximino	t AC ʃ AI i AK m AF i AK ɲ AG o AL
txina	t AC ʃ AI i AK n AG a AK
txinera	t AC ʃ AI i AK n AG e AK ɾ BC a AK
txingurri	t AC ʃ AI i AK n AG ɡ AC u AL r AM i AK
txirrin	t AC ʃ AI i AK r AM i AK ɲ AG
txirrindu	t AC ʃ AI i AK r AM i AK n AG d AC u AL
txirrindulari	t AC ʃ AI i AK r AM i AK n AG d AC u AL l AE a AK ɾ BC i AK
txirrindularitza	t AC ʃ AI i AK r AM i AK n AG d AC u AL l AE a AK ɾ BC i AK t AC s̻ AI a AK
txori	t AC ʃ AI o AL ɾ BC i AK
u	u AL
uda	u AL d AC a AK
udaberri	u AL d AC a AK b AH e AK r AM i AK
udal	u AL d AC a AK l AE
udaletxe	u AL d AC a AK l AE e AK t AC ʃ AI e AK
udazken	u AL d AC a AK s̻ AI k AC e AK n AG
ugaztun	u AL ɡ AC a AK s̻ AI t AC u AL n AG
uharte	u AL ɦ AA a AK r AM t AC e AK
uhartedi	u AL h AA a AK r AM t AC e AK d AC i AK
uhartegi	u AL h AA a AK r AM t AC e AK ɡ AC i AK
ukondo	u AL k AC o AL n AG d AC o AL
ukraina	u AL k AC r AM a AK i AK n AG a AK
ukrainan	u AL k AC r AM a AK i AK n AG a AK n AG
ukrainera	u AL k AC r AM a AK i AK n AG e AK ɾ BC a AK
ulertu	u AL l AE e AK r AM t AC u AL
unai	u AL n AG a AK i AK
untxi	u AL n AG t AC ʃ AI i AK
ur	u AL r AM
urde	u AL r AM d AC e AK
urdin	u AL r AM d AC i AK ɲ AG
urre	u AL r AM e AK
urri	u AL r AM i AK
urrieta	u AL r AM i AK e AK t AC a AK
urril	u AL r AM i AK ʎ AE
urtaro	u AL r AM t AC a AK ɾ BC o AL
urtarril	u AL r AM t AC a AK r AM i AK ʎ AE
urte	u AL r AM t AC e AK
urthe	u AL r AM tʰ AD e AK
urtxintxa	u AL r AM t AC ʃ AI i AK n AG t AC ʃ AI a AK
usategi	u AL s̺ AI a AK t AC e AK ɡ AC i AK
uso	u AL s̺ AI o AL
usteldu	u AL s̺ AI t AC e AK l AE d AC u AL
utz	u AL t AC s̪ AI
utzi	u AL t AC s̻ AI i AK
uve	u AL b AH e AK
uzbekera	u AL s̻ AI b AH e AK k AC e AK ɾ BC a AK
uzta	u AL s̻ AI t AC a AK
uztail	u AL s̻ AI t AC a AK ʎ AE
uñhu	u AL ɲ AG ɦ AA ũ
v	u AL b AH e AK
vietnamera	b AH j AB e AK t AC n AG a AK m AF e AK ɾ BC a AK
x	i AK ʃ AI a AK
xabier	ʃ AI a AK β AN j AB e AK r AM
xaboi	ʃ AI a AK b AH o AL i AK
xake	ʃ AI a AK k AC e AK
xakelari	ʃ AI a AK k AC e AK l AE a AK ɾ BC i AK
xanpu	ʃ AI a AK m AF p AH u AL
xurgagailu	ʃ AI u AL r AM ɡ AC a AK ɡ AC a AK ʎ AE u AL
yarda	ʎ AE a AK r AM d AC a AK
z	s̻ AI e AK t AC a AK
zabiltza	s̪ AI a AK b AH i AK l AE t AC s̪ AI a AK
zabiltzate	s̪ AI a AK b AH i AK l AE t AC s̪ AI a AK t AC e AK
zabilzke	s̪ AI a AK b AH i AK l AE s̪ AI k AC e AK
zabilzkete	s̪ AI a AK b AH i AK l AE s̪ AI k AC e AK t AC e AK
zahar	s̻ AI a AK ɦ AA a AK r AM
zahi	s̻ AI a AK ɦ AA i AK
zaitez	s̪ AI a AK j AB t AC e AK s̪ AI
zaitezke	s̪ AI a AK j AB t AC e AK s̪ AI k AC e AK
zaitezkete	s̪ AI a AK j AB t AC e AK s̪ AI k AC e AK t AC e AK
zaitezte	s̪ AI a AK j AB t AC e AK s̪ AI t AC e AK
zaldi	s̻ AI a AK l AE d AC i AK
zamari	s̻ AI a AK m AF a AK ɾ BC i AK
zapaburu	s̻ AI a AK p AH a AK b AH u AL ɾ BC u AL
zapatu	s̻ AI a AK p AH a AK t AC u AL
zara	s̪ AI a AK ɾ BC a AK
zarautz	s̻ AI a AK ɾ BC a AK u AL t AC s̻ AI
zarete	s̪ AI a AK ɾ BC e AK t AC e AK
zatoz	s̪ AI a AK t AC o AL s̪ AI
zatozke	s̪ AI a AK t AC o AL s̪ AI k AC e AK
zatozkete	s̪ AI a AK t AC o AL s̪ AI k AC e AK t AC e AK
zatozte	s̪ AI a AK t AC o AL s̪ AI t AC e AK
zatxezkidate	s̪ AI a AK t AC ʃ AI e AK s̪ AI k AC i AK d AC a AK t AC e AK
zatxezkie	s̪ AI a AK t AC ʃ AI e AK s̪ AI k AC i AK e AK
zatxezkiete	s̪ AI a AK t AC ʃ AI e AK s̪ AI k AC i AK e AK t AC e AK
zatxezkigu	s̪ AI a AK t AC ʃ AI e AK s̪ AI k AC i AK ɡ AC u AL
zatxezkigute	s̪ AI a AK t AC ʃ AI e AK s̪ AI k AC i AK ɡ AC u AL t AC e AK
zatxezkio	s̪ AI a AK t AC ʃ AI e AK s̪ AI k AC i AK o AL
zatxezkiote	s̪ AI a AK t AC ʃ AI e AK s̪ AI k AC i AK o AL t AC e AK
zatxezkit	s̪ AI a AK t AC ʃ AI e AK s̪ AI k AC i AK t AC
zaude	s̪ AI a AK w AJ d AC e AK
zaudeke	s̪ AI a AK w AJ d AC e AK k AC e AK
zaudekete	s̪ AI a AK w AJ d AC e AK k AC e AK t AC e AK
zaudete	s̪ AI a AK w AJ d AC e AK t AC e AK
zauri	s̻ AI a AK u AL ɾ BC i AK
zautza	s̪ AI a AK w AJ t AC s̪ AI a AK
zautzate	s̪ AI a AK w AJ t AC s̪ AI a AK t AC e AK
zazpi	s̻ AI a AK s̻ AI p AH i AK
zazpigarren	s̻ AI a AK s̻ AI p AH i AK ɡ AC a AK r AM e AK n AG
zazpikoitz	s̻ AI a AK s̻ AI p AH i AK k AC o AL i AK t AC s̻ AI
zazpiren	s̻ AI a AK s̻ AI p AH i AK ɾ BC e AK n AG
ze	s̻ AI e AK
zebilen	s̪ AI e AK b AH i AK ʎ AE e AK n AG
zebilkeen	s̪ AI e AK b AH i AK l AE k AC e AK e AK n AG
zebiltzan	s̪ AI e AK b AH i AK l AE t AC s̪ AI a AK n AG
zebilzkeen	s̪ AI e AK b AH i AK l AE s̪ AI k AC e AK e AK n AG
zedin	s̪ AI e AK d AC i AK ɲ AG
zegoen	s̪ AI e AK ɡ AC o AL e AK n AG
zegokeen	s̪ AI e AK ɡ AC o AL k AC e AK e AK n AG
zein	s̪ AI e AK ɲ AG
zekien	s̪ AI e AK k AC i AK e AK n AG
zekion	s̪ AI e AK k AC i AK o AL n AG
zekizkien	s̪ AI e AK k AC i AK s̪ AI k AC i AK e AK n AG
zekizkion	s̪ AI e AK k AC i AK s̪ AI k AC i AK o AL n AG
zemendi	s̻ AI e AK m AF e AK n AG d AC i AK
zen	s̪ AI e AK n AG
zenbaki	s̻ AI e AK n AG b AH a AK k AC i AK
zenbiltzan	s̪ AI e AK n AG b AH i AK l AE t AC s̪ AI a AK n AG
zenbiltzaten	s̪ AI e AK n AG b AH i AK l AE t AC s̪ AI a AK t AC e AK n AG
zenbilzke	s̪ AI e AK n AG b AH i AK l AE s̪ AI k AC e AK
zenbilzkeen	s̪ AI e AK n AG b AH i AK l AE s̪ AI k AC e AK e AK n AG
zenbilzkete	s̪ AI e AK n AG b AH i AK l AE s̪ AI k AC e AK t AC e AK
zenbilzketen	s̪ AI e AK n AG b AH i AK l AE s̪ AI k AC e AK t AC e AK n AG
zenkizkien	s̪ AI e AK n AG k AC i AK s̪ AI k AC i AK e AK n AG
zenkizkieten	s̪ AI e AK n AG k AC i AK s̪ AI k AC i AK e AK t AC e AK n AG
zenkizkion	s̪ AI e AK n AG k AC i AK s̪ AI k AC i AK o AL n AG
zenkizkioten	s̪ AI e AK n AG k AC i AK s̪ AI k AC i AK o AL t AC e AK n AG
zentozen	s̪ AI e AK n AG t AC o AL s̪ AI e AK n AG
zentozke	s̪ AI e AK n AG t AC o AL s̪ AI k AC e AK
zentozkeen	s̪ AI e AK n AG t AC o AL s̪ AI k AC e AK e AK n AG
zentozkete	s̪ AI e AK n AG t AC o AL s̪ AI k AC e AK t AC e AK
zentozketen	s̪ AI e AK n AG t AC o AL s̪ AI k AC e AK t AC e AK n AG
zentozten	s̪ AI e AK n AG t AC o AL s̪ AI t AC e AK n AG
zentxezkidake	s̪ AI e AK n AG t AC ʃ AI e AK s̪ AI k AC i AK d AC a AK k AC e AK
zentxezkidakete	s̪ AI e AK n AG t AC ʃ AI e AK s̪ AI k AC i AK d AC a AK k AC e AK t AC e AK
zentxezkidan	s̪ AI e AK n AG t AC ʃ AI e AK s̪ AI k AC i AK d AC a AK n AG
zentxezkidaten	s̪ AI e AK n AG t AC ʃ AI e AK s̪ AI k AC i AK d AC a AK t AC e AK n AG
zentxezkieke	s̪ AI e AK n AG t AC ʃ AI e AK s̪ AI k AC i AK e AK k AC e AK
zentxezkiekete	s̪ AI e AK n AG t AC ʃ AI e AK s̪ AI k AC i AK e AK k AC e AK t AC e AK
zentxezkien	s̪ AI e AK n AG t AC ʃ AI e AK s̪ AI k AC i AK e AK n AG
zentxezkieten	s̪ AI e AK n AG t AC ʃ AI e AK s̪ AI k AC i AK e AK t AC e AK n AG
zentxezkiguke	s̪ AI e AK n AG t AC ʃ AI e AK s̪ AI k AC i AK ɡ AC u AL k AC e AK
zentxezkigukete	s̪ AI e AK n AG t AC ʃ AI e AK s̪ AI k AC i AK ɡ AC u AL k AC e AK t AC e AK
zentxezkigun	s̪ AI e AK n AG t AC ʃ AI e AK s̪ AI k AC i AK ɡ AC u AL n AG
zentxezkiguten	s̪ AI e AK n AG t AC ʃ AI e AK s̪ AI k AC i AK ɡ AC u AL t AC e AK n AG
zentxezkioke	s̪ AI e AK n AG t AC ʃ AI e AK s̪ AI k AC i AK o AL k AC e AK
zentxezkiokete	s̪ AI e AK n AG t AC ʃ AI e AK s̪ AI k AC i AK o AL k AC e AK t AC e AK
zentxezkion	s̪ AI e AK n AG t AC ʃ AI e AK s̪ AI k AC i AK o AL n AG
zentxezkioten	s̪ AI e AK n AG t AC ʃ AI e AK s̪ AI k AC i AK o AL t AC e AK n AG
zer	s̪ AI e AK ɾ BC
zerbitzu	s̪ AI e AK r AM b AH i AK t AC s̪ AI u AL
zerbitzugune	s̪ AI e AK r AM b AH i AK t AC s̪ AI u AL ɡ AC u AL n AG e AK
zerbütxügüne	s̪ AI e AK r AM b AH i AK t AC ʃ AI y AL ɡ AC y AL n AG e AK
zerekin	s̪ AI e AK ɾ BC e AK k AC i AK n AG
zeren	s̪ AI e AK ɾ BC e AK n AG
zerentzat	s̻ AI e AK ɾ BC e AK n AG t AC s̻ AI a AK t AC
zerez	s̪ AI e AK ɾ BC e AK s̪ AI
zergatik	s̪ AI e AK r AM ɡ AC a AK t AC i AK k AC
zeri	s̪ AI e AK ɾ BC i AK
zerk	s̪ AI e AK r AM k AC
zero	s̻ AI e AK ɾ BC o AL
zerogarren	s̻ AI e AK ɾ BC o AL ɡ AC a AK r AM e AK n AG
zerri	s̻ AI e AK r AM i AK
zertaz	s̪ AI e AK r AM t AC a AK s̪ AI
zeru	s̻ AI e AK ɾ BC u AL
zeta	s̻ AI e AK t AC a AK
zetorkeen	s̪ AI e AK t AC o AL r AM k AC e AK e AK n AG
zetorren	s̪ AI e AK t AC o AL r AM e AK n AG
zetozen	s̪ AI e AK t AC o AL s̪ AI e AK n AG
zetozkeen	s̪ AI e AK t AC o AL s̪ AI k AC e AK e AK n AG
zetxekian	s̪ AI e AK t AC ʃ AI e AK k AC i AK a AK n AG
zetxekidan	s̪ AI e AK t AC ʃ AI e AK k AC i AK d AC a AK n AG
zetxekien	s̪ AI e AK t AC ʃ AI e AK k AC i AK e AK n AG
zetxekigun	s̪ AI e AK t AC ʃ AI e AK k AC i AK ɡ AC u AL n AG
zetxekinan	s̪ AI e AK t AC ʃ AI e AK k AC i AK n AG a AK n AG
zetxekion	s̪ AI e AK t AC ʃ AI e AK k AC i AK o AL n AG
zetxekizuen	s̪ AI e AK t AC ʃ AI e AK k AC i AK s̪ AI u AL e AK n AG
zetxekizun	s̪ AI e AK t AC ʃ AI e AK k AC i AK s̪ AI u AL n AG
zetxezkian	s̪ AI e AK t AC ʃ AI e AK s̪ AI k AC i AK a AK n AG
zetxezkidan	s̪ AI e AK t AC ʃ AI e AK s̪ AI k AC i AK d AC a AK n AG
zetxezkien	s̪ AI e AK t AC ʃ AI e AK s̪ AI k AC i AK e AK n AG
zetxezkigun	s̪ AI e AK t AC ʃ AI e AK s̪ AI k AC i AK ɡ AC u AL n AG
zetxezkinan	s̪ AI e AK t AC ʃ AI e AK s̪ AI k AC i AK n AG a AK n AG
zetxezkion	s̪ AI e AK t AC ʃ AI e AK s̪ AI k AC i AK o AL n AG
zetxezkizuen	s̪ AI e AK t AC ʃ AI e AK s̪ AI k AC i AK s̪ AI u AL e AK n AG
zetxezkizun	s̪ AI e AK t AC ʃ AI e AK s̪ AI k AC i AK s̪ AI u AL n AG
zetzan	s̪ AI e AK t AC s̪ AI a AK n AG
zeu	s̪ AI e AK w AJ
zeudekeen	s̪ AI e AK w AJ d AC e AK k AC e AK e AK n AG
zeuden	s̪ AI e AK w AJ d AC e AK n AG
zeundeke	s̪ AI e AK w AJ n AG d AC e AK k AC e AK
zeundekeen	s̪ AI e AK w AJ n AG d AC e AK k AC e AK e AK n AG
zeundekete	s̪ AI e AK w AJ n AG d AC e AK k AC e AK t AC e AK
zeundeketen	s̪ AI e AK w AJ n AG d AC e AK k AC e AK t AC e AK n AG
zeunden	s̪ AI e AK w AJ n AG d AC e AK n AG
zeundeten	s̪ AI e AK w AJ n AG d AC e AK t AC e AK n AG
zeuntzake	s̪ AI e AK w AJ n AG t AC s̪ AI a AK k AC e AK
zeuntzakete	s̪ AI e AK w AJ n AG t AC s̪ AI a AK k AC e AK t AC e AK
zeuntzan	s̪ AI e AK w AJ n AG t AC s̪ AI a AK n AG
zeuntzaten	s̪ AI e AK w AJ n AG t AC s̪ AI a AK t AC e AK n AG
zeure	s̪ AI e AK w AJ ɾ BC e AK
zeutzan	s̪ AI e AK w AJ t AC s̪ AI a AK n AG
zezeil	s̺ AI e AK s̺ AI e AK ʎ AE
zezen	s̻ AI e AK s̻ AI e AK n AG
zezenkari	s̻ AI e AK s̻ AI e AK n AG k AC a AK ɾ BC i AK
zigilu	s̻ AI i AK ɡ AC i AK ʎ AE u AL
zikoina	s̻ AI i AK k AC o AL ɲ AG a AK
zilar	s̪ AI i AK ʎ AE a AK ɾ BC
zintezen	s̪ AI i AK n AG t AC e AK s̪ AI e AK n AG
zintezke	s̪ AI i AK n AG t AC e AK s̪ AI k AC e AK
zintezkeen	s̪ AI i AK n AG t AC e AK s̪ AI k AC e AK e AK n AG
zintezkete	s̪ AI i AK n AG t AC e AK s̪ AI k AC e AK t AC e AK
zintezketen	s̪ AI i AK n AG t AC e AK s̪ AI k AC e AK t AC e AK n AG
zintezten	s̪ AI i AK n AG t AC e AK s̪ AI t AC e AK n AG
zintzur	s̻ AI i AK n AG t AC s̻ AI u AL r AM
zipre	s̻ AI i AK p AH r AM e AK
zirkonio	s̪ AI i AK r AM k AC o AL n AG j AB o AL
zitekeen	s̪ AI i AK t AC e AK k AC e AK e AK n AG
zitezen	s̪ AI i AK t AC e AK s̪ AI e AK n AG
zitezkeen	s̪ AI i AK t AC e AK s̪ AI k AC e AK e AK n AG
ziztatu	s̻ AI i AK s̻ AI t AC a AK t AC u AL
zolda	s̻ AI o AL l AE d AC a AK
zortzi	s̻ AI o AL r AM t AC s̻ AI i AK
zortzigarren	s̻ AI o AL r AM t AC s̻ AI i AK ɡ AC a AK r AM e AK n AG
zortzikoitz	s̻ AI o AL r AM t AC s̻ AI i AK k AC o AL i AK t AC s̻ AI
zortziren	s̻ AI o AL r AM t AC s̻ AI i AK ɾ BC e AK n AG
zu	s̪ AI u AL
zubi	s̻ AI u AL b AH i AK
zuek	s̪ AI u AL e AK k AC
zuhaitz	s̻ AI u AL ɦ AA a AK i AK t AC s̻ AI
zuhaixka	s̻ AI u AL h AA a AK i AK ʃ AI k AC a AK
zuhamuxka	s̻ AI u AL h AA a AK m AF u AL ʃ AI k AC a AK
zuk	s̪ AI u AL k AC
zulo	s̻ AI u AL l AE o AL
zulogune	s̻ AI u AL l AE o AL ɡ AC u AL n AG e AK
zumake	s̻ AI u AL m AF a AK k AC e AK
zumarraga	s̻ AI u AL m AF a AK r AM a AK ɡ AC a AK
zur	s̻ AI u AL r AM
zurgin	s̻ AI u AL r AM ɡ AC i AK ɲ AG
zurgina	s̻ AI u AL r AM ɡ AC i AK ɲ AG a AK
zurginak	s̻ AI u AL r AM ɡ AC i AK ɲ AG a AK k AC
zurginarekin	s̻ AI u AL r AM ɡ AC i AK ɲ AG a AK ɾ BC e AK k AC i AK ɲ AG
zurginaren	s̻ AI u AL r AM ɡ AC i AK ɲ AG a AK ɾ BC e AK n AG
zurginarengan	s̻ AI u AL r AM ɡ AC i AK ɲ AG a AK ɾ BC e AK n AG ɡ AC a AK n AG
zurginarengana	s̻ AI u AL r AM ɡ AC i AK ɲ AG a AK ɾ BC e AK n AG ɡ AC a AK n AG a AK
zurginarenganaino	s̻ AI u AL r AM ɡ AC i AK ɲ AG a AK ɾ BC e AK n AG ɡ AC a AK n AG a AK ɲ AG o AL
zurginarenganako	s̻ AI u AL r AM ɡ AC i AK ɲ AG a AK ɾ BC e AK n AG ɡ AC a AK n AG a AK k AC o AL
zurginarenganantz	s̻ AI u AL r AM ɡ AC i AK ɲ AG a AK ɾ BC e AK n AG ɡ AC a AK n AG a AK n AG t AC s̻ AI
zurginarengandik	s̻ AI u AL r AM ɡ AC i AK ɲ AG a AK ɾ BC e AK n AG ɡ AC a AK n AG d AC i AK k AC
zurginarengatik	s̻ AI u AL r AM ɡ AC i AK ɲ AG a AK ɾ BC e AK n AG ɡ AC a AK t AC i AK k AC
zurginarentzat	s̻ AI u AL r AM ɡ AC i AK ɲ AG a AK ɾ BC e AK n AG t AC s̻ AI a AK t AC
zurginari	s̻ AI u AL r AM ɡ AC i AK ɲ AG a AK ɾ BC i AK
zurginaz	s̻ AI u AL r AM ɡ AC i AK ɲ AG a AK s̻ AI
zurgindegi	s̻ AI u AL r AM ɡ AC i AK n AG d AC e AK ɡ AC i AK
zurginei	s̻ AI u AL r AM ɡ AC i AK ɲ AG e AK i AK
zurginek	s̻ AI u AL r AM ɡ AC i AK ɲ AG e AK k AC
zurginekin	s̻ AI u AL r AM ɡ AC i AK ɲ AG e AK k AC i AK ɲ AG
zurginen	s̻ AI u AL r AM ɡ AC i AK ɲ AG e AK n AG
zurginengan	s̻ AI u AL r AM ɡ AC i AK ɲ AG e AK n AG ɡ AC a AK n AG
zurginengana	s̻ AI u AL r AM ɡ AC i AK ɲ AG e AK n AG ɡ AC a AK n AG a AK
zurginenganaino	s̻ AI u AL r AM ɡ AC i AK ɲ AG e AK n AG ɡ AC a AK n AG a AK ɲ AG o AL
zurginenganako	s̻ AI u AL r AM ɡ AC i AK ɲ AG e AK n AG ɡ AC a AK n AG a AK k AC o AL
zurginenganantz	s̻ AI u AL r AM ɡ AC i AK ɲ AG e AK n AG ɡ AC a AK n AG a AK n AG t AC s̻ AI
zurginengandik	s̻ AI u AL r AM ɡ AC i AK ɲ AG e AK n AG ɡ AC a AK n AG d AC i AK k AC
zurginengatik	s̻ AI u AL r AM ɡ AC i AK ɲ AG e AK n AG ɡ AC a AK t AC i AK k AC
zurginentzat	s̻ AI u AL r AM ɡ AC i AK ɲ AG e AK n AG t AC s̻ AI a AK t AC
zurginez	s̻ AI u AL r AM ɡ AC i AK ɲ AG e AK s̻ AI
zurgini	s̻ AI u AL r AM ɡ AC i AK ɲ AG i AK
zurginik	s̻ AI u AL r AM ɡ AC i AK ɲ AG i AK k AC
zurgintza	s̻ AI u AL r AM ɡ AC i AK n AG t AC s̻ AI a AK
zurgintzat	s̻ AI u AL r AM ɡ AC i AK n AG t AC s̻ AI a AK t AC
zuri	s̻ AI u AL ɾ BC i AK
zuzen	s̻ AI u AL s̻ AI e AK n AG
zuzendu	s̻ AI u AL s̻ AI e AK n AG d AC u AL
zuzentasun	s̻ AI u AL s̻ AI e AK n AG t AC a AK s̺ AI u AL n AG
zuzentzaile	s̻ AI u AL s̻ AI e AK n AG t AC s̻ AI a AK ʎ AE e AK
zuñiga	s̻ AI u AL ɲ AG i AK ɡ AC a AK
züntzür	s̻ AI y AL n AG t AC s̻ AI y AL r AM
ñ	e AK ɲ AG e AK
ü	y AL
üthürri	y AL tʰ AD y AL r AM i AK
ĺ	ʎ AE
ŕ	r AM
