a	a AD
aba	a AD b a AD
abade	a AD b a AD d e AD
abadegai	a AD b a AD d e AD ɡ a AD i AD
abadesa	a AD b a AD d e AD s̺ a AD
abadia	a AD b a AD d i AD a AD
abadiano	a AD b a AD d j AB a AD n o AE
abagune	a AD b a AD ɡ u AE n e AD
abako	a AD b a AD k o AE
abantaila	a AD b a AD n t a AD ʎ a AD
abendu	a AD b e AD n d u AE
abentura	a AD b e AD n t u AE ɾ a AD
abenturazale	a AD b e AD n t u AE ɾ a AD s̻ a AD l e AD
aberastasun	a AD b e AD ɾ a AD s̺ t a AD s̺ u AE n
aberats	a AD b e AD ɾ a AD t s̺
abere	a AD b e AD ɾ e AD
aberri	a AD b e AD r i AD
abertzale	a AD b e AD r t s̻ a AD l e AD
abertzaletasun	a AD b e AD r t s̻ a AD l e AD t a AD s u AE n
abes	a AD b e AD s̺
abesbatza	a AD b e AD s̺ b a AD t s̻ a AD
abeslari	a AD b e AD s l a AD ɾ i AD
abeste	a AD b e AD s̺ t e AD
abesten	a AD b e AD s̺ t e AD n
abesti	a AD b e AD s̺ t i AD
abestu	a AD b e AD s̺ t u AE
abestuko	a AD b e AD s̺ t u AE k o AE
abizen	a AD b i AD s̻ e AD n
abkhazera	a AD b x a AD s̻ e AD ɾ a AD
abkhazia	a AD b x a AD s̻ j AB a AD
abkhaziar	a AD b x a AD s̻ j AB a AD r
aboitiz	a AD b o AE i AD t i AD s̻
abstraktu	a AD b s̺ t r a AD k t u AE
abundi	a AD b u AE n d i AD
abundio	a AD b u AE n d j AB o AE
aburu	a AD b u AE ɾ u AE
abuztu	a AD b u AE s̻ t u AE
adar	a AD d a AD r
adibide	a AD d i AD b i AD d e AD
adibidez	a AD d i AD b i AD d e AD s̻
adimen	a AD d i AD m e AD n
adiskidetasun	a AD d i AD s̺ k i AD d e AD t a AD s̺ u AE n
aditu	a AD d i AD t u AE
aditz	a AD d i AD t s̻
adolba	a AD d o AE l b a AD
adore	a AD d o AE ɾ e AD
ados	a AD d o AE s̺
adoste	a AD d o AE s̺ t e AD
adosten	a AD d o AE s̺ t e AD n
adostu	a AD d o AE s̺ t u AE
adostuko	a AD d o AE s̺ t u AE k o AE
afari	a AD f a AD ɾ i AD
afganistan	a AD f ɡ a AD n i AD s̺ t a AD n
afganistandar	a AD f ɡ a AD n i AD s̺ t a AD n d a AD r
agate	a AD ɡ a AD t e AD
agirre	a AD ɡ i AD r e AD
agor	a AD ɡ o AE r
agorril	a AD ɡ o AE r i AD ʎ
agur	a AD ɡ u AE r
ahabe	ã h AA ã b e AD
ahabia	a AD ɦ AA a AD b j AB a AD
ahai	a AD h̃ AH a AD i AD
ahal	a AD ɦ AA a AD l
ahate	a AD ɦ AA a AD t e AD
ahatz	a AD h AA a AD t s̻
ahazte	a AD h AA a AD s̻ t e AD
ahazten	a AD h AA a AD s̻ t e AD n
ahaztu	a AD s̻ t u AE
ahaztuko	a AD s̻ t u AE k o AE
ahuntz	a AD ɦ AA u AE n t s̻
ainara	a AD i AD n a AD ɾ a AD
ainarba	a AD ɲ a AD r b a AD
ainhoa	a AD i AD n o AE a AD
aintzane	a AD i AD n t s̻ a AD n e AD
aise	a AD i AD s̺ e AD
aita	a AD i AD t a AD
aitatxi	a AD i AD t a AD t ʃ i AD
aitona	a AD i AD t o AE n a AD
aitor	a AD i AD t o AE r
aitzur	a AD i AD t s̻ u AE r
aizkolari	a AD i AD s̻ k o AE l a AD ɾ i AD
aizkora	a AD i AD s̻ k o AE ɾ a AD
aizto	a AD i AD s̻ t o AE
akelarre	a AD k e AD l a AD r e AD
aker	a AD k e AD r
akordeoi	a AD k o AE r d e AD o AE i AD
akrobata	a AD k r o AE b a AD t a AD
aktiba	a AD k t i AD b a AD
aktibatu	a AD k t i AD b a AD t u AE
aktibatuko	a AD k t i AD b a AD t u AE k o AE
aktibatze	a AD k t i AD b a AD t s̻ e AD
aktibatzen	a AD k t i AD b a AD t s̻ e AD n
aktore	a AD k t o AE ɾ e AD
alaba	a AD l a AD b a AD
alai	a AD l a AD i AD
albaitari	a AD l b a AD i AD t a AD ɾ i AD
albania	a AD l b a AD n j AB a AD
albaniar	a AD l b a AD n j AB a AD r
albaniera	a AD l b a AD n j AB e AD ɾ a AD
alda	a AD l d a AD
aldatu	a AD l d a AD t u AE
aldatuko	a AD l d a AD t u AE k o AE
aldatze	a AD l d a AD t s̻ e AD
aldatzen	a AD l d a AD t s̻ e AD n
alde	a AD l d e AD
aldizkari	a AD l d i AD s̻ k a AD ɾ i AD
aleman	a AD l e AD m a AD n
alemanera	a AD l e AD m a AD n e AD ɾ a AD
alemania	a AD l e AD m a AD n j AB a AD
alemaniar	a AD l e AD m a AD n j AB a AD r
alkandora	a AD l k a AD n d o AE ɾ a AD
alkandorak	a AD l k a AD n d o AE ɾ a AD k
alkandorek	a AD l k a AD n d o AE ɾ e AD k
alkate	a AD l k a AD t e AD
alkohol	a AD l k o AE ɦ AA o AE l
alkohola	a AD l k o AE ɦ AA o AE l a AD
alkoholan	a AD l k o AE ɦ AA o AE l a AD n
alkoholen	a AD l k o AE ɦ AA o AE l e AD n
alkoholi	a AD l k o AE ɦ AA o AE l i AD
alkoholik	a AD l k o AE ɦ AA o AE l i AD k
altxoin	a AD l t ʃ o AE i AD ɲ
altxor	a AD l t ʃ o AE r
aluminio	a AD l u AE m i AD n j AB o AE
ama	a AD m a AD
amaraun	a AD m a AD ɾ a AD u AE n
amatasun	a AD m a AD t a AD s̺ u AE n
amesgaizto	a AD m e AD s̺ ɡ a AD i AD s̻ t o AE
amets	a AD m e AD t s̺
ametz	a AD m e AD t s̻
anana	a AD n a AD n a AD
andaia	a AD n d a AD j AB a AD
ander	a AD n d e AD r
andereño	a AD n d e AD ɾ e AD ɲ o AE
andorra	a AD n d o AE r a AD
andorratar	a AD n d o AE r a AD t a AD r
andorratarra	a AD n d o AE r a AD t a AD r a AD
andorratarrak	a AD n d o AE r a AD t a AD r a AD k
andorratarraren	a AD n d o AE r a AD t a AD r a AD ɾ e AD n
andorratarrari	a AD n d o AE r a AD t a AD r a AD ɾ i AD
andorratarrei	a AD n d o AE r a AD t a AD r e AD i AD
andorratarrek	a AD n d o AE r a AD t a AD r e AD k
andorratarren	a AD n d o AE r a AD t a AD r e AD n
andorratarri	a AD n d o AE r a AD t a AD r i AD
angola	a AD n ɡ o AE l a AD
animalia	a AD n i AD m a AD l i AD a AD
anime	a AD n i AD m e AD
anker	a AD n k e AD r
antartika	a AD n t a AD r t i AD k a AD
antigua	a AD n t i AD ɡ w AC a AD
antton	a AD n t ʃ o AE n
antxeta	a AD n t ʃ e AD t a AD
antxieta	a AD n t ʃ j AB e AD t a AD
antzara	a AD n t s̻ a AD ɾ a AD
apaiz	a AD p a AD i AD s̻
apaizgai	a AD p a AD i AD s̻ ɡ a AD i AD
apar	a AD p a AD r
apez	a AD p e AD s̻
apiril	a AD p i AD ɾ i AD ʎ
apo	a AD p o AE
aprobetxategi	a AD p r o AE b e AD t ʃ a AD t e AD ɡ i AD
araba	a AD ɾ a AD b a AD
arabiera	a AD ɾ a AD b j AB e AD ɾ a AD
arabisagar	a AD ɾ a AD b i AD s̺ a AD ɡ a AD r
aramu	a AD ɾ a AD m u AE
aran	a AD ɾ a AD n
aranondo	a AD ɾ a AD n o AE n d o AE
arbola	a AD r b o AE l a AD
ardi	a AD r d i AD
ardo	a AD r d o AE
arellano	a AD ɾ e AD ʎ a AD n o AE
argi	a AD r ɡ i AD
argitsu	a AD r ɡ i AD t s̺ u AE
aristotele	a AD ɾ i AD s̺ t o AE t e AD l e AD
aritz	a AD ɾ i AD t s̻
armenia	a AD r m e AD n j AB a AD
armeniar	a AD r m e AD n j AB a AD r
armeniera	a AD r m e AD n j AB e AD ɾ a AD
armiarma	a AD r m i AD a AD r m a AD
arotz	a AD ɾ o AE t s̻
aroztegi	a AD ɾ o AE s̻ t e AD ɡ i AD
arrain	a AD r a AD i AD ɲ
arrano	a AD r a AD n o AE
arrantzale	a AD r a AD n t s̻ a AD l e AD
arratoi	a AD r a AD t o AE i AD
arraun	a AD r a AD u AE n
arrigorriaga	a AD r i AD ɡ o AE r j AB a AD ɡ a AD
arroda	a AD r o AE d a AD
arrosa	a AD r o AE s̺ a AD
arrunt	a AD r u AE n t
artaburu	a AD r t a AD b u AE ɾ u AE
arte	a AD r t e AD
arto	a AD r t o AE
artseniko	a AD r t s̺ e AD n i AD k o AE
artxipelago	a AD r t ʃ i AD p e AD l a AD ɡ o AE
artzain	a AD r t s̻ a AD i AD ɲ
askatasun	a AD s̺ k a AD t a AD s̺ u AE n
aske	a AD s̺ k e AD
asko	a AD s̺ k o AE
aste	a AD s̺ t e AD
astearte	a AD s̺ t e AD a AD r t e AD
asteazken	a AD s̺ t e AD a AD s̻ k e AD n
asteburu	a AD s̺ t e AD b u AE ɾ u AE
astelehen	a AD s̺ t e AD l e AD n
asto	a AD s̺ t o AE
asturiera	a AD s̺ t u AE ɾ j AB e AD ɾ a AD
asun	a AD s̺ u AE n
atena	a AD t e AD n a AD
atxeki	a AD t ʃ e AD k i AD
atxekiko	a AD t ʃ e AD k i AD k o AE
atxekitzen	a AD t ʃ e AD k i AD t s̻ e AD n
atzelari	a AD t s̻ e AD l a AD ɾ i AD
atzo	a AD t s̻ o AE
aukera	a AD u AE k e AD ɾ a AD
aukeratu	a AD u AE k e AD ɾ a AD t u AE
aukeratuko	a AD u AE k e AD ɾ a AD t u AE k o AE
aukeratze	a AD u AE k e AD ɾ a AD t s̻ e AD
aukeratzen	a AD u AE k e AD ɾ a AD t s̻ e AD n
aurki	a AD u AE r k i AD
aurkitu	a AD u AE r k i AD t u AE
aurkituko	a AD u AE r k i AD t u AE k o AE
aurkitze	a AD u AE r k i AD t s̻ e AD
aurkitzen	a AD u AE r k i AD t s̻ e AD n
aurpegi	a AD u AE r p e AD ɡ i AD
aurre	a AD u AE r e AD
australia	a AD u AE s̺ t r a AD l j AB a AD
austria	a AD u AE s̺ t r j AB a AD
austriar	a AD u AE s̺ t r j AB a AD r
azaro	a AD s̻ a AD ɾ o AE
azerbaijan	a AD s̻ e AD r b a AD i AD j AB a AD n
azerbaijandar	a AD s̻ e AD r b a AD i AD j AB a AD n d a AD r
azerbaijanera	a AD s̻ e AD r b a AD i AD j AB a AD n e AD ɾ a AD
azeri	a AD s̻ e AD ɾ i AD
azkar	a AD s̻ k a AD r
azkonar	a AD s̻ k o AE n a AD r
azoka	a AD s̻ o AE k a AD
azukre	a AD s̻ u AE k r e AD
b	b e AD
badia	b a AD d i AD a AD
bagenbiltza	b a AD ɡ e AD n b i AD l t s̻ a AD
bagentoz	b a AD ɡ e AD n t o AE s̻
bageunde	b a AD ɡ e AD u AE n d e AD
bagil	b a AD ɡ i AD ʎ
bagina	b a AD ɡ i AD ɲ a AD
bagintez	b a AD ɡ i AD n t e AD s̻
bahenbil	b a AD h AA e AD n b i AD l
bahendi	b a AD h AA e AD n d i AD
bahengo	b a AD h AA e AD n ɡ o AE
bahentor	b a AD h AA e AD n t o AE r
bai	b a AD i AD
baita	b a AD i AD t a AD
bakarrik	b a AD k a AD r i AD k
bake	b a AD k e AD
baketu	b a AD k e AD t u AE
baketuko	b a AD k e AD t u AE k o AE
baketze	b a AD k e AD t s̪ e AD
baketzen	b a AD k e AD t s̻ e AD n
bakteriofago	b a AD k t e AD ɾ j AB o AE f a AD ɡ o AE
balebil	b a AD l e AD b i AD l
balebiltza	b a AD l e AD b i AD l t s̪ a AD
baledi	b a AD l e AD d i AD
balego	b a AD l e AD ɡ o AE
baletor	b a AD l e AD t o AE r
baletoz	b a AD l e AD t o AE s̻
baleude	b a AD l e AD u AE d e AD
balitez	b a AD l i AD t e AD s̻
bana	b a AD n a AD
banatu	b a AD n a AD t u AE
banatuko	b a AD n a AD t u AE k o AE
banatze	b a AD n a AD t s̪ e AD
banatzen	b a AD n a AD t s̻ e AD n
banenbil	b a AD n e AD n b i AD l
banendi	b a AD n e AD n d i AD
banengo	b a AD n e AD n ɡ o AE
banentor	b a AD n e AD n t o AE r
banentorkio	b a AD n e AD n t o AE r k i AD o AE
banintz	b a AD n i AD n t s̻
banpiro	b a AD m p i AD ɾ o AE
barantaila	b a AD ɾ a AD n t a AD ʎ a AD
barazkari	b a AD ɾ a AD s̻ k a AD ɾ i AD
barbuda	b a AD r b u AE d a AD
bare	b a AD ɾ e AD
bariku	b a AD ɾ i AD k u AE
barna	b a AD r n a AD
barrabil	b a AD r a AD b i AD ʎ
barre	b a AD r e AD
barren	b a AD r e AD n
barrena	b a AD r e AD n a AD
bart	b a AD r t
basajaun	b a AD s̺ a AD x a AD u AE n
baserri	b a AD s̺ e AD r i AD
baserritar	b a AD s̺ e AD r i AD t a AD r
baserritartu	b a AD s̺ e AD r i AD t a AD r t u AE
baserritartuko	b a AD s̺ e AD r i AD t a AD r t u AE k o AE
baserritartze	b a AD s̺ e AD r i AD t a AD r t s̪ e AD
baserritartzen	b a AD s̺ e AD r i AD t a AD r t s̻ e AD n
baso	b a AD s̺ o AE
basurde	b a AD s̺ u AE r d e AD
bat	b a AD t
bata	b a AD t a AD
batak	b a AD t a AD k
batean	b a AD t e AD a AD n
batek	b a AD t e AD k
baten	b a AD t e AD n
batera	b a AD t e AD ɾ a AD
batez	b a AD t e AD s̪
bati	b a AD t i AD
batzuetan	b a AD t s̻ u AE e AD t a AD n
bazenbiltza	b a AD s̻ e AD n b i AD l t s̻ a AD
bazenbiltzate	b a AD s̻ e AD n b i AD l t s̻ a AD t e AD
bazentoz	b a AD s̻ e AD n t o AE s̻
bazentozte	b a AD s̻ e AD n t o AE s̻ t e AD
bazeunde	b a AD s̻ e AD u AE n d e AD
bazeundete	b a AD s̻ e AD u AE n d e AD t e AD
bazintez	b a AD s̻ i AD n t e AD s̻
bazintezte	b a AD s̻ i AD n t e AD s̻ t e AD
be	b e AD
bebil	b e AD b i AD l
bebiltza	b e AD b i AD l t s̻ a AD
bederatzi	b e AD d e AD ɾ a AD t s̻ i AD
bedi	b e AD d i AD
begi	b e AD ɡ i AD
begira	b e AD ɡ i AD ɾ a AD
begiratu	b e AD ɡ i AD ɾ a AD t u AE
begiratuko	b e AD ɡ i AD ɾ a AD t u AE k o AE
begiratze	b e AD ɡ i AD ɾ a AD t s̪ e AD
begiratzen	b e AD ɡ i AD ɾ a AD t s̻ e AD n
bego	b e AD ɡ o AE
behar	b e AD ɦ AA a AD r
behartsu	b e AD ɦ AA a AD r t s̺ u AE
behi	b e AD ɦ AA i AD
beki	b e AD k i AD
bekie	b e AD k i AD e AD
bele	b e AD l e AD
belgika	b e AD l ɡ i AD k a AD
belgikar	b e AD l ɡ i AD k a AD r
beltx	b e AD l t ʃ
beltz	b e AD l t s̻
belz	b e AD l s̻
berde	b e AD r d e AD
berilio	b e AD ɾ i AD l j AB o AE
bero	b e AD ɾ o AE
berpiztu	b e AD r p i AD s̻ t u AE
berri	b e AD r i AD
berriro	b e AD r i AD ɾ o AE
besape	b e AD s̺ a AD p e AD
beso	b e AD s̺ o AE
beti	b e AD t i AD
betor	b e AD t o AE r
betoz	b e AD t o AE s̻
beude	b e AD u AE d e AD
bi	b i AD
bide	b i AD d e AD
bidegorri	b i AD d e AD ɡ o AE r i AD
bielorrusia	b j AB e AD l o AE r u AE s̺ j AB a AD
bielorrusiera	b j AB e AD l o AE r u AE s̺ j AB e AD ɾ a AD
bigarren	b i AD ɡ a AD r e AD n
bihar	b i AD h AA a AD r
bihotz	b i AD ɦ AA o AE t s̻
bikoitz	b i AD k o AE i AD t s̻
bikote	b i AD k o AE t e AD
bilatu	b i AD ʎ a AD t u AE
bilbo	b i AD l b o AE
bildil	b i AD l d i AD ʎ
bira	b i AD ɾ a AD
birika	b i AD ɾ i AD k a AD
bitez	b i AD t e AD s̻
bizar	b i AD s a AD r
boro	b o AE ɾ o AE
bosgarren	b o AE s̺ ɡ a AD r e AD n
boskoitz	b o AE s̺ k o AE i AD t s̻
bosniera	b o AE s̺ n j AB e AD ɾ a AD
bost	b o AE s̺ t
bosten	b o AE s̺ t e AD n
bozkatu	b o AE s̻ k a AD t u AE
bretoiera	b r e AD t o AE i AD e AD ɾ a AD
bulgaria	b u AE l ɡ a AD ɾ j AB a AD
bulgarian	b u AE l ɡ a AD ɾ j AB a AD n
bulgariera	b u AE l ɡ a AD ɾ j AB e AD ɾ a AD
burdina	b u AE r d i AD ɲ a AD
burdinbide	b u AE r d i AD m b i AD d e AD
burdingintza	b u AE r d i AD n ɡ i AD n t s̻ a AD
buru	b u AE ɾ u AE
buruil	b u AE ɾ u AE ʎ
burukomin	b u AE ɾ u AE k o AE m i AD ɲ
burumuin	b u AE ɾ u AE m u AE ɲ
büü	b y AE y AE
c	s̻ e AD
d	d e AD
da	d a AD
dabil	d a AD b i AD l
dabilela	d a AD b i AD ʎ e AD l a AD
dabilke	d a AD b i AD l k e AD
dabiltza	d a AD b i AD l t s̻ a AD
dabiltzala	d a AD b i AD l t s̻ a AD l a AD
dabilzke	d a AD b i AD l s̻ k e AD
dadila	d a AD d i AD ʎ a AD
dadin	d a AD d i AD ɲ
dagi	d a AD ɡ i AD
dagit	d a AD ɡ i AD t
dago	d a AD ɡ o AE
dagoela	d a AD ɡ o AE e AD l a AD
dagoke	d a AD ɡ o AE k e AD
dagonil	d a AD ɡ o AE n i AD ʎ
daiteke	d a AD i AD t e AD k e AD
daitez	d a AD i AD t e AD s̻
daitezela	d a AD i AD t e AD s̻ e AD l a AD
daitezke	d a AD i AD t e AD s̻ k e AD
daki	d a AD k i AD
dakik	d a AD k i AD k
dakin	d a AD k i AD n
dakit	d a AD k i AD t
daniera	d a AD n j AB e AD ɾ a AD
danimarka	d a AD n i AD m a AD r k a AD
darama	d a AD ɾ a AD m a AD
darik	d a AD ɾ i AD k
darin	d a AD ɾ i AD n
dator	d a AD t o AE r
datorke	d a AD t o AE r k e AD
datorrela	d a AD t o AE r e AD l a AD
datoz	d a AD t o AE s̻
datozela	d a AD t o AE s̻ e AD l a AD
datozke	d a AD t o AE s̻ k e AD
datxekie	d a AD t ʃ e AD k i AD e AD
datxekigu	d a AD t ʃ e AD k i AD ɡ u AE
datxekik	d a AD t ʃ e AD k i AD k
datxekin	d a AD t ʃ e AD k i AD n
datxekio	d a AD t ʃ e AD k i AD o AE
datxekit	d a AD t ʃ e AD k i AD t
datxekizu	d a AD t ʃ e AD k i AD s̻ u AE
datxekizue	d a AD t ʃ e AD k i AD s̻ u AE e AD
datxezkie	d a AD t ʃ e AD s̻ k i AD e AD
datxezkigu	d a AD t ʃ e AD s̻ k i AD ɡ u AE
datxezkik	d a AD t ʃ e AD s̻ k i AD k
datxezkin	d a AD t ʃ e AD s̻ k i AD n
datxezkio	d a AD t ʃ e AD s̻ k i AD o AE
datxezkit	d a AD t ʃ e AD s̻ k i AD t
datxezkizu	d a AD t ʃ e AD k i AD s̻ u AE
datxezkizue	d a AD t ʃ e AD s̻ k i AD s̻ u AE e AD
datza	d a AD t s̻ a AD
daude	d a AD u AE d e AD
daudeke	d a AD u AE d e AD k e AD
daudela	d a AD u AE d e AD l a AD
dautza	d a AD u AE t s̻ a AD
de	d e AD
deabru	d e AD a AD b r u AE
dei	d e AD i AD
deia	d e AD i AD a AD
deien	d e AD i AD e AD n
deira	d e AD i AD ɾ a AD
deiri	d e AD i AD ɾ i AD
deitara	d e AD i AD t a AD ɾ a AD
deitura	d e AD i AD t u AE ɾ a AD
deiz	d e AD i AD s̻
dira	d i AD ɾ a AD
doa	d o AE a AD
domeka	d o AE m e AD k a AD
donostia	d o AE n o AE s̺ t j AB a AD
dortoka	d o AE r t o AE k a AD
dromedario	d r o AE m e AD d a AD ɾ j AB o AE
e	e AD
ebiakoitz	e AD b i AD a AD k o AE i AD t s̻
edan	e AD d a AD n
edari	e AD d a AD ɾ i AD
eder	e AD d e AD r
edin	e AD d i AD n
eduki	e AD d u AE k i AD
edukiko	e AD d u AE k i AD k o AE
edukitze	e AD d u AE k i AD t s̪ e AD
edukitzen	e AD d u AE k i AD t s̻ e AD n
edun	e AD d u AE n
efe	e AD f e AD
egin	e AD ɡ i AD ɲ
egingo	e AD ɡ i AD n ɡ o AE
egitasmo	e AD ɡ i AD t a AD s̺ m o AE
egite	e AD ɡ i AD t e AD
egiten	e AD ɡ i AD t e AD n
egon	e AD ɡ o AE n
egongo	e AD ɡ o AE n ɡ o AE
egote	e AD ɡ o AE t e AD
egoten	e AD ɡ o AE t e AD n
eguazten	e AD ɡ u AE a AD s̻ t e AD n
egubakoitz	e AD ɡ u AE b a AD k o AE i AD t s̻
eguen	e AD ɡ u AE e AD n
egun	e AD ɡ u AE n
egur	e AD ɡ u AE r
eguzkitsu	e AD ɡ u AE s̻ k i AD t s̺ u AE
ehe	e AD h̃ AH e AD
ehiza	e AD ɦ AA i AD s̻ a AD
ekain	e AD k a AD i AD ɲ
ekaiztsu	e AD k a AD i AD s̻ t s̺ u AE
ekark	e AD k a AD r k
ekarna	e AD k a AD r n a AD
ekarri	e AD k a AD r i AD
ekialde	e AD k i AD a AD l d e AD
ele	e AD l e AD
elefante	e AD l e AD f a AD n t e AD
eliza	e AD l i AD s̻ a AD
elkar	e AD l k a AD r
elkarlan	e AD l k a AD ɾ l a AD n
elkarrekin	e AD l k a AD r e AD k i AD ɲ
eltxo	e AD l t ʃ o AE
emagaldu	e AD m a AD ɡ a AD l d u AE
eman	e AD m a AD n
eme	e AD m e AD
enara	e AD n a AD ɾ a AD
ene	e AD n e AD
enegan	e AD n e AD ɡ a AD n
enigmatiko	e AD n i AD ɡ m a AD t i AD k o AE
entzun	e AD n t s̻ u AE n
epail	e AD p a AD ʎ
eper	e AD p e AD r
erabili	e AD ɾ a AD b i AD ʎ i AD
erakutsi	e AD ɾ a AD k u AE t s̺ i AD
eraman	e AD ɾ a AD m a AD n
erbi	e AD r b i AD
erdara	e AD r d a AD ɾ a AD
erdi	e AD r d i AD
ereiaro	e AD ɾ e AD i AD a AD ɾ o AE
erion	e AD ɾ j AB o AE n
erlategi	e AD r l a AD t e AD ɡ i AD
erlauntza	e AD r l a AD u AE n t s̻ a AD
ermita	e AD r m i AD t a AD
erne	e AD r n e AD
eroan	e AD ɾ o AE a AD n
eroango	e AD ɾ o AE a AD n ɡ o AE
eroate	e AD ɾ o AE a AD t e AD
eroaten	e AD ɾ o AE a AD t e AD n
erori	e AD ɾ o AE ɾ i AD
eros	e AD ɾ o AE s̺
erosi	e AD ɾ o AE s̺ i AD
erosiek	e AD ɾ o AE s̺ i AD e AD k
erosien	e AD ɾ o AE s̺ i AD e AD n
erosiok	e AD ɾ o AE s̺ i AD o AE k
erosion	e AD ɾ o AE s̺ i AD o AE n
erostak	e AD ɾ o AE s̺ t a AD k
erostan	e AD ɾ o AE s̺ t a AD n
erran	e AD r a AD n
errauts	e AD r a AD u AE t s̺
erraz	e AD r a AD s̻
erre	e AD r e AD
erreferentzia	e AD r e AD f e AD ɾ e AD n t s̻ j AB a AD
erregina	e AD r e AD ɡ i AD ɲ a AD
errepide	e AD r e AD p i AD d e AD
errez	e AD r e AD s̻
errota	e AD r o AE t a AD
erru	e AD r u AE
errumania	e AD r u AE m a AD n i AD a AD
errumaniar	e AD r u AE m a AD n j AB a AD r
errumaniera	e AD r u AE m a AD n j AB e AD ɾ a AD
errusia	e AD r u AE s̺ j AB a AD
errusiar	e AD r u AE s̺ j AB a AD r
errusiera	e AD r u AE s̺ j AB e AD ɾ a AD
esan	e AD s̺ a AD n
ese	e AD s̺ e AD
esker	e AD s̺ k e AD r
eskozia	e AD s̺ k o AE s̻ j AB a AD
eskribitu	e AD s̺ k r i AD b i AD t u AE
esku	e AD s̺ k u AE
eskubila	e AD s̺ k u AE b i AD ʎ a AD
eslovakia	e AD s̺ l o AE b a AD k j AB a AD
eslovakiar	e AD s̺ l o AE b a AD k j AB a AD r
eslovakiera	e AD s̺ l o AE b a AD k j AB e AD ɾ a AD
eslovenia	e AD s̺ l o AE b e AD n j AB a AD
esloveniar	e AD s̺ l o AE b e AD n j AB a AD r
esloveniera	e AD s̺ l o AE b e AD n j AB e AD ɾ a AD
espainia	e AD s̺ p a AD ɲ j AB a AD
espainiar	e AD s̺ p a AD ɲ j AB a AD r
esperanto	e AD s̺ p e AD ɾ a AD n t o AE
espresuki	e AD s̺ p r e AD s̺ u AE k i AD
estonia	e AD s̺ t o AE n j AB a AD
estoniako	e AD s̺ t o AE n j AB a AD k o AE
estonian	e AD s̺ t o AE n j AB a AD n
estoniar	e AD s̺ t o AE n j AB a AD r
estoniera	e AD s̺ t o AE n j AB e AD ɾ a AD
estralurtar	e AD s̺ t r a AD l u AE r t a AD r
eta	e AD t a AD
eten	e AD t e AD n
etete	e AD t e AD t e AD
etor	e AD t o AE r
etorri	e AD t o AE r i AD
etorriko	e AD t o AE r i AD k o AE
etortze	e AD t o AE r t s̪ e AD
etortzen	e AD t o AE r t s̻ e AD n
etsai	e AD t s̺ a AD i AD
etxe	e AD t ʃ e AD
etzango	e AD t s̻ a AD n ɡ o AE
etzate	e AD t s̪ a AD t e AD
etzaten	e AD t s̻ a AD t e AD n
etzi	e AD t s̻ i AD
euli	e AD u AE l i AD
euskadi	e AD u AE s̺ k a AD d i AD
euskal	e AD u AE s̺ k a AD l
euskaldun	e AD u AE s̺ k a AD l d u AE n
euskaltegi	e AD w AC s̺ k a AD l t e AD ɡ i AD
euskara	e AD u AE s̺ k a AD ɾ a AD
euskera	e AD u AE s̺ k e AD ɾ a AD
euzkadi	e AD u AE s̻ k a AD d i AD
ez	e AD s̻
ezagut	e AD s̻ a AD ɡ u AE t
ezagutu	e AD s̻ a AD ɡ u AE t u AE
ezagutuko	e AD s̻ a AD ɡ u AE t u AE k o AE
ezagutze	e AD s̪ a AD ɡ u AE t s̪ e AD
ezagutzen	e AD s̻ a AD ɡ u AE t s̻ e AD n
ezker	e AD s̻ k e AD r
ezkerra	e AD s̻ k e AD r a AD
ezko	e AD s̻ k o AE
ezkongabe	e AD s̻ k o AE n ɡ a AD b e AD
ezkutatu	e AD s̻ k u AE t a AD t u AE
ezpel	e AD s̻ p e AD l
eztarri	e AD s̻ t a AD r i AD
ezti	e AD s̻ t i AD
eñe	e AD ɲ e AD
f	e AD f e AD
finlandia	f i AD n l a AD n d j AB a AD
finlandiar	f i AD n l a AD n d j AB a AD r
finlandiera	f i AD n l a AD n d j AB e AD ɾ a AD
flatulentzia	f l a AD t u AE l e AD n t s̻ j AB a AD
fluor	f l u AE o AE r
frantses	f r a AD n t s̺ e AD s̺
frantzia	f r a AD n t s̻ j AB a AD
frantziar	f r a AD n t s̻ j AB a AD r
g	ɡ e AD
gabiltza	ɡ a AD b i AD l t s̻ a AD
gabiltzan	ɡ a AD b i AD l t s̻ a AD n
gabilzke	ɡ a AD b i AD l s̻ k e AD
gai	ɡ a AD i AD
gailu	ɡ a AD ʎ u AE
gaitez	ɡ a AD i AD t e AD s̻
gaitezke	ɡ a AD i AD t e AD s̻ k e AD
gaizki	ɡ a AD i AD s̻ k i AD
gaizto	ɡ a AD i AD s̻ t o AE
galdu	ɡ a AD l d u AE
gales	ɡ a AD l e AD s̺
galesera	ɡ a AD l e AD s̺ e AD ɾ a AD
galiziar	ɡ a AD l i AD s̻ j AB a AD r
galtzairu	ɡ a AD l t s̻ a AD i AD ɾ u AE
galtzak	ɡ a AD l t s̻ a AD k
galtzarbe	ɡ a AD l t s̻ a AD r b e AD
galtzari	ɡ a AD l t s̻ a AD ɾ i AD
galtzerdi	ɡ a AD l t s̻ e AD r d i AD
galtzetin	ɡ a AD l t s̻ e AD t i AD ɲ
gamelu	ɡ a AD m e AD l u AE
gara	ɡ a AD ɾ a AD
garagar	ɡ a AD ɾ a AD ɡ a AD r
garagardo	ɡ a AD ɾ a AD ɡ a AD r d o AE
garagarril	ɡ a AD ɾ a AD ɡ a AD r i AD ʎ
garai	ɡ a AD ɾ a AD i AD
garbantzu	ɡ a AD r b a AD n t s̻ u AE
garesti	ɡ a AD ɾ e AD s̺ t i AD
garil	ɡ a AD ɾ i AD ʎ
gasteiz	ɡ a AD s̺ t e AD i AD s̻
gatazka	ɡ a AD t a AD s̻ k a AD
gatoz	ɡ a AD t o AE s̻
gatozen	ɡ a AD t o AE s̻ e AD n
gatozke	ɡ a AD t o AE s̻ k e AD
gatxezkie	ɡ a AD t ʃ e AD s̻ k i AD e AD
gatxezkik	ɡ a AD t ʃ e AD s̻ k i AD k
gatxezkin	ɡ a AD t ʃ e AD s̻ k i AD n
gatxezkio	ɡ a AD t ʃ e AD s̻ k i AD o AE
gatxezkizu	ɡ a AD t ʃ e AD s̻ k i AD s̻ u AE
gatxezkizue	ɡ a AD t ʃ e AD s̻ k i AD s̻ u AE e AD
gatz	ɡ a AD t s̻
gau	ɡ a AD u AE
gaude	ɡ a AD u AE d e AD
gaudeke	ɡ a AD u AE d e AD k e AD
gauden	ɡ a AD u AE d e AD n
gauenara	ɡ a AD u AE e AD n a AD ɾ a AD
gaupasa	ɡ a AD w AC p a AD s̺ a AD
gaur	ɡ a AD u AE r
gautza	ɡ a AD u AE t s̻ a AD
gauza	ɡ a AD u AE s̻ a AD
gazi	ɡ a AD s̻ i AD
gaztaina	ɡ a AD s̻ t a AD ɲ a AD
gazte	ɡ a AD s̻ t e AD
gaztela	ɡ a AD s̻ t e AD l a AD
gaztelania	ɡ a AD s̻ t e AD l a AD n i AD a AD
gaztelera	ɡ a AD s̻ t e AD l e AD ɾ a AD
ge	ɡ e AD
genbiltzan	ɡ e AD n b i AD l t s̻ a AD n
genbilzke	ɡ e AD n b i AD l s̻ k e AD
genbilzkeen	ɡ e AD n b i AD l s̻ k e AD e AD n
genkizkien	ɡ e AD n k i AD s̻ k i AD e AD n
genkizkion	ɡ e AD n k i AD s̻ k i AD o AE n
gentozen	ɡ e AD n t o AE s̻ e AD n
gentozke	ɡ e AD n t o AE s̻ k e AD
gentozkeen	ɡ e AD n t o AE s̻ k e AD e AD n
gentxezkiake	ɡ e AD n t ʃ e AD s̻ k i AD a AD k e AD
gentxezkian	ɡ e AD n t ʃ e AD s̻ k i AD a AD n
gentxezkieke	ɡ e AD n t ʃ e AD s̻ k i AD e AD k e AD
gentxezkien	ɡ e AD n t ʃ e AD s̻ k i AD e AD n
gentxezkinake	ɡ e AD n t ʃ e AD s̻ k i AD n a AD k e AD
gentxezkinan	ɡ e AD n t ʃ e AD s̻ k i AD n a AD n
gentxezkioke	ɡ e AD n t ʃ e AD s̻ k i AD o AE k e AD
gentxezkion	ɡ e AD n t ʃ e AD s̻ k i AD o AE n
gentxezkizueke	ɡ e AD n t ʃ e AD s̻ k i AD s̻ u AE e AD k e AD
gentxezkizuen	ɡ e AD n t ʃ e AD s̻ k i AD s̻ u AE e AD n
gentxezkizuke	ɡ e AD n t ʃ e AD s̻ k i AD s̻ u AE k e AD
gentxezkizun	ɡ e AD n t ʃ e AD s̻ k i AD s̻ u AE n
georgia	ɡ e AD o AE r ɡ j AB a AD
georgiar	ɡ e AD o AE r ɡ j AB a AD r
georgiera	ɡ e AD o AE r ɡ j AB e AD ɾ a AD
gerezi	ɡ e AD ɾ e AD s̻ i AD
gero	ɡ e AD ɾ o AE
gerra	ɡ e AD r a AD
geu	ɡ e AD u̯ AC
geundeke	ɡ e AD u AE n d e AD k e AD
geundekeen	ɡ e AD u AE n d e AD k e AD e AD n
geunden	ɡ e AD u AE n d e AD n
geuntzake	ɡ e AD u AE n t s̻ a AD k e AD
geuntzan	ɡ e AD u AE n t s̻ a AD n
geure	ɡ e AD w AC ɾ e AD
gezi	ɡ e AD s̻ i AD
ghana	ɡ a AD n a AD
ghanan	ɡ a AD n a AD n
gibel	ɡ i AD b e AD l
giltza	ɡ i AD l t s̻ a AD
giltzurrun	ɡ i AD l t s̻ u AE r u AE n
ginen	ɡ i AD ɲ e AD n
gintezen	ɡ i AD n t e AD s̻ e AD n
gintezke	ɡ i AD n t e AD s̻ k e AD
gintezkeen	ɡ i AD n t e AD s̻ k e AD e AD n
gipuzkoa	ɡ i AD p u AE s̻ k o AE a AD
gipuzkoan	ɡ i AD p u AE s̻ k o AE a AD n
gizon	ɡ i AD s̻ o AE n
goaz	ɡ o AE a AD s̻
gogo	ɡ o AE ɡ o AE
gontz	ɡ o AE n t s̻
gora	ɡ o AE ɾ a AD
gorotzil	ɡ o AE ɾ o AE t s̻ i AD ʎ
gorri	ɡ o AE r i AD
gorrimin	ɡ o AE r i AD m i AD ɲ
gorrimotel	ɡ o AE r i AD m o AE t e AD l
gorringo	ɡ o AE r i AD n ɡ o AE
gosaldu	ɡ o AE s̺ a AD l d u AE
gozo	ɡ o AE s̻ o AE
grezia	ɡ r e AD s̻ j AB a AD
gris	ɡ r i AD s̺
gu	ɡ u AE
guda	ɡ u AE d a AD
guk	ɡ u AE k
gune	ɡ u AE n e AD
guneka	ɡ u AE n e AD k a AD
gurdi	ɡ u AE r d i AD
gure	ɡ u AE ɾ e AD
guri	ɡ u AE ɾ i AD
gurpil	ɡ u AE r p i AD ʎ
h	h AA a AD t ʃ e AD
habe	h AA a AD b e AD
habil	h AA a AD b i AD l
habilke	h AA a AD b i AD l k e AD
hadi	h AA a AD d i AD
hadin	h AA a AD d i AD n
hago	h AA a AD ɡ o AE
hagoke	h AA a AD ɡ o AE k e AD
haiei	h AA a AD j AB e AD i AD
haiek	h AA a AD j AB e AD k
haien	h AA a AD j AB e AD n
haiteke	h AA a AD j AB t e AD k e AD
haitz	ɦ AA a AD i AD t s̻
haiz	h AA a AD j AB s̪
hakar	h AA a AD k a AD ɾ
hakien	h AA a AD k i AD e AD n
hala	ɦ AA a AD l a AD
hamabi	h AA a AD m a AD b i AD
hamabost	h AA a AD m a AD b o AE s̺ t
hamaika	h AA a AD m a AD i AD k a AD
hamairu	h AA a AD m a AD i AD ɾ u AE
hamalau	h AA a AD m a AD l a AD u AE
hamar	h AA a AD m a AD r
haren	h AA a AD ɾ e AD n
hari	h AA a AD ɾ i AD
haritz	h AA a AD ɾ i AD t s̻
haritzezko	ɦ AA a AD ɾ i AD t s̻ e AD s̻ k o AE
harizki	h AA a AD r i AD s k i AD
hark	h AA a AD r k
harri	ɦ AA a AD r i AD
hartan	h AA a AD r t a AD n
hartara	h AA a AD r t a AD ɾ a AD
hartarat	h AA a AD r t a AD ɾ a AD t
hartz	ɦ AA a AD r t s̻
hator	h AA a AD t o AE ɾ
hatorke	h AA a AD t o AE r k e AD
hatxe	h AA a AD t ʃ e AD
hatxekie	h AA a AD t ʃ e AD k i AD e AD
hatxekigu	h AA a AD t ʃ e AD k i AD ɡ u AE
hatxekio	h AA a AD t ʃ e AD k i AD o AE
hatxekit	h AA a AD t ʃ e AD k i AD t
hatza	h AA a AD t s̪ a AD
hau	h AA a AD w AC
hauei	h AA a AD w AC e AD i AD
hauek	h AA a AD w AC e AD k
hauen	h AA a AD w AC e AD n
hauka	h AA a AD w AC k a AD
haukat	h AA a AD w AC k a AD t
hazil	a AD s̺ i AD l
hebreera	ɦ AA e AD b r e AD e AD ɾ a AD
hegal	ɦ AA e AD ɡ a AD l
hego	ɦ AA e AD ɡ o AE
helio	h AA e AD l j AB o AE
hemen	ɦ AA e AD m e AD n
henbilen	h AA e AD n b i AD ʎ e AD n
henbilke	h AA e AD n b i AD l k e AD
henbilkeen	h AA e AD n b i AD l k e AD e AD n
hendin	h AA e AD n d i AD n
hengoen	h AA e AD n ɡ o AE e AD n
hengoke	h AA e AD n ɡ o AE k e AD
hengokeen	h AA e AD n ɡ o AE k e AD e AD n
henkien	h AA e AD n k i AD e AD n
henkion	h AA e AD n k i AD o AE n
hentorke	h AA e AD n t o AE r k e AD
hentorkeen	h AA e AD n t o AE r k e AD
hentorren	h AA e AD n t o AE r e AD n
hentxekidake	h AA e AD n t ʃ e AD k i AD d a AD k e AD
hentxekidan	h AA e AD n t ʃ e AD k i AD d a AD n
hentxekieke	h AA e AD n t ʃ e AD k i AD e AD k e AD
hentxekien	h AA e AD n t ʃ e AD k i AD e AD n
hentxekiguke	h AA e AD n t ʃ e AD k i AD ɡ u AE k e AD
hentxekigun	h AA e AD n t ʃ e AD k i AD ɡ u AE n
hentxekioke	h AA e AD n t ʃ e AD k i AD o AE k e AD
hentxekion	h AA e AD n t ʃ e AD k i AD o AE n
hentzake	h AA e AD n t s̪ a AD k e AD
hentzan	h AA e AD n t s̪ a AD n
heren	h AA e AD ɾ e AD n
herenegun	ɦ AA e AD ɾ e AD n e AD ɡ u AE n
heroan	h AA e AD ɾ o AE a AD n
herri	h AA e AD r i AD
heu	h AA e AD u̯ AC
heuk	h AA e AD w AC k
heure	h AA e AD w AC ɾ e AD
hezur	ɦ AA e AD s̻ u AE r
hezurdura	ɦ AA e AD s̻ u AE r d u AE ɾ a AD
hezurtegi	ɦ AA e AD s̻ u AE r t e AD ɡ i AD
hi	i AD
hidrogeno	i AD d r o AE x e AD n o AE
hiena	ɦ AA j AB e AD n a AD
higan	i AD ɡ a AD n
hik	i AD k
hil	ɦ AA i AD ʎ
hinteke	i AD n t e AD k e AD
hintekeen	i AD n t e AD k e AD e AD n
hire	i AD ɾ e AD
hiregan	i AD ɾ e AD ɡ a AD n
hiri	i AD ɾ i AD
hirigintza	ɦ AA i AD ɾ i AD ɡ i AD n t s̻ a AD
hiru	ɦ AA i AD ɾ u AE
hirugarren	i AD ɾ u AE ɡ a AD r e AD n
hirukoitz	i AD ɾ u AE k o AE i AD t s̻
hitan	i AD t a AD n
hoa	o AE a AD
hodei	ɦ AA o AE d e AD i AD
hogei	ɦ AA o AE ɡ e AD i AD
honek	o AE n e AD k
honen	o AE n e AD n
honi	o AE n i AD
hori	o AE ɾ i AD
horrek	o AE r e AD k
horren	o AE r e AD n
horri	o AE r i AD
hostaro	o AE s t a AD ɾ o AE
hots	ɦ AA o AE t s̺
hotz	o AE t s̻
hozkailu	o AE s̻ k a AD ʎ u AE
hungaria	ɦ AA u AE n ɡ a AD ɾ j AB a AD
hungariako	ɦ AA u AE n ɡ a AD ɾ j AB a AD k o AE
hungarian	ɦ AA u AE n ɡ a AD ɾ j AB a AD n
hungariar	ɦ AA u AE n ɡ a AD ɾ j AB a AD r
hungariera	ɦ AA u AE n ɡ a AD ɾ j AB e AD ɾ a AD
hur	ɦ AA u AE r
hura	u AE ɾ a AD
huts	u AE t s̺
hutsik	ɦ AA u AE t s̺ i AD k
i	i AD
ia	i AD a AD
iaz	i AD a AD s̻
ibai	i AD b a AD i AD
ibili	i AD b i AD ʎ i AD
idatzi	i AD d a AD t s̻ i AD
idazle	i AD d a AD s̻ l e AD
ido	i AD d o AE
igande	i AD ɡ a AD n d e AD
igaz	i AD ɡ a AD s̻
igel	i AD ɡ e AD l
igo	i AD ɡ o AE
igorri	i AD ɡ o AE r i AD
iharduki	i AD ɦ AA a AD r d u AE k i AD
ikasgai	i AD k a AD s̺ ɡ a AD i AD
ikasi	i AD k a AD s̺ i AD
ikatz	i AD k a AD t s̻
iker	i AD k e AD r
ikertu	i AD k e AD r t u AE
ikus	i AD k u AE s̺
ikusi	i AD k u AE s̺ i AD
ikusiko	i AD k u AE s̺ i AD k o AE
ikuste	i AD k u AE s̺ t e AD
ikusten	i AD k u AE s̺ t e AD n
ilargi	i AD ʎ a AD r ɡ i AD
ilbeltz	i AD l b e AD l t s̻
ilen	i AD ʎ e AD n
independentzia	i AD n d e AD p e AD n d e AD n t s̻ j AB a AD
indonesiera	i AD n d o AE n e AD s̺ j AB e AD ɾ a AD
ingalaterra	i AD n ɡ a AD l a AD t e AD r a AD
ingelera	i AD n ɡ e AD l e AD ɾ a AD
ingeles	i AD n ɡ e AD l e AD s̺
internazional	i AD n t e AD r n a AD s̻ j AB o AE n a AD l
intsektu	i AD n t s̺ e AD k t u AE
intxaur	i AD n t ʃ a AD u AE r
inurri	i AD ɲ u AE r i AD
ipar	i AD p a AD r
irail	i AD ɾ a AD ʎ
irakatsi	i AD ɾ a AD k a AD t s̺ i AD
irakin	i AD ɾ a AD k i AD ɲ
irakurri	i AD ɾ a AD k u AE r i AD
iraun	i AD ɾ a AD u AE n
iritzi	i AD ɾ i AD t s̻ i AD
irla	i AD r l a AD
irlanda	i AD r l a AD n d a AD
irudi	i AD ɾ u AE d i AD
irudiko	i AD ɾ u AE d i AD k o AE
iruña	i AD ɾ u AE ɲ a AD
iruñea	i AD ɾ u AE ɲ e AD a AD
islandia	i AD s̺ l a AD n d j AB a AD
islandiar	i AD s̺ l a AD n d j AB a AD r
islandiera	i AD s̺ l a AD n d j AB e AD ɾ a AD
ispilu	i AD s̺ p i AD ʎ u AE
italia	i AD t a AD l j AB a AD
italian	i AD t a AD l j AB a AD n
italiar	i AD t a AD l j AB a AD r
italiera	i AD t a AD l j AB e AD ɾ a AD
ito	i AD t o AE
itsu	i AD t s̺ u AE
itsusi	i AD t s̺ u AE s̺ i AD
iturri	i AD t u AE r i AD
itzuli	i AD t s̻ u AE l i AD
itzultzaile	i AD t s̻ u AE l t s̻ a AD ʎ e AD
ixa	i AD ʃ a AD
izan	i AD s̻ a AD n
izeba	i AD s̻ e AD b a AD
izeko	i AD s̻ e AD k o AE
izen	i AD s e AD n
izokin	i AD s̻ o AE k i AD ɲ
izotz	i AD s̻ o AE t s̻
izotzil	i AD s̻ o AE t s̻ i AD ʎ
izurde	i AD s̻ u AE r d e AD
jakin	ʒ a AD k i AD n
jan	x a AD n
janari	x a AD n a AD ɾ i AD
japonia	x a AD p o AE n j AB a AD
japoniera	x a AD p o AE n j AB e AD ɾ a AD
jardun	ʒ a AD r d u AE n
jarraiki	ʒ a AD r a AD j AB t e AD
joan	x o AE a AD n
jokatu	x o AE k a AD t u AE
jorrail	ʝ o AE r a AD ʎ
jugoslavia	j AB u AE ɡ o AE s̺ l a AD b j AB a AD
jugoslavian	j AB u AE ɡ o AE s̺ l a AD b j AB a AD n
k	k a AD
ka	k a AD
kaixo	k a AD j AB ʃ̺ o AE
kako	k a AD k o AE
kamerun	k a AD m e AD ɾ u AE n
kameu	k a AD m e AD u AE
kanpai	k a AD m p a AD i AD
karbono	k a AD r b o AE n o AE
karlistada	k a AD r l i AD s̺ t a AD d a AD
karlistaldi	k a AD r l i AD s̺ t a AD l d i AD
karmele	k a AD r m e AD l e AD
katagorri	k a AD t a AD ɡ o AE r i AD
kate	k a AD t e AD
katu	k a AD t u AE
kazakhera	k a AD s̻ a AD x e AD ɾ a AD
kazakhstan	k a AD s̻ a AD x s̺ t a AD n
ke	k e AD
kemen	k e AD m e AD n
ketsu	k e AD t s̺ u AE
kirol	k i AD ɾ o AE l
kirolari	k i AD ɾ o AE l a AD ɾ i AD
kiroldegi	k i AD ɾ o AE l d e AD ɡ i AD
koaderno	k w AC a AD d e AD r n o AE
kobre	k o AE b r e AD
koronabirus	k o AE ɾ o AE n a AD b i AD ɾ u AE s̺
korsikera	k o AE r s̺ i AD k e AD ɾ a AD
koru	k o AE ɾ u AE
kroazia	k r o AE a AD s̻ j AB a AD
kroaziar	k r o AE a AD s̻ j AB a AD r
kroaziera	k r o AE a AD s̻ j AB e AD ɾ a AD
ku	k u AE
kukutxeztul	k u AE k u AE t ʃ e AD s̺ t u AE l
l	e AD l e AD
labar	l a AD b a AD r
labe	l a AD b e AD
labezomorro	l a AD b e AD s̻ o AE m o AE r o AE
labezomorroa	l a AD b e AD s̪ o AE m o AE r o AE a AD
labezomorroak	l a AD b e AD s̪ o AE m o AE r o AE a AD k
labezomorroarenganantz	l a AD b e AD s̪ o AE m o AE r o AE a AD ɾ e AD n ɡ a AD n a AD n t s̪
labezomorroek	l a AD b e AD s̺ o AE m o AE r o AE e AD k
labezomorroenganantz	l a AD b e AD s̪ o AE m o AE r o AE e AD n ɡ a AD n a AD n t s̪
labezomorrok	l a AD b e AD s̪ o AE m o AE r o AE k
labezomorrorenganako	l a AD b e AD s̪ o AE m o AE r o AE ɾ e AD n ɡ a AD n a AD k o AE
labezomorrorenganantz	l a AD b e AD s̪ o AE m o AE r o AE ɾ e AD n ɡ a AD n a AD n t s̪
labezomorrorengandik	l a AD b e AD s̪ o AE m o AE r o AE ɾ e AD n ɡ a AD n d i AD k
labezomorrorik	l a AD b e AD s̪ o AE m o AE r o AE ɾ i AD k
labezomorrotzat	l a AD b e AD s̪ o AE m o AE r o AE t s̪ a AD t
labur	l a AD b u AE r
laga	l a AD ɡ a AD
lagun	l a AD ɡ u AE n
lagundu	l a AD ɡ u AE n d u AE
laino	l a AD ɲ o AE
lari	l a AD ɾ i AD
larunbat	l a AD ɾ u AE n b a AD t
lastail	l a AD s t a AD ʎ
laster	l a AD s̺ t e AD r
lau	l a AD u AE
lauburu	l a AD u AE b u AE ɾ u AE
laugarren	l a AD u AE ɡ a AD r e AD n
laukoitz	l a AD u AE k o AE i AD t s̻
laurden	l a AD u AE r d e AD n
lebilke	l e AD b i AD l k e AD
lebilzke	l e AD b i AD l s̪ k e AD
legoke	l e AD ɡ o AE k e AD
lehen	l e AD h AA e AD n
lehendakari	l e AD ɦ AA e AD n d a AD k a AD ɾ i AD
lera	l e AD ɾ a AD
lerak	l e AD ɾ a AD k
leraren	l e AD ɾ a AD ɾ e AD n
lerari	l e AD ɾ a AD ɾ i AD
lerei	l e AD ɾ e AD i AD
lerek	l e AD ɾ e AD k
letonia	l e AD t o AE n j AB a AD
letoniera	l e AD t o AE n j AB e AD ɾ a AD
letorke	l e AD t o AE r k e AD
letozke	l e AD t o AE s̪ k e AD
letxekiake	l e AD t ʃ e AD k i AD a AD k e AD
letxekidake	l e AD t ʃ e AD k i AD d a AD k e AD
letxekieke	l e AD t ʃ e AD k i AD e AD k e AD
letxekiguke	l e AD t ʃ e AD k i AD ɡ u AE k e AD
letxekinake	l e AD t ʃ e AD k i AD n a AD k e AD
letxekioke	l e AD t ʃ e AD k i AD o AE k e AD
letxekizueke	l e AD t ʃ e AD k i AD s̪ u AE e AD k e AD
letxekizuke	l e AD t ʃ e AD k i AD s̪ u AE k e AD
letxezkiake	l e AD t ʃ e AD s̪ k i AD a AD k e AD
letxezkidake	l e AD t ʃ e AD s̪ k i AD d a AD k e AD
letxezkieke	l e AD t ʃ e AD s̪ k i AD e AD k e AD
letxezkiguke	l e AD t ʃ e AD s̪ k i AD ɡ u AE k e AD
letxezkinake	l e AD t ʃ e AD s̪ k i AD n a AD k e AD
letxezkioke	l e AD t ʃ e AD s̪ k i AD o AE k e AD
letxezkizueke	l e AD t ʃ e AD s̪ k i AD s̪ u AE e AD k e AD
letxezkizuke	l e AD t ʃ e AD s̪ k i AD s̪ u AE k e AD
letzake	l e AD t s̪ a AD k e AD
leudeke	l e AD w AC d e AD k e AD
leutzake	l e AD w AC t s̪ a AD k e AD
lipschitzar	l i AD p ʃ i AD t s̻ j AB a AD r
liteke	l i AD t e AD k e AD
litezke	l i AD t e AD s̪ k e AD
litio	l i AD t j AB o AE
lituania	l i AD t w AC a AD n j AB a AD
lituaniera	l i AD t w AC a AD n j AB e AD ɾ a AD
lizar	l i AD s a AD r
lizarki	l i AD s a AD r k i AD
lorail	l o AE ɾ a AD ʎ
lotazil	l o AE t a AD s̻ i AD l
lotu	l o AE t u AE
lur	l u AE r
lurra	l u AE r a AD
luze	l u AE s̻ e AD
m	e AD m e AD
madril	m a AD d r i AD ʎ
maiatz	m a AD i AD a AD t s̻
maitatu	m a AD i AD t a AD t u AE
makaronesia	m a AD k a AD ɾ o AE n e AD s̺ j AB a AD
maltera	m a AD l t e AD ɾ a AD
mapa	m a AD p a AD
marasma	m a AD ɾ a AD s m a AD
maroko	m a AD ɾ o AE k o AE
marroi	m a AD r o AE i AD
marti	m a AD r t i AD
martitzen	m a AD r t i AD t s̻ e AD n
martxo	m a AD r t ʃ o AE
mazedoniera	m a AD s̻ e AD d o AE n j AB e AD ɾ a AD
mendebal	m e AD n d e AD b a AD l
mendi	m e AD n d i AD
merkatu	m e AD r k a AD t u AE
merkatü	m e AD r k a AD t y AE
merkhatü	m e AD r kʰ a AD t y AE
mesede	m e AD s̺ e AD d e AD
mesedez	m e AD s̺ e AD d e AD s̻
milesker	m i AD ʎ e AD s̺ k e AD r
mintzatu	m i AD n t s̻ a AD t u AE
misantropo	m i AD s a AD n t r o AE p o AE
moldavia	m o AE l d a AD b j AB a AD
moldavian	m o AE l d a AD b j AB a AD n
mongoliera	m o AE n ɡ o AE l j AB e AD ɾ a AD
motz	m o AE t s̻
mutil	m u AE t i AD ʎ
n	e AD n e AD
nabil	n a AD b i AD l
nabilen	n a AD b i AD ʎ e AD n
nabilke	n a AD b i AD l k e AD
nadin	n a AD d i AD n
nago	n a AD ɡ o AE
nagoen	n a AD ɡ o AE e AD n
nagoke	n a AD ɡ o AE k e AD
naiteke	n a AD j AB t e AD k e AD
naiz	n a AD i AD s̻
naizateke	n a AD i AD s̻ a AD t e AD k e AD
nakar	n a AD k a AD ɾ
nakie	n a AD k i AD e AD
naski	n a AD s̺ k i AD
nator	n a AD t o AE ɾ
natorke	n a AD t o AE r k e AD
natorkio	n a AD t o AE r k i AD o AE
natorkioke	n a AD t o AE r k i AD o AE k e AD
natorkion	n a AD t o AE r k i AD o AE n
natorren	n a AD t o AE r e AD n
natxekie	n a AD t ʃ e AD k i AD e AD
natxekik	n a AD t ʃ e AD k i AD k
natxekin	n a AD t ʃ e AD k i AD n
natxekio	n a AD t ʃ e AD k i AD o AE
natxekizu	n a AD t ʃ e AD k i AD s̪ u AE
natxekizue	n a AD t ʃ e AD k i AD s̪ u AE e AD
natza	n a AD t s̪ a AD
nauka	n a AD w AC k a AD
nederlandera	n e AD d e AD r l a AD n d e AD ɾ a AD
neguil	n e AD ɡ u AE i AD ʎ
nekatu	n e AD k a AD t u AE
nenbilen	n e AD n b i AD ʎ e AD n
nenbilke	n e AD n b i AD l k e AD
nenbilkeen	n e AD n b i AD l k e AD e AD n
nendin	n e AD n d i AD n
nengoen	n e AD n ɡ o AE e AD n
nengoke	n e AD n ɡ o AE k e AD
nengokeen	n e AD n ɡ o AE k e AD e AD n
nenkien	n e AD n k i AD e AD n
nenkion	n e AD n k i AD o AE n
nentorke	n e AD n t o AE r k e AD
nentorkeen	n e AD n t o AE r k e AD e AD n
nentorkioke	n e AD n t o AE r k i AD o AE k e AD
nentorkiokeen	n e AD n t o AE r k i AD o AE k e AD e AD n
nentorkion	n e AD n t o AE r k i AD o AE n
nentorren	n e AD n t o AE r e AD n
nentxekiake	n e AD n t ʃ e AD k i AD a AD k e AD
nentxekian	n e AD n t ʃ e AD k i AD a AD n
nentxekieke	n e AD n t ʃ e AD k i AD e AD k e AD
nentxekien	n e AD n t ʃ e AD k i AD e AD n
nentxekinake	n e AD n t ʃ e AD k i AD n a AD k e AD
nentxekinan	n e AD n t ʃ e AD k i AD n a AD n
nentxekioke	n e AD n t ʃ e AD k i AD o AE k e AD
nentxekion	n a AD t ʃ e AD k i AD o AE n
nentxekizueke	n e AD n t ʃ e AD k i AD s̪ u AE e AD k e AD
nentxekizuen	n e AD n t ʃ e AD k i AD s̪ u AE e AD n
nentxekizuke	n e AD n t ʃ e AD k i AD s̪ u AE k e AD
nentxekizun	n e AD n t ʃ e AD k i AD s̪ u AE n
nentzake	n e AD n t s̪ a AD k e AD
nentzan	n e AD n t s̪ a AD n
neon	n e AD o AE n
neska	n e AD s̺ k a AD
neskenegun	n e AD s k e AD n e AD ɡ u AE n
neu	n e AD u̯ AC
neuk	n e AD w AC k
neurri	n e AD u AE r i AD
ni	n i AD
nigan	n i AD ɡ a AD n
nik	n i AD k
ninteke	n i AD n t e AD k e AD
nintekeen	n i AD n t e AD k e AD e AD n
nintzateke	n i AD n t s̻ a AD t e AD k e AD
nintzatekeen	n i AD n t s̻ a AD t e AD k e AD e AD n
nintzen	n i AD n t s̻ e AD n
nire	n i AD ɾ e AD
niregan	n i AD ɾ e AD ɡ a AD n
nitan	n i AD t a AD n
nitrogeno	n i AD t r o AE x e AD n o AE
noa	n o AE a AD
nola	n o AE l a AD
non	n o AE n
nor	n o AE r
nora	n o AE ɾ a AD
nori	n o AE ɾ i AD
nork	n o AE r k
nortzuk	n o AE r t s̪ u AE k
norvegia	n o AE r b e AD ɡ j AB a AD
norvegiera	n o AE r b e AD ɡ j AB e AD ɾ a AD
o	o AE
oheratu	o AE ɦ AA e AD ɾ a AD t u AE
oilaur	o AE ʎ a AD u AE r
oin	o AE ɲ
oinarri	o AE ɲ a AD r i AD
oka	o AE k a AD
okin	o AE k i AD ɲ
okzitaniera	o AE k s̻ i AD t a AD n j AB e AD ɾ a AD
olerkari	o AE l e AD r k a AD ɾ i AD
olerkaritza	o AE l e AD r k a AD ɾ i AD t s̪ a AD
olerki	o AE l e AD r k i AD
on	o AE n
ondo	o AE n d o AE
onil	o AE n i AD ʎ
ontzi	o AE n t s̻ i AD
ordenatu	o AE r d e AD n a AD t u AE
ordots	o AE r d o AE t s̺
orein	o AE ɾ e AD ɲ
oreka	o AE ɾ e AD k a AD
orri	o AE r i AD
orril	o AE r i AD ʎ
ortzegun	o AE r t s̻ e AD ɡ u AE n
ortzi	o AE r t s̻ i AD
ortzirale	o AE r t s̻ i AD ɾ a AD l e AD
osaba	o AE s̺ a AD b a AD
ostegun	o AE s̺ t e AD ɡ u AE n
ostiral	o AE s̺ t i AD ɾ a AD l
otsail	o AE t s̺ a AD ʎ
otso	o AE t s̺ o AE
oxigeno	o AE k s̺ i AD x e AD n o AE
ozpin	o AE s̻ p i AD ɲ
oztin	o AE s̻ t i AD ɲ
oñati	o AE ɲ a AD t i AD
p	p e AD
pago	p a AD ɡ o AE
pandemia	p a AD n d e AD m j AB a AD
patata	p a AD t a AD t a AD
patxaran	p a AD t ʃ a AD ɾ a AD n
pauso	p a AD u AE s̺ o AE
pe	p e AD
penintsula	p e AD n i AD n t s̺ u AE l a AD
pintxo	p i AD n t ʃ o AE
piraña	p i AD ɾ a AD ɲ a AD
piztu	p i AD s̻ t u AE
poeta	p o AE e AD t a AD
polen	p o AE l e AD n
polit	p o AE l i AD t
politikari	p o AE l i AD t i AD k a AD ɾ i AD
polje	p o AE ʎ e AD
polonia	p o AE l o AE n j AB a AD
polonian	p o AE l o AE n j AB a AD n
poloniera	p o AE l o AE n j AB e AD ɾ a AD
portugalera	p o AE r t u AE ɡ a AD l e AD ɾ a AD
portuges	p o AE r t u AE ɡ e AD s̺
potasio	p o AE t a AD s̺ j AB o AE
pozoi	p o AE s̻ o AE i AD
pozoidun	p o AE s̻ o AE i AD d u AE n
pozoidura	p o AE s̻ o AE i AD d u AE ɾ a AD
pozoitasun	p o AE s̻ o AE i AD t a AD s̺ u AE n
pozoitsu	p o AE s̻ o AE i AD t s̺ u AE
pozoitu	p o AE s̻ o AE i AD t u AE
q	k u AE
r	e AD r e AD
rabbi	r a AD b i AD
s	e AD s̺ e AD
sagar	s̺ a AD ɡ a AD r
sagardo	s̺ a AD ɡ a AD r d o AE
sagarrondo	s̺ a AD ɡ a AD r o AE n d o AE
saguzar	s̺ a AD ɡ u AE s̻ a AD r
saldu	s̺ a AD l d u AE
sartalde	s̺ a AD r t a AD l d e AD
sartu	s̺ a AD r t u AE
satan	s̺ a AD t a AD n
sator	s̺ a AD t o AE r
sei	s̺ e AD i AD
seigarren	s̺ e AD i AD ɡ a AD r e AD n
seikoitz	s̺ e AD i AD k o AE i AD t s̻
sein	s̺ e AD i̯ AB ɲ
seiren	s̺ e AD i AD ɾ e AD n
sekretu	s̺ e AD k r e AD t u AE
seme	s̺ e AD m e AD
serbia	s̺ e AD r b j AB a AD
serbiera	s̺ e AD r b j AB e AD ɾ a AD
serbokroaziera	s̺ e AD r b o AE k r o AE a AD s̻ j AB e AD ɾ a AD
setemere	s e AD t e AD m e AD ɾ e AD
siziliera	s̺ i AD s̻ i AD l j AB e AD ɾ a AD
soin	s̺ o AE ɲ
somaliera	s̺ o AE m a AD l j AB e AD ɾ a AD
sorgin	s̺ o AE r ɡ i AD ɲ
sortalde	s̺ o AE r t a AD l d e AD
suedia	s̺ w AC e AD d j AB a AD
suediera	s̺ w AC e AD d j AB e AD ɾ a AD
sufre	s̺ u AE f ɾ e AD
suitza	s̺ w AC i AD t s̻ a AD
t	t e AD
taberna	t a AD b e AD r n a AD
tailandiera	t a AD i AD l a AD n d j AB e AD ɾ a AD
tarte	t a AD r t e AD
tarteka	t a AD r t e AD k a AD
tatami	t a AD t a AD m i AD
tauromakia	t a AD u AE ɾ o AE m a AD k j AB a AD
te	t e AD
telezabor	t e AD l e AD s̻ a AD b o AE r
tigre	t i AD ɡ r e AD
tigrea	t i AD ɡ r e AD a AD
tigreari	t i AD ɡ r e AD a AD ɾ i AD
tigrez	t i AD ɡ r e AD s̻
tipula	t i AD p u AE l a AD
tobera	t o AE b e AD ɾ a AD
toki	t o AE k i AD
tunisia	t u AE n i AD s̺ j AB a AD
tunisian	t u AE n i AD s̺ j AB a AD n
turkia	t u AE r k i AD a AD
turkiera	t u AE r k i AD e AD ɾ a AD
txakaviera	t ʃ a AD k a AD b j AB e AD ɾ a AD
txakur	t ʃ a AD k u AE r
txakurkume	t ʃ a AD k u AE r k u AE m e AD
txapel	t ʃ a AD p e AD l
txekiera	t ʃ e AD k j AB e AD ɾ a AD
txerri	t ʃ e AD r i AD
txetnik	t ʃ e AD t n i AD k
tximino	t ʃ i AD m i AD ɲ o AE
txina	t ʃ i AD n a AD
txinera	t ʃ i AD n e AD ɾ a AD
txingurri	t ʃ i AD n ɡ u AE r i AD
txirrin	t ʃ i AD r i AD ɲ
txirrindu	t ʃ i AD r i AD n d u AE
txirrindulari	t ʃ i AD r i AD n d u AE l a AD ɾ i AD
txirrindularitza	t ʃ i AD r i AD n d u AE l a AD ɾ i AD t s̻ a AD
txori	t ʃ o AE ɾ i AD
u	u AE
uda	u AE d a AD
udaberri	u AE d a AD b e AD r i AD
udal	u AE d a AD l
udaletxe	u AE d a AD l e AD t ʃ e AD
udazken	u AE d a AD s̻ k e AD n
ugaztun	u AE ɡ a AD s̻ t u AE n
uharte	u AE ɦ AA a AD r t e AD
uhartedi	u AE h AA a AD r t e AD d i AD
uhartegi	u AE h AA a AD r t e AD ɡ i AD
ukondo	u AE k o AE n d o AE
ukraina	u AE k r a AD i AD n a AD
ukrainan	u AE k r a AD i AD n a AD n
ukrainera	u AE k r a AD i AD n e AD ɾ a AD
ulertu	u AE l e AD r t u AE
unai	u AE n a AD i AD
untxi	u AE n t ʃ i AD
ur	u AE r
urde	u AE r d e AD
urdin	u AE r d i AD ɲ
urre	u AE r e AD
urri	u AE r i AD
urrieta	u AE r i AD e AD t a AD
urril	u AE r i AD ʎ
urtaro	u AE r t a AD ɾ o AE
urtarril	u AE r t a AD r i AD ʎ
urte	u AE r t e AD
urthe	u AE r tʰ e AD
urtxintxa	u AE r t ʃ i AD n t ʃ a AD
usategi	u AE s̺ a AD t e AD ɡ i AD
uso	u AE s̺ o AE
usteldu	u AE s̺ t e AD l d u AE
utz	u AE t s̪
utzi	u AE t s̻ i AD
uve	u AE b e AD
uzbekera	u AE s̻ b e AD k e AD ɾ a AD
uzta	u AE s̻ t a AD
uztail	u AE s̻ t a AD ʎ
uñhu	u AE ɲ ɦ AA ũ
v	u AE b e AD
vietnamera	b j AB e AD t n a AD m e AD ɾ a AD
x	i AD ʃ a AD
xabier	ʃ a AD β j AB e AD r
xaboi	ʃ a AD b o AE i AD
xake	ʃ a AD k e AD
xakelari	ʃ a AD k e AD l a AD ɾ i AD
xanpu	ʃ a AD m p u AE
xurgagailu	ʃ u AE r ɡ a AD ɡ a AD ʎ u AE
yarda	ʎ a AD r d a AD
z	s̻ e AD t a AD
zabiltza	s̪ a AD b i AD l t s̪ a AD
zabiltzate	s̪ a AD b i AD l t s̪ a AD t e AD
zabilzke	s̪ a AD b i AD l s̪ k e AD
zabilzkete	s̪ a AD b i AD l s̪ k e AD t e AD
zahar	s̻ a AD ɦ AA a AD r
zahi	s̻ a AD ɦ AA i AD
zaitez	s̪ a AD j AB t e AD s̪
zaitezke	s̪ a AD j AB t e AD s̪ k e AD
zaitezkete	s̪ a AD j AB t e AD s̪ k e AD t e AD
zaitezte	s̪ a AD j AB t e AD s̪ t e AD
zaldi	s̻ a AD l d i AD
zamari	s̻ a AD m a AD ɾ i AD
zapaburu	s̻ a AD p a AD b u AE ɾ u AE
zapatu	s̻ a AD p a AD t u AE
zara	s̪ a AD ɾ a AD
zarautz	s̻ a AD ɾ a AD u AE t s̻
zarete	s̪ a AD ɾ e AD t e AD
zatoz	s̪ a AD t o AE s̪
zatozke	s̪ a AD t o AE s̪ k e AD
zatozkete	s̪ a AD t o AE s̪ k e AD t e AD
zatozte	s̪ a AD t o AE s̪ t e AD
zatxezkidate	s̪ a AD t ʃ e AD s̪ k i AD d a AD t e AD
zatxezkie	s̪ a AD t ʃ e AD s̪ k i AD e AD
zatxezkiete	s̪ a AD t ʃ e AD s̪ k i AD e AD t e AD
zatxezkigu	s̪ a AD t ʃ e AD s̪ k i AD ɡ u AE
zatxezkigute	s̪ a AD t ʃ e AD s̪ k i AD ɡ u AE t e AD
zatxezkio	s̪ a AD t ʃ e AD s̪ k i AD o AE
zatxezkiote	s̪ a AD t ʃ e AD s̪ k i AD o AE t e AD
zatxezkit	s̪ a AD t ʃ e AD s̪ k i AD t
zaude	s̪ a AD w AC d e AD
zaudeke	s̪ a AD w AC d e AD k e AD
zaudekete	s̪ a AD w AC d e AD k e AD t e AD
zaudete	s̪ a AD w AC d e AD t e AD
zauri	s̻ a AD u AE ɾ i AD
zautza	s̪ a AD w AC t s̪ a AD
zautzate	s̪ a AD w AC t s̪ a AD t e AD
zazpi	s̻ a AD s̻ p i AD
zazpigarren	s̻ a AD s̻ p i AD ɡ a AD r e AD n
zazpikoitz	s̻ a AD s̻ p i AD k o AE i AD t s̻
zazpiren	s̻ a AD s̻ p i AD ɾ e AD n
ze	s̻ e AD
zebilen	s̪ e AD b i AD ʎ e AD n
zebilkeen	s̪ e AD b i AD l k e AD e AD n
zebiltzan	s̪ e AD b i AD l t s̪ a AD n
zebilzkeen	s̪ e AD b i AD l s̪ k e AD e AD n
zedin	s̪ e AD d i AD ɲ
zegoen	s̪ e AD ɡ o AE e AD n
zegokeen	s̪ e AD ɡ o AE k e AD e AD n
zein	s̪ e AD ɲ
zekien	s̪ e AD k i AD e AD n
zekion	s̪ e AD k i AD o AE n
zekizkien	s̪ e AD k i AD s̪ k i AD e AD n
zekizkion	s̪ e AD k i AD s̪ k i AD o AE n
zemendi	s̻ e AD m e AD n d i AD
zen	s̪ e AD n
zenbaki	s̻ e AD n b a AD k i AD
zenbiltzan	s̪ e AD n b i AD l t s̪ a AD n
zenbiltzaten	s̪ e AD n b i AD l t s̪ a AD t e AD n
zenbilzke	s̪ e AD n b i AD l s̪ k e AD
zenbilzkeen	s̪ e AD n b i AD l s̪ k e AD e AD n
zenbilzkete	s̪ e AD n b i AD l s̪ k e AD t e AD
zenbilzketen	s̪ e AD n b i AD l s̪ k e AD t e AD n
zenkizkien	s̪ e AD n k i AD s̪ k i AD e AD n
zenkizkieten	s̪ e AD n k i AD s̪ k i AD e AD t e AD n
zenkizkion	s̪ e AD n k i AD s̪ k i AD o AE n
zenkizkioten	s̪ e AD n k i AD s̪ k i AD o AE t e AD n
zentozen	s̪ e AD n t o AE s̪ e AD n
zentozke	s̪ e AD n t o AE s̪ k e AD
zentozkeen	s̪ e AD n t o AE s̪ k e AD e AD n
zentozkete	s̪ e AD n t o AE s̪ k e AD t e AD
zentozketen	s̪ e AD n t o AE s̪ k e AD t e AD n
zentozten	s̪ e AD n t o AE s̪ t e AD n
zentxezkidake	s̪ e AD n t ʃ e AD s̪ k i AD d a AD k e AD
zentxezkidakete	s̪ e AD n t ʃ e AD s̪ k i AD d a AD k e AD t e AD
zentxezkidan	s̪ e AD n t ʃ e AD s̪ k i AD d a AD n
zentxezkidaten	s̪ e AD n t ʃ e AD s̪ k i AD d a AD t e AD n
zentxezkieke	s̪ e AD n t ʃ e AD s̪ k i AD e AD k e AD
zentxezkiekete	s̪ e AD n t ʃ e AD s̪ k i AD e AD k e AD t e AD
zentxezkien	s̪ e AD n t ʃ e AD s̪ k i AD e AD n
zentxezkieten	s̪ e AD n t ʃ e AD s̪ k i AD e AD t e AD n
zentxezkiguke	s̪ e AD n t ʃ e AD s̪ k i AD ɡ u AE k e AD
zentxezkigukete	s̪ e AD n t ʃ e AD s̪ k i AD ɡ u AE k e AD t e AD
zentxezkigun	s̪ e AD n t ʃ e AD s̪ k i AD ɡ u AE n
zentxezkiguten	s̪ e AD n t ʃ e AD s̪ k i AD ɡ u AE t e AD n
zentxezkioke	s̪ e AD n t ʃ e AD s̪ k i AD o AE k e AD
zentxezkiokete	s̪ e AD n t ʃ e AD s̪ k i AD o AE k e AD t e AD
zentxezkion	s̪ e AD n t ʃ e AD s̪ k i AD o AE n
zentxezkioten	s̪ e AD n t ʃ e AD s̪ k i AD o AE t e AD n
zer	s̪ e AD ɾ
zerbitzu	s̪ e AD r b i AD t s̪ u AE
zerbitzugune	s̪ e AD r b i AD t s̪ u AE ɡ u AE n e AD
zerbütxügüne	s̪ e AD r b i AD t ʃ y AE ɡ y AE n e AD
zerekin	s̪ e AD ɾ e AD k i AD n
zeren	s̪ e AD ɾ e AD n
zerentzat	s̻ e AD ɾ e AD n t s̻ a AD t
zerez	s̪ e AD ɾ e AD s̪
zergatik	s̪ e AD r ɡ a AD t i AD k
zeri	s̪ e AD ɾ i AD
zerk	s̪ e AD r k
zero	s̻ e AD ɾ o AE
zerogarren	s̻ e AD ɾ o AE ɡ a AD r e AD n
zerri	s̻ e AD r i AD
zertaz	s̪ e AD r t a AD s̪
zeru	s̻ e AD ɾ u AE
zeta	s̻ e AD t a AD
zetorkeen	s̪ e AD t o AE r k e AD e AD n
zetorren	s̪ e AD t o AE r e AD n
zetozen	s̪ e AD t o AE s̪ e AD n
zetozkeen	s̪ e AD t o AE s̪ k e AD e AD n
zetxekian	s̪ e AD t ʃ e AD k i AD a AD n
zetxekidan	s̪ e AD t ʃ e AD k i AD d a AD n
zetxekien	s̪ e AD t ʃ e AD k i AD e AD n
zetxekigun	s̪ e AD t ʃ e AD k i AD ɡ u AE n
zetxekinan	s̪ e AD t ʃ e AD k i AD n a AD n
zetxekion	s̪ e AD t ʃ e AD k i AD o AE n
zetxekizuen	s̪ e AD t ʃ e AD k i AD s̪ u AE e AD n
zetxekizun	s̪ e AD t ʃ e AD k i AD s̪ u AE n
zetxezkian	s̪ e AD t ʃ e AD s̪ k i AD a AD n
zetxezkidan	s̪ e AD t ʃ e AD s̪ k i AD d a AD n
zetxezkien	s̪ e AD t ʃ e AD s̪ k i AD e AD n
zetxezkigun	s̪ e AD t ʃ e AD s̪ k i AD ɡ u AE n
zetxezkinan	s̪ e AD t ʃ e AD s̪ k i AD n a AD n
zetxezkion	s̪ e AD t ʃ e AD s̪ k i AD o AE n
zetxezkizuen	s̪ e AD t ʃ e AD s̪ k i AD s̪ u AE e AD n
zetxezkizun	s̪ e AD t ʃ e AD s̪ k i AD s̪ u AE n
zetzan	s̪ e AD t s̪ a AD n
zeu	s̪ e AD w AC
zeudekeen	s̪ e AD w AC d e AD k e AD e AD n
zeuden	s̪ e AD w AC d e AD n
zeundeke	s̪ e AD w AC n d e AD k e AD
zeundekeen	s̪ e AD w AC n d e AD k e AD e AD n
zeundekete	s̪ e AD w AC n d e AD k e AD t e AD
zeundeketen	s̪ e AD w AC n d e AD k e AD t e AD n
zeunden	s̪ e AD w AC n d e AD n
zeundeten	s̪ e AD w AC n d e AD t e AD n
zeuntzake	s̪ e AD w AC n t s̪ a AD k e AD
zeuntzakete	s̪ e AD w AC n t s̪ a AD k e AD t e AD
zeuntzan	s̪ e AD w AC n t s̪ a AD n
zeuntzaten	s̪ e AD w AC n t s̪ a AD t e AD n
zeure	s̪ e AD w AC ɾ e AD
zeutzan	s̪ e AD w AC t s̪ a AD n
zezeil	s̺ e AD s̺ e AD ʎ
zezen	s̻ e AD s̻ e AD n
zezenkari	s̻ e AD s̻ e AD n k a AD ɾ i AD
zigilu	s̻ i AD ɡ i AD ʎ u AE
zikoina	s̻ i AD k o AE ɲ a AD
zilar	s̪ i AD ʎ a AD ɾ
zintezen	s̪ i AD n t e AD s̪ e AD n
zintezke	s̪ i AD n t e AD s̪ k e AD
zintezkeen	s̪ i AD n t e AD s̪ k e AD e AD n
zintezkete	s̪ i AD n t e AD s̪ k e AD t e AD
zintezketen	s̪ i AD n t e AD s̪ k e AD t e AD n
zintezten	s̪ i AD n t e AD s̪ t e AD n
zintzur	s̻ i AD n t s̻ u AE r
zipre	s̻ i AD p r e AD
zirkonio	s̪ i AD r k o AE n j AB o AE
zitekeen	s̪ i AD t e AD k e AD e AD n
zitezen	s̪ i AD t e AD s̪ e AD n
zitezkeen	s̪ i AD t e AD s̪ k e AD e AD n
ziztatu	s̻ i AD s̻ t a AD t u AE
zolda	s̻ o AE l d a AD
zortzi	s̻ o AE r t s̻ i AD
zortzigarren	s̻ o AE r t s̻ i AD ɡ a AD r e AD n
zortzikoitz	s̻ o AE r t s̻ i AD k o AE i AD t s̻
zortziren	s̻ o AE r t s̻ i AD ɾ e AD n
zu	s̪ u AE
zubi	s̻ u AE b i AD
zuek	s̪ u AE e AD k
zuhaitz	s̻ u AE ɦ AA a AD i AD t s̻
zuhaixka	s̻ u AE h AA a AD i AD ʃ k a AD
zuhamuxka	s̻ u AE h AA a AD m u AE ʃ k a AD
zuk	s̪ u AE k
zulo	s̻ u AE l o AE
zulogune	s̻ u AE l o AE ɡ u AE n e AD
zumake	s̻ u AE m a AD k e AD
zumarraga	s̻ u AE m a AD r a AD ɡ a AD
zur	s̻ u AE r
zurgin	s̻ u AE r ɡ i AD ɲ
zurgina	s̻ u AE r ɡ i AD ɲ a AD
zurginak	s̻ u AE r ɡ i AD ɲ a AD k
zurginarekin	s̻ u AE r ɡ i AD ɲ a AD ɾ e AD k i AD ɲ
zurginaren	s̻ u AE r ɡ i AD ɲ a AD ɾ e AD n
zurginarengan	s̻ u AE r ɡ i AD ɲ a AD ɾ e AD n ɡ a AD n
zurginarengana	s̻ u AE r ɡ i AD ɲ a AD ɾ e AD n ɡ a AD n a AD
zurginarenganaino	s̻ u AE r ɡ i AD ɲ a AD ɾ e AD n ɡ a AD n a AD ɲ o AE
zurginarenganako	s̻ u AE r ɡ i AD ɲ a AD ɾ e AD n ɡ a AD n a AD k o AE
zurginarenganantz	s̻ u AE r ɡ i AD ɲ a AD ɾ e AD n ɡ a AD n a AD n t s̻
zurginarengandik	s̻ u AE r ɡ i AD ɲ a AD ɾ e AD n ɡ a AD n d i AD k
zurginarengatik	s̻ u AE r ɡ i AD ɲ a AD ɾ e AD n ɡ a AD t i AD k
zurginarentzat	s̻ u AE r ɡ i AD ɲ a AD ɾ e AD n t s̻ a AD t
zurginari	s̻ u AE r ɡ i AD ɲ a AD ɾ i AD
zurginaz	s̻ u AE r ɡ i AD ɲ a AD s̻
zurgindegi	s̻ u AE r ɡ i AD n d e AD ɡ i AD
zurginei	s̻ u AE r ɡ i AD ɲ e AD i AD
zurginek	s̻ u AE r ɡ i AD ɲ e AD k
zurginekin	s̻ u AE r ɡ i AD ɲ e AD k i AD ɲ
zurginen	s̻ u AE r ɡ i AD ɲ e AD n
zurginengan	s̻ u AE r ɡ i AD ɲ e AD n ɡ a AD n
zurginengana	s̻ u AE r ɡ i AD ɲ e AD n ɡ a AD n a AD
zurginenganaino	s̻ u AE r ɡ i AD ɲ e AD n ɡ a AD n a AD ɲ o AE
zurginenganako	s̻ u AE r ɡ i AD ɲ e AD n ɡ a AD n a AD k o AE
zurginenganantz	s̻ u AE r ɡ i AD ɲ e AD n ɡ a AD n a AD n t s̻
zurginengandik	s̻ u AE r ɡ i AD ɲ e AD n ɡ a AD n d i AD k
zurginengatik	s̻ u AE r ɡ i AD ɲ e AD n ɡ a AD t i AD k
zurginentzat	s̻ u AE r ɡ i AD ɲ e AD n t s̻ a AD t
zurginez	s̻ u AE r ɡ i AD ɲ e AD s̻
zurgini	s̻ u AE r ɡ i AD ɲ i AD
zurginik	s̻ u AE r ɡ i AD ɲ i AD k
zurgintza	s̻ u AE r ɡ i AD n t s̻ a AD
zurgintzat	s̻ u AE r ɡ i AD n t s̻ a AD t
zuri	s̻ u AE ɾ i AD
zuzen	s̻ u AE s̻ e AD n
zuzendu	s̻ u AE s̻ e AD n d u AE
zuzentasun	s̻ u AE s̻ e AD n t a AD s̺ u AE n
zuzentzaile	s̻ u AE s̻ e AD n t s̻ a AD ʎ e AD
zuñiga	s̻ u AE ɲ i AD ɡ a AD
züntzür	s̻ y AE n t s̻ y AE r
ñ	e AD ɲ e AD
ü	y AE
üthürri	y AE tʰ y AE r i AD
ĺ	ʎ
ŕ	r
