abakus	a AL b AH a AL k AC ʊ AM s AI
abang	a AL b AH a AL ŋ AG
abdomen	a AL p AH d AC o AM m AF ə AL n AG
abduksi	a AL p̚ d̪ AC ʊ AM k̚ s AI i AL
abdusen	a AL p̚ d AC u AM s AI ə AL n AG
abikara	a AL b AH i AL k AC a AL r AN a AL
abiturien	a AL b AH i AL t̪ AC u AM r AN i AL e AL n AG
ablaut	a AL p AH l AE a AL ʊ AM t̪̚
abolisi	a AL b AH o AM l AE i AL s AI i AL
absolut	a AL p̚ s AI o AM l AE ʊ AM t̚
acak	a AL t AC ʃ AI a AL k̚
acala	a AL t AC ʃ AI a AL l AE a AL
acara	a AL t AC ʃ AI a AL r AN a AL
ace	a AL t AC ʃ AI ə AL
acingara	a AL t AC ʃ AI i AL ŋ AG a AL r AN a AL
acintia	a AL t AC ʃ AI ɪ AL n AG t AC i AL a̯
acu	a AL t AC ʃ AI u AM
adangiyah	a AL d AC a AL ŋ AG i AL j AB a AL h AA
adegan	a AL d̪ AC ə AL ɡ AC a AL n AG
adiguna	a AL d AC i AL ɡ AC u AM n AG a AL
adiksi	a AL d AC ɪ AL k AC s AI i AL
adilaga	a AL d̪ AC i AL l AE a AL ɡ AC a AL
adimarga	a AL d AC i AL m AF a AL r AN ɡ AC a AL
adipati	a AL d AC i AL p AH a AL t AC i AL
adipura	a AL d AC i AL p AH u AM r AN a AL
aditorium	a AL d̪ AC i AL t AC o AM r AN i AL ʊ AM m AF
adiwira	a AL d AC i AL w AJ i AL r AN a AL
administrasi	a AL t̚ m AF i AL n AG ɪ AL s AI t AC r AN a AL s AI i AL
administratif	a AL t̚ m AF i AL n AG ɪ AL s AI t AC r AN a AL t AC ɪ AL f BA
admisi	a AL t AC m AF i AL s AI i AL
adnan	a AL t̪ AC n AG a AL n AG
adolesens	a AL d AC o AM l AE ɛ AL s AI ə AL n AG s AI
adolu	a AL d̪ AC o AM l AE u AM
adreng	a AL t̪̚ r AN ə AL ŋ AG
aduksi	a AL d̪ AC ʊ AM k̚ s AI i AL
adusen	a AL d AC u AM s AI ɛ AL n AG
adven	a AL t AC v BA ɛ AL n AG
advokat	a AL t̚ v BA o AM k AC a AL t̚
aeni	a AL e AL n AG i AL
aerosol	a AL e AL r AN o AM s AI ɔ AM l AE
aerosolisasi	a AL e AL r AN o AM s AI o AM l AE i AL s AI a AL s AI i AL
afek	a AL f BA ɛ AL k̚
afeksi	a AL f BA ɛ AL k̚ s AI i AL
afektif	a AL f BA ɛ AL k̚ t AC ɪ AL f BA
afkir	a AL f BA k AC ɪ AL r AN
afogato	a AL f BA o AM ɡ AC a AL t AC o AM
aga	a AL ɡ AC a AL
agak	a AL ɡ AC a AL ʔ AK
agama	a AL ɡ AC a AL m AF a AL
agenda	a AL ɡ AC ɛ AL n AG d AC a AL
agensi	a AL ɡ AC ɛ AL n AG s AI i AL
agio	a AL ɡ AC i AL o̯ AJ
agitasi	a AL ɡ AC i AL t AC a AL s AI i AL
agitatif	a AL ɡ AC i AL t̪ AC a AL t̪ AC ɪ AL f BA
agitator	a AL ɡ AC i AL t̪ AC a AL t̪ AC ɔ AM r AN
agni	a AL ɡ AC n AG i AL
agnyana	a AL ɡ AC ɲ AG a AL n AG a AL
agresif	a AL ɡ AC r AN ɛ AL s AI ɪ AL f BA
agustusan	a AL ɡ AC ʊ AM s AI t AC ʊ AM s AI a AL n AG
airawata	a AL i̯ AB r AN a AL w AJ a AL t AC a AL
aja	a AL d AC ʒ AI a AL
ajaib	a AL d AC ʒ AI a AL ɪ AL p AH
ajun	a AL d AC ʒ AI ʊ AM n AG
akasa	a AL k AC a AL s AI a AL
akcaya	a AL k AC s AI a AL j AB a AL
aki	a AL k AC i AL
akor	a AL k AC ɔ AM r AN
akrobatik	a AL k AC r AN o AM b AH a AL t AC ɪ AL k AC
akrobatis	a AL k AC r AN o AM b AH a AL t AC ɪ AL s AI
akromion	a AL k̚ r AN o AM m AF i AL ɔ AM n AG
akropolis	a AL k̚ r AN o AM p AH o AM l AE ɪ AL s AI
akses	a AL k AC s AI ɛ AL s AI
aksesori	a AL k̚ s AI e AL s AI o AM r AN i AL
akson	a AL k̚ s AI ɔ AM n AG
aktentas	a AL k̚ t AC ə AL n AG t AC a AL s AI
akting	a AL k̚ t AC i AL ŋ AG
aktinometer	a AL k̚ t AC i AL n AG o AM m AF ɛ AL t AC ə AL r AN
aktiva	a AL k AC t̪ AC i AL v BA a AL
aktual	a AL k AC t AC u AM a AL l AE
akuafaba	a AL k AC u AM a̯ f BA a AL b AH a AL
akun	a AL k AC ʊ AM n AG
akuntan	a AL k AC ʊ AM n AG t AC a AL n AG
ala	a AL l AE a AL
alab	a AL l AE a AL p̚
alaf	a AL l AE a AL f BA
alamas	a AL l AE a AL m AF a AL s AI
albahdir	a AL l AE b AH a AL h AA d AC ɪ AL r AN
albania	a AL l AE b AH a AL n AG i AL a̯
alber	a AL l AE b AH ə AL r AN
album	a AL l AE b AH ʊ AM m AF
alena	a AL l AE ɛ AL n AG a AL
alergi	a AL l AE ɛ AL r AN ɡ AC i AL
algoritma	a AL l AE ɡ AC o AM r AN ɪ AL t̪ AC m AF a AL
algoritme	a AL l AE ɡ AC o AM r AN ɪ AL t̪ AC m AF ə AL
alibi	a AL l AE i AL b AH i AL
alinea	a AL l AE i AL n AG e AL a AL
aljabar	a AL l AE d AC ʒ AI a AL b AH a AL r AN
alkes	a AL l AE k AC ə AL s AI
allah	ɔ AM ɫ AE ɫ AE ɔ AM h AA
almanak	a AL l AE m AF a AL n AG a AL ʔ AK
almasih	a AL l AE m AF a AL s AI ɪ AL h AA
alokasi	a AL l AE o AM k AC a AL s AI i AL
along	a AL l AE ɔ AM ŋ AG
alpaka	a AL l AE p AH a AL k AC a AL
alpeka	a AL l AE p AH ə AL k AC a AL
alter	a AL l AE t̪ AC ɛ AL r AN
alveolus	a AL l AE v BA e AL o AM l AE ʊ AM s AI
amal	a AL m AF a AL l AE
amalaka	a AL m AF a AL l AE a AL k AC a AL
amatir	a AL m AF a AL t̪ AC ɪ AL r AN
ambah	a AL m AF b AH a AL h AA
ambang	a AL m AF b AH a AL ŋ AG
ambar	a AL m AF b AH a AL r AN
ambara	a AL m AF b AH a AL r AN a AL
ambeien	a AL m AF b AH e AL i AL ə AL n AG
ambeksura	a AL m AF b AH ə AL k̚ s AI u AM r AN a AL
amber	a AL m AF b AH ə AL r AN
ambigu	a AL m AF b AH i AL ɡ AC u AM
ambulatori	a AL m AF b AH u AM l AE a AL t AC o AM r AN i AL
amoi	a AL m AF o AM i̯ AB
amplifikasi	a AL m AF p AH l AE i AL f BA i AL k AC a AL s AI i AL
amprah	a AL m AF p AH r AN a AL h AA
ampula	a AL m AF p AH u AM l AE a AL
ampun	a AL m AF p AH ʊ AM n AG
amtenar	a AL m AF t AC ə AL n AG a AL r AN
amulet	a AL m AF u AM l AE ɛ AL t AC
ananta	a AL n AG a AL n AG t AC a AL
anatomi	a AL n AG a AL t AC o AM m AF i AL
anca	a AL n AG t AC ʃ AI a AL
ancoa	a AL n AG t AC ʃ AI o AM a̯
andai	a AL n AG d̪ AC a AL i̯ AB
andil	a AL n AG d AC ɪ AL l AE
andong	a AL n AG d̪ AC ɔ AM ŋ AG
anemer	a AL n AG e AL m AF ə AL r AN
angel	a AL ŋ AG ɛ AL l AE
anggota	a AL ŋ AG ɡ AC o AM t̪ AC a AL
anggur	a AL ŋ AG ɡ AC ʊ AM r AN
angkat	a AL ŋ AG k AC a AL t AC
angker	a AL ŋ AG k AC ə AL r AN
angket	a AL ŋ AG k AC ɛ AL t̚
angkong	a AL ŋ AG k AC ɔ AM ŋ AG
angsio	a AL ŋ AG s AI i AL o̯ AJ
anime	a AL n AG i AL m AF e AL
anjing	a AL n AG d AC ʒ AI ɪ AL ŋ AG
anjir	a AL n AG d AC ʒ AI ɪ AL r AN
ansar	a AL n AG s AI a AL r AN
antariksa	a AL n AG t AC a AL r AN ɪ AL k AC s AI a AL
antarmuka	a AL n AG t AC a AL r AN m AF u AM k AC a AL
antik	a AL n AG t AC i AL ʔ AK
antologi	a AL n AG t̪ AC o AM l AE o AM ɡ AC i AL
antre	a AL n AG t AC r AN e AL
antropologi	a AL n AG t AC r AN o AM p AH o AM l AE o AM ɡ AC i AL
antusias	a AL n AG t AC u AM s AI i AL a AL s AI
anugerah	a AL n AG u AM ɡ AC ə AL r AN a AL h AA
anugrahamurti	a AL n AG u AM ɡ AC r AN a AL h AA a AL m AF ʊ AM r AN t AC i AL
anyelir	a AL ɲ AG ə AL l AE ɪ AL r AN
aparatur	a AL p AH a AL r AN a AL t AC ʊ AM r AN
aparatus	a AL p AH a AL r AN a AL t̪ AC ʊ AM s AI
apel	a AL p AH ɛ AL l AE
aplikasi	a AL p AH l AE i AL k AC a AL s AI i AL
aplus	a AL p AH l AE ʊ AM s AI
apokalips	a AL p AH o AM k AC a AL l AE ɪ AL p AH s AI
apokrifa	a AL p AH o AM k AC r AN i AL f BA a AL
apoteker	a AL p AH o AM t̪ AC e AL k AC ə AL r AN
apung	a AL p AH ʊ AM ŋ AG
arbitrase	a AL r AN b AH ɪ AL t AC r AN a AL s AI ə AL
arbitrer	a AL r AN b AH ɪ AL t AC r AN ɛ AL r AN
arca	a AL r AN t AC ʃ AI a AL
arde	a AL r AN d AC ə AL
ares	a AL r AN ɛ AL s AI
arkade	a AL r AN k AC a AL d̪ AC ə AL
arkeologi	a AL r AN k AC e AL o AM l AE o AM ɡ AC i AL
arnal	a AL r AN n AG a AL l AE
arsitek	a AL r AN s AI i AL t AC ɛ AL k̚
arsitektur	a AL r AN s AI i AL t AC ɛ AL k̚ t AC ʊ AM r AN
artefak	a AL r AN t AC ə AL f BA a AL k̚
arteri	a AL r AN t AC e AL r AN i AL
artikel	a AL r AN t AC i AL k AC ə AL l AE
arupadatu	a AL r AN u AM p AH a AL d̪ AC a AL t̪ AC u AM
as	a AL s AI
asa	a AL s AI a AL
asana	a AL s AI a AL n AG a AL
asas	a AL s AI a AL s AI
asdos	a AL s AI d̪ AC ɔ AM s AI
aset	a AL s AI ɛ AL t̪̚
asisten	a AL s AI ɪ AL s AI t̪ AC ɛ AL n AG
asmaradahana	a AL s AI m AF a AL r AN a AL d AC a AL h AA a AL n AG a AL
asosiasi	a AL s AI o AM s AI i AL a AL s AI i AL
aspiran	a AL s AI p AH i AL r AN a AL n AG
asprak	a AL s AI p AH r AN a AL k̚
astaka	a AL s AI t̪ AC a AL k AC a AL
astrologi	a AL s AI t AC r AN o AM l AE o AM ɡ AC i AL
astronomi	a AL s AI t AC r AN o AM n AG o AM m AF i AL
astungkara	a AL s AI t AC ʊ AM ŋ AG k AC a AL r AN a AL
asuransi	a AL s AI u AM r AN a AL n AG s AI i AL
atase	a AL t̪ AC a AL s AI e AL
ateret	a AL t AC ə AL r AN ɛ AL t̚
atlet	a AL t AC l AE ɛ AL t AC
atletik	a AL t AC l AE ɛ AL t AC ɪ AL k AC
atmosfer	a AL t̪̚ m AF ɔ AM s AI f BA ɛ AL r AN
atom	a AL t AC o AM m AF
atonemen	a AL t AC o AM n AG ɛ AL m AF ə AL n AG
atribut	a AL t AC r AN i AL b AH ʊ AM t AC
auditor	a AL u̯ AJ d̪ AC i AL t AC ɔ AM r AN
auditorium	a AL u̯ AJ d̪ AC i AL t AC o AM r AN i AL ʊ AM m AF
aula	a AL u̯ AJ l AE a AL
aura	a AL u̯ AJ r AN a AL
auskultasi	a AL ʊ AM s AI k AC ʊ AM l AE t AC a AL s AI i AL
autopsi	o AM t AC ɔ AM p AH s AI i AL
awan	a AL w AJ a AL n AG
awang	a AL w AJ a AL ŋ AG
awatara	a AL w AJ a AL t AC a AL r AN a AL
badai	b AH a AL d̪ AC a AL i̯ AB
badan	b AH a AL d AC a AL n AG
bagasi	b AH a AL ɡ AC a AL s AI i AL
bahagia	b AH a AL h AA a AL ɡ AC j AB a AL
bahan	b AH a AL h AA a AL n AG
bahari	b AH a AL h AA a AL r AN i AL
bahlul	b AH a AL h AA l AE ʊ AM l AE
bait	b AH a AL ɪ AL t̪̚
baji	b AH a AL d AC ʒ AI i AL
baju	b AH a AL d AC ʒ AI u AM
bakalaureat	b AH a AL k AC a AL l AE a AL u̯ AJ r AN e AL a AL t̚
bakar	b AH a AL k AC a AL r AN
bakteri	b AH a AL k̚ t AC e AL r AN i AL
bakteriologi	b AH a AL k AC t AC e AL r AN i AL o AM l AE o AM ɡ AC i AL
baku	b AH a AL k AC u AM
bal	b AH a AL l AE
balans	b AH a AL l AE a AL n AG s AI
balas	b AH a AL l AE a AL s AI
balgam	b AH a AL l AE ɡ AC a AL m AF
balkon	b AH a AL l AE k AC ɔ AM n AG
balon	b AH a AL l AE ɔ AM n AG
baluarti	b AH a AL l AE u AM a AL r AN t̪ AC i AL
balut	b AH a AL l AE ʊ AM t̪ AC
ban	b AH a AL n AG
bandana	b AH a AL n AG d AC a AL n AG a AL
bandar	b AH a AL n AG d AC a AL r AN
banderol	b AH a AL n AG d̪ AC ə AL r AN ɔ AM l AE
banget	b AH a AL ŋ AG ə AL t AC
bangga	b AH a AL ŋ AG ɡ AC a AL
bangkai	b AH a AL ŋ AG k AC a AL i̯ AB
bangkrut	b AH a AL ŋ AG k AC r AN ʊ AM t AC
bangsal	b AH a AL ŋ AG s AI a AL l AE
bankir	b AH a AL n AG k AC ɪ AL r AN
banrol	b AH a AL n AG r AN ɔ AM l AE
bansos	b AH a AL n AG s AI ɔ AM s AI
bantu	b AH a AL n AG t̪ AC u AM
bantuan	b AH a AL n AG t AC u AM a AL n AG
banyak	b AH a AL ɲ AG a AL ʔ AK
baper	b AH a AL p AH ə AL r AN
baptis	b AH a AL p AH t AC ɪ AL s AI
barber	b AH a AL r AN b AH ə AL r AN
bardi	b AH a AL r AN d AC i AL
baris	b AH a AL r AN ɪ AL s AI
barok	b AH a AL r AN ɔ AM k̚
baru	b AH a AL r AN u AM
bas	b AH a AL s AI
basa	b AH a AL s AI a AL
basemen	b AH a AL s AI ə AL m AF ɛ AL n AG
basi	b AH a AL s AI i AL
basil	b AH a AL s AI ɪ AL l AE
basis	b AH a AL s AI ɪ AL s AI
baskom	b AH a AL s AI k AC ɔ AM m AF
bastar	b AH a AL s AI t AC a AL r AN
batas	b AH a AL t̪ AC a AL s AI
baterai	b AH a AL t AC ə AL r AN a AL i̯ AB
batil	b AH a AL t̪ AC ɪ AL l AE
batrik	b AH a AL t̚ r AN ɪ AL k AC
bau	b AH a AL u̯ AJ
baut	b AH a AL ʊ AM t AC
bawasir	b AH a AL w AJ a AL s AI ɪ AL r AN
bayonet	b AH a AL j AB o AM n AG ɛ AL t AC
bazoka	b AH a AL z AI o AM k AC a AL
becak	b AH ɛ AL t AC ʃ AI a AL ʔ AK
beda	b AH ɛ AL d AC a AL
bedil	b AH ə AL d̪ AC ɪ AL l AE
bedinde	b AH ə AL d AC ɪ AL n AG d AC ə AL
begandering	b AH ə AL ɡ AC a AL n AG d AC ə AL r AN ɪ AL ŋ AG
behandel	b AH ə AL h AA a AL n AG d AC ə AL l AE
behel	b AH ɛ AL h AA ə AL l AE
bejana	b AH ə AL d AC ʒ AI a AL n AG a AL
bejibun	b AH ə AL d AC ʒ AI i AL b AH ʊ AM n AG
bek	b AH ɛ AL k AC
bekal	b AH ə AL k AC a AL l AE
bekel	b AH ɛ AL k AC ə AL l AE
beken	b AH ə AL k AC ɛ AL n AG
beker	b AH ɛ AL k AC ə AL r AN
bekerja	b AH ə AL k AC ə AL r AN d AC ʒ AI a AL
bekleding	b AH ə AL k AC l AE e AL d AC ɪ AL ŋ AG
bekles	b AH ɛ AL k AC l AE ɛ AL s AI
beku	b AH ə AL k AC u AM
belek	b AH ɛ AL l AE ɛ AL k AC
belenggu	b AH ə AL l AE ə AL ŋ AG ɡ AC u AM
belikat	b AH ə AL l AE i AL k AC a AL t̪ AC
belut	b AH ə AL l AE ʊ AM t̚
bemper	b AH ɛ AL m AF p AH ə AL r AN
benang	b AH ə AL n AG a AL ŋ AG
benar	b AH ə AL n AG a AL r AN
bencana	b AH ə AL n AG t AC ʃ AI a AL n AG a AL
benci	b AH ə AL n AG t AC ʃ AI i AL
bendara	b AH ə AL n AG d AC a AL r AN a AL
bendesa	b AH ə AL n AG d AC ɛ AL s AI a AL
bendi	b AH ɛ AL n AG d̪ AC i AL
bensin	b AH ɛ AL n AG s AI ɪ AL n AG
bento	b AH ɛ AL n AG t AC o AM
benua	b AH ə AL n AG u AM a̯
beol	b AH ɛ AL ɔ AM l AE
beraja	b AH ə AL r AN a AL d AC ʒ AI a AL
berani	b AH ə AL r AN a AL n AG i AL
beras	b AH ə AL r AN a AL s AI
berat	b AH ə AL r AN a AL t AC
beredel	b AH ə AL r AN ɛ AL d AC ɛ AL l AE
bergejala	b AH ə AL r AN ɡ AC e AL d AC ʒ AI a AL l AE a AL
beri	b AH ɛ AL r AN i AL
beriani	b AH ə AL r AN i AL a AL n AG i AL
berita	b AH ə AL r AN i AL t AC a AL
berkat	b AH ə AL r AN k AC a AL t AC
berlian	b AH ə AL r AN l AE i AL a AL n AG
berpacaran	b AH ə AL r AN p AH a AL t AC ʃ AI a AL r AN a AL n AG
besi	b AH ə AL s AI i AL
beslit	b AH ɛ AL s AI l AE ɪ AL t̚
bestek	b AH ɛ AL s AI t AC ɛ AL k̚
bestir	b AH ə AL s AI t AC ɪ AL r AN
besuk	b AH ə AL s AI ʊ AM k AC
biang	b AH i AL a̯ ŋ AG
bias	b AH i AL a AL s AI
bibliotek	b AH ɪ AL p AH l AE i AL o AM t AC ɛ AL k AC
bija	b AH i AL d AC ʒ AI a AL
binen	b AH i AL n AG ɛ AL n AG
bintang	b AH ɪ AL n AG t AC a AL ŋ AG
biologi	b AH i AL o AM l AE o AM ɡ AC i AL
bioma	b AH i AL o̯ AJ m AF a AL
biomassa	b AH i AL o AM m AF a AL s AI s AI a AL
bir	b AH ɪ AL r AN
birama	b AH i AL r AN a AL m AF a AL
birokrat	b AH i AL r AN o AM k AC r AN a AL t AC
bis	b AH ɪ AL s AI
bisa	b AH i AL s AI a AL
bisnis	b AH ɪ AL s AI n AG ɪ AL s AI
bistik	b AH ɪ AL s AI t AC ɪ AL k̚
bit	b AH ɪ AL t AC
blok	b AH l AE ɔ AM k̚
blokade	b AH l AE o AM k AC a AL d AC ə AL
bloknot	b AH l AE ɔ AM k̚ n AG ɔ AM t̚
bludrek	b AH l AE ʊ AM d AC r AN ə AL k AC
blumkol	b AH l AE ʊ AM m AF k AC ɔ AM l AE
blus	b AH l AE ʊ AM s AI
boa	b AH o AM a̯
boba	b AH o AM b AH a AL
bocuan	b AH o AM t AC ʃ AI u AM a̯ n AG
bodi	b AH o AM d AC i AL
boga	b AH o AM ɡ AC a AL
bohlam	b AH ɔ AM h AA l AE a AL m AF
boi	b AH o AM i AL
bokeh	b AH o AM k AC ɛ AL h AA
bokep	b AH o AM k AC ɛ AL p AH
bokser	b AH ɔ AM k AC s AI ə AL r AN
boksu	b AH ɔ AM k̚ s AI u AM
bola	b AH o AM l AE a AL
bolpen	b AH ɔ AM l AE p AH ɛ AL n AG
bolpoin	b AH o AM l AE p AH o AM i AL n AG
bom	b AH ɔ AM m AF
bombastis	b AH ɔ AM m AF b AH a AL s AI t AC ɪ AL s AI
boneka	b AH o AM n AG ɛ AL k AC a AL
bong	b AH ɔ AM ŋ AG
bonus	b AH o AM n AG ʊ AM s AI
boplang	b AH ɔ AM p AH l AE a AL ŋ AG
boreh	b AH o AM r AN ɛ AL h AA
borjuis	b AH ɔ AM r AN d AC ʒ AI u AM ɪ AL s AI
bos	b AH ɔ AM s AI
botang	b AH o AM t AC a AL ŋ AG
botani	b AH o AM t AC a AL n AG i AL
botol	b AH o AM t AC ɔ AM l AE
brankas	b AH r AN a AL n AG k AC a AL s AI
branwir	b AH r AN a AL n AG w AJ ɪ AL r AN
brata	b AH r AN a AL t AC a AL
brevet	b AH r AN ɛ AL v BA ɛ AL t AC
brompit	b AH r AN ɔ AM m AF p AH ɪ AL t AC
bros	b AH r AN ɔ AM s AI
brosur	b AH r AN o AM s AI ʊ AM r AN
brutal	b AH r AN u AM t AC a AL l AE
bruto	b AH r AN u AM t AC o AM
bucin	b AH u AM t AC ʃ AI ɪ AL n AG
bui	b AH u AM i̯ AB
bujet	b AH u AM d AC ʒ AI ɛ AL t AC
bujeter	b AH u AM d AC ʒ AI ɛ AL t AC ɛ AL r AN
buk	b AH ʊ AM k AC
buket	b AH u AM k AC ɛ AL t̪ AC
bulai	b AH u AM l AE a AL i̯ AB
bulevar	b AH u AM l AE ə AL v BA a AL r AN
bulsak	b AH ʊ AM l AE s AI a AL k AC
bum	b AH ʊ AM m AF
bumerang	b AH u AM m AF ə AL r AN a AL ŋ AG
bumper	b AH ʊ AM m AF p AH ə AL r AN
bundar	b AH ʊ AM n AG d AC a AL r AN
bunker	b AH ʊ AM ŋ AG k AC ə AL r AN
bunyi	b AH u AM ɲ AG i AL
bursa	b AH ʊ AM r AN s AI a AL
buruk	b AH u AM r AN u AM ʔ AK
busi	b AH u AM s AI i AL
butik	b AH u AM t AC ɪ AL k AC
ca	t AC ʃ AI a AL
cabo	t AC ʃ AI a AL b AH o AM
cadangan	t AC ʃ AI a AL d AC a AL ŋ AG a AL n AG
cagak	t AC ʃ AI a AL ɡ AC a AL k AC
caima	t AC ʃ AI a AL i̯ AB m AF a AL
cair	t AC ʃ AI a AL ɪ AL r AN
caisim	t AC ʃ AI a AL i̯ AB s AI ɪ AL m AF
cakiak	t AC ʃ AI a AL k AC i AL a AL ʔ AK
calo	t AC ʃ AI a AL l AE o AM
calui	t AC ʃ AI a AL l AE u AM i̯ AB
cambuk	t AC ʃ AI a AL m AF b AH ʊ AM k AC
camca	t AC ʃ AI a AL m AF t AC ʃ AI a AL
canai	t AC ʃ AI a AL n AG a AL i̯ AB
canda	t AC ʃ AI a AL n AG d AC a AL
candi	t AC ʃ AI a AL n AG d AC i AL
candradimuka	t AC ʃ AI a AL n AG d̪ AC r AN a AL d̪ AC i AL m AF u AM k AC a AL
candu	t AC ʃ AI a AL n AG d AC u AM
cangcimen	t AC ʃ AI a AL ŋ AG t AC ʃ AI i AL m AF ɛ AL n AG
cantik	t AC ʃ AI a AL n AG t AC i AL ʔ AK
cap	t AC ʃ AI a AL p AH
capcai	t AC ʃ AI a AL p AH t AC ʃ AI a AL i̯ AB
capek	t AC ʃ AI a AL p AH ɛ AL ʔ AK
caper	t AC ʃ AI a AL p AH ə AL r AN
capgome	t AC ʃ AI a AL p AH ɡ AC o AM m AF e AL
caraka	t AC ʃ AI a AL r AN a AL k AC a AL
cas	t AC ʃ AI a AL s AI
cat	t AC ʃ AI a AL t̚
cawan	t AC ʃ AI a AL w AJ a AL n AG
ceban	t AC ʃ AI ə AL b AH a AL n AG
cek	t AC ʃ AI ɛ AL ʔ AK
ceki	t AC ʃ AI ə AL k AC i AL
celana	t AC ʃ AI ə AL l AE a AL n AG a AL
cemas	t AC ʃ AI ə AL m AF a AL s AI
cemeti	t AC ʃ AI ə AL m AF ə AL t̪ AC i AL
cengbeng	t AC ʃ AI ɛ AL ŋ AG b AH ɛ AL ŋ AG
cengkau	t AC ʃ AI ə AL ŋ AG k AC a AL u̯ AJ
cengki	t AC ʃ AI ə AL ŋ AG k AC i AL
cengli	t AC ʃ AI ɛ AL ŋ AG l AE i AL
centeng	t AC ʃ AI ə AL n AG t AC ɛ AL ŋ AG
cerai	t AC ʃ AI ə AL r AN a AL i̯ AB
ceramah	t AC ʃ AI ə AL r AN a AL m AF a AL h AA
cermin	t AC ʃ AI ə AL r AN m AF ɪ AL n AG
cerna	t AC ʃ AI ə AL r AN n AG a AL
cerpu	t AC ʃ AI ə AL r AN p AH u AM
ciak	t AC ʃ AI i AL a̯ k̚
cialat	t AC ʃ AI i AL a̯ l AE a AL t̚
cikuwa	t AC ʃ AI i AL k AC u AM w AJ a AL
cina	t AC ʃ AI i AL n AG a AL
cincai	t AC ʃ AI ɪ AL n AG t AC ʃ AI a AL i̯ AB
cincau	t AC ʃ AI i AL n AG t AC ʃ AI a AL u̯ AJ
cincin	t AC ʃ AI ɪ AL n AG t AC ʃ AI ɪ AL n AG
cincu	t AC ʃ AI i AL n AG t AC ʃ AI u AM
cinta	t AC ʃ AI ɪ AL n AG t AC a AL
cip	t AC ʃ AI ɪ AL p AH
cipta	t AC ʃ AI ɪ AL p AH t AC a AL
citra	t AC ʃ AI ɪ AL t̚ r AN a AL
comblang	t AC ʃ AI ɔ AM m AF b AH l AE a AL ŋ AG
compoh	t AC ʃ AI ɔ AM m AF p AH ɔ AM h AA
congki	t AC ʃ AI ɔ AM ŋ AG k AC i AL
congsam	t AC ʃ AI ɔ AM ŋ AG s AI a AL m AF
coro	t AC ʃ AI o AM r AN o AM
cuan	t AC ʃ AI u AM a̯ n AG
cuci	t AC ʃ AI u AM t AC ʃ AI i AL
cukai	t AC ʃ AI u AM k AC a AL i̯ AB
cukimai	t AC ʃ AI u AM k AC i AL m AF a AL i̯ AB
cukin	t AC ʃ AI u AM k AC ɪ AL n AG
cukong	t AC ʃ AI u AM k AC ɔ AM ŋ AG
curek	t AC ʃ AI u AM r AN ə AL ʔ AK
cuti	t AC ʃ AI u AM t̪ AC i AL
dabing	d AC a AL b AH ɪ AL ŋ AG
dacin	d AC a AL t AC ʃ AI ɪ AL n AG
dada	d̪ AC a AL d̪ AC a AL
dadah	d AC a AL d AC a AL h AA
dading	d AC a AL d AC ɪ AL ŋ AG
dadu	d̪ AC a AL d̪ AC u AM
daftar	d̪ AC a AL f BA t AC a AL r AN
dahak	d̪ AC a AL h AA a AL k AC
dak	d AC a AL k AC
daksa	d AC a AL k AC s AI a AL
dakwa	d̪ AC a AL ʔ AK w AJ a AL
dakwah	d̪ AC a AL ʔ AK w AJ a AL h AA
dalang	d̪ AC a AL l AE a AL ŋ AG
dalih	d AC a AL l AE ɪ AL h AA
dam	d AC a AL m AF
damai	d AC a AL m AF a AL i̯ AB
damar	d̪ AC a AL m AF a AL r AN
dapur	d AC a AL p AH ʊ AM r AN
darurat	d AC a AL r AN u AM r AN a AL t̚
data	d AC a AL t AC a AL
datum	d AC a AL t AC ʊ AM m AF
debat	d̪ AC e AL b AH a AL t̪̚
debet	d AC e AL b AH ə AL t̪̚
debetor	d AC e AL b AH ə AL t̪ AC ɔ AM r AN
debit	d AC e AL b AH ɪ AL t̪̚
debitor	d AC e AL b AH i AL t̪ AC ɔ AM r AN
debitur	d AC e AL b AH i AL t̪ AC ʊ AM r AN
dedapur	d̪ AC ə AL d̪ AC a AL p AH ʊ AM r AN
defamasi	d AC e AL f BA a AL m AF a AL s AI i AL
definisi	d̪ AC e AL f BA i AL n AG i AL s AI i AL
defisit	d AC e AL f BA i AL s AI ɪ AL t̪̚
dek	d AC ɛ AL k AC
dekade	d AC e AL k AC a AL d AC ə AL
deklarasi	d AC ɛ AL k AC l AE a AL r AN a AL s AI i AL
dekonsentrasi	d AC e AL k AC ɔ AM n AG s AI ɛ AL n AG t AC r AN a AL s AI i AL
dekor	d AC ɛ AL k AC ɔ AM r AN
dekorasi	d AC ɛ AL k AC o AM r AN a AL s AI i AL
dekret	d AC ə AL k AC r AN ɛ AL t̪ AC
delapan	d AC ə AL l AE a AL p AH a AL n AG
delegasi	d AC e AL l AE ə AL ɡ AC a AL s AI i AL
deler	d AC ə AL l AE ɛ AL r AN
delik	d AC ə AL l AE ɪ AL k AC
delinkuensi	d AC e AL l AE ɪ AL n AG k AC u AM ɛ AL n AG s AI i AL
delta	d AC ɛ AL l AE t AC a AL
delusi	d̪ AC e AL l AE u AM s AI i AL
demagog	d AC e AL m AF a AL ɡ AC ɔ AM k̚
demokrasi	d AC e AL m AF o AM k AC r AN a AL s AI i AL
demokrat	d̪ AC e AL m AF o AM k AC r AN a AL t̪̚
denda	d̪ AC ə AL n AG d̪ AC a AL
denominasi	d AC e AL n AG o AM m AF i AL n AG a AL s AI i AL
deodoran	d̪ AC e AL o AM d̪ AC o AM r AN a AL n AG
departemen	d AC ə AL p AH a AL r AN t AC ə AL m AF ɛ AL n AG
deposito	d AC e AL p AH o AM s AI i AL t AC o AM
derap	d AC ə AL r AN a AL p AH
derivatif	d AC ɛ AL r AN i AL v BA a AL t AC ɪ AL f BA
derji	d AC ə AL r AN d AC ʒ AI i AL
derma	d AC ə AL r AN m AF a AL
dermaga	d̪ AC ə AL r AN m AF a AL ɡ AC a AL
desa	d AC ɛ AL s AI a AL
desain	d AC e AL s AI a AL ɪ AL n AG
desersi	d̪ AC ɛ AL s AI ɛ AL r AN s AI i AL
deskripsi	d̪ AC ɛ AL s AI k AC r AN ɪ AL p AH s AI i AL
destar	d AC ə AL s AI t AC a AL r AN
detasemen	d AC e AL t AC a AL s AI ə AL m AF ɛ AL n AG
deteksi	d̪ AC e AL t̪ AC e AL k̚ s AI i AL
detektif	d̪ AC e AL t̪ AC e AL k̚ t̪ AC ɪ AL f BA
detergen	d AC e AL t̪ AC ə AL r AN ɡ AC e AL n AG
detik	d AC ə AL t AC ɪ AL ʔ AK
deviasi	d̪ AC e AL v BA i AL a̯ s AI i AL
dewala	d AC ɛ AL w AJ a AL l AE a AL
dewasa	d AC ɛ AL w AJ a AL s AI a AL
diabetes	d AC i AL a AL b AH ɛ AL t AC ə AL s AI
diagnosis	d AC i AL a AL ɡ AC n AG o AM s AI ɪ AL s AI
diakones	d AC i AL a AL k AC o AM n AG ə AL s AI
dian	d̪ AC i AL a AL n AG
diare	d̪ AC i AL a AL r AN e AL
diari	d AC i AL a AL r AN i AL
diaspora	d AC i AL a AL s AI p AH o AM r AN a AL
diktat	d AC ɪ AL k AC t AC a AL t AC
dikte	d̪ AC i AL ʔ AK t̪ AC e AL
diktum	d AC ɪ AL k AC t AC ʊ AM m AF
dim	d AC ɪ AL m AF
dimensi	d̪ AC i AL m AF ɛ AL n AG s AI i AL
din	d AC ɪ AL n AG
dinamo	d AC i AL n AG a AL m AF o AM
dinar	d̪ AC i AL n AG a AL r AN
dinas	d AC i AL n AG a AL s AI
dinasti	d̪ AC i AL n AG a AL s AI t̪ AC i AL
dini	d AC i AL n AG i AL
dioses	d̪ AC i AL o AM s AI ə AL s AI
dipertuan	d̪ AC i AL p AH ə AL r AN t AC u AM a AL n AG
diplomasi	d AC ɪ AL p AH l AE o AM m AF a AL s AI i AL
diplomatik	d AC ɪ AL p AH l AE o AM m AF a AL t AC ɪ AL k AC
diplomatis	d AC ɪ AL p AH l AE o AM m AF a AL t AC ɪ AL s AI
direk	d AC i AL r AN ɛ AL ʔ AK
direksi	d AC i AL r AN ɛ AL k AC s AI i AL
direktori	d AC i AL r AN ɛ AL k AC t AC o AM r AN i AL
direktur	d AC i AL r AN ɛ AL k AC t AC ʊ AM r AN
dirgantara	d AC ɪ AL r AN ɡ AC a AL n AG t AC a AL r AN a AL
dirigen	d AC i AL r AN i AL ɡ AC ɛ AL n AG
disel	d AC i AL s AI ɛ AL l AE
disiplin	d̪ AC i AL s AI ɪ AL p̚ l AE ɪ AL n AG
disket	d AC ɪ AL s AI k AC ɛ AL t AC
diskon	d AC i AL s AI k AC o AM n AG
diskonto	d AC ɪ AL s AI k AC ɔ AM n AG t AC o AM
diskresi	d̪ AC ɪ AL s AI k AC r AN ɛ AL s AI i AL
diskret	d̪ AC ɪ AL s AI k AC r AN ɛ AL t̪̚
diskriminasi	d AC ɪ AL s AI k AC r AN i AL m AF i AL n AG a AL s AI i AL
diskualifikasi	d AC ɪ AL s AI k AC u AM a AL l AE i AL f BA i AL k AC a AL s AI i AL
diskus	d̪ AC ɪ AL s AI k AC ʊ AM s AI
diskusi	d̪ AC ɪ AL s AI k AC u AM s AI i AL
dispensasi	d AC ɪ AL s AI p AH ɛ AL n AG s AI a AL s AI i AL
dispenser	d AC ɪ AL s AI p AH ɛ AL n AG s AI ə AL r AN
dispersi	d̪ AC ɪ AL s AI p AH ɛ AL r AN s AI i AL
distansi	d̪ AC ɪ AL s AI t̪ AC a AL n AG s AI i AL
distrik	d AC ɪ AL s AI t AC r AN ɪ AL k̚
divisi	d AC i AL v BA i AL s AI i AL
dobel	d AC o AM b AH ə AL l AE
doi	d AC o AM i̯ AB
dok	d AC ɔ AM k AC
dokar	d̪ AC o AM k AC a AL r AN
doksologi	d AC ɔ AM k AC s AI o AM l AE o AM ɡ AC i AL
doktrin	d AC ɔ AM k AC t AC r AN ɪ AL n AG
dol	d AC ɔ AM l AE
dom	d AC ɔ AM m AF
domain	d̪ AC o AM m AF a AL ɪ AL n AG
domba	d AC ɔ AM m AF b AH a AL
domine	d̪ AC o AM m AF i AL n AG e AL
domisili	d AC o AM m AF i AL s AI i AL l AE i AL
donatir	d̪ AC o AM n AG a AL t̪ AC ɪ AL r AN
donator	d̪ AC o AM n AG a AL t̪ AC ɔ AM r AN
donatur	d̪ AC o AM n AG a AL t̪ AC ʊ AM r AN
dongker	d AC ɔ AM ŋ AG k AC ə AL r AN
dop	d AC ɔ AM p AH
doping	d AC o AM p AH ɪ AL ŋ AG
dorslah	d AC ɔ AM r AN s AI l AE a AL h AA
dosir	d̪ AC o AM s AI ɪ AL r AN
draf	d̪ AC r AN a AL f BA
drai	d̪ AC r AN a AL i̯ AB
drainase	d̪ AC r AN a AL i AL n AG a AL s AI ə AL
drakor	d̪ AC r AN a AL k AC ɔ AM r AN
drama	d̪ AC r AN a AL m AF a AL
duaja	d AC u AM a AL d AC ʒ AI a AL
duet	d̪ AC u AM ɛ AL t̪̚
dugem	d AC u AM ɡ AC ə AL m AF
dup	d AC ʊ AM p AH
durhaka	d AC ʊ AM r AN h AA a AL k AC a AL
durjana	d̪ AC ʊ AM r AN d AC ʒ AI a AL n AG a AL
dus	d AC ʊ AM s AI
dusta	d̪ AC ʊ AM s AI t AC a AL
ebi	ɛ AL b AH i AL
eden	e AL d̪ AC ə AL n AG
edukasi	ɛ AL d AC u AM k AC a AL s AI i AL
efikasi	ɛ AL f BA i AL k AC a AL s AI i AL
eke	ɛ AL k AC ə AL
ekologi	e AL k AC o AM l AE o AM ɡ AC i AL
ekonomi	e AL k AC o AM n AG o AM m AF i AL
ekonomika	ɛ AL k AC o AM n AG o AM m AF i AL k AC a AL
eksamen	ɛ AL k AC s AI a AL m AF ə AL n AG
eksaminasi	ɛ AL k AC s AI a AL m AF i AL n AG a AL s AI i AL
eksekusi	ɛ AL k̚ s AI ə AL k AC u AM s AI i AL
eksekutif	ɛ AL k AC s AI ə AL k AC u AM t AC ɪ AL f BA
eksepsi	ɛ AL k AC s AI ɛ AL p̚ s AI i AL
eksis	ɛ AL k AC s AI ɪ AL s AI
eksit	ɛ AL ʔ AK s AI ɪ AL t AC
ekskavasi	ɛ AL k AC s AI k AC a AL v BA a AL s AI i AL
eksklusif	ɛ AL k AC s AI k AC l AE u AM s AI ɪ AL f BA
ekspedisi	ɛ AL x AI p AH ə AL d AC i AL s AI i AL
eksperimen	ɛ AL k AC s AI p AH ə AL r AN i AL m AF ɛ AL n AG
eksploit	ɛ AL x AI p AH l AE o AM ɪ AL t AC
ekspor	ɛ AL k AC s AI p AH ɔ AM r AN
ekstrak	ɛ AL k AC s AI t̪ AC r AN a AL k AC
ekstraksi	ɛ AL k AC s AI t̪ AC r AN a AL k AC s AI i AL
ekstraktif	ɛ AL k AC s AI t̪ AC r AN a AL k AC t AC ɪ AL f BA
ekstrem	ɛ AL k AC s AI t̪ AC r AN e AL m AF
elektorat	ɛ AL l AE ɛ AL k̚ t AC o AM r AN a AL t AC
elektronik	ɛ AL l AE ɛ AL k̚ t AC r AN o AM n AG ɪ AL k̚
elektronika	ɛ AL l AE ɛ AL k AC t AC r AN o AM n AG i AL k AC a AL
elektronis	ɛ AL l AE ɛ AL k̚ t AC r AN o AM n AG ɪ AL s AI
emat	ə AL m AF a AL t AC
ember	ɛ AL m AF b AH ɛ AL r AN
emisi	ɛ AL m AF i AL s AI i AL
emplasemen	ɛ AL m AF p AH l AE a AL s AI ə AL m AF ɛ AL n AG
enjin	ɛ AL n AG d AC ʒ AI ɪ AL n AG
ensiklopedia	e AL n AG s AI ɪ AL k AC l AE o AM p AH e AL d AC i AL a̯
entablatur	e AL n AG t AC a AL b AH l AE a AL t AC ʊ AM r AN
enten	ə AL n AG t AC ɛ AL n AG
entente	ɛ AL n AG t AC ɛ AL n AG t AC ə AL
entomolog	e AL n AG t̪ AC o AM m AF o AM l AE ɔ AM ɡ AC
entomologi	e AL n AG t̪ AC o AM m AF o AM l AE o AM ɡ AC i AL
entomologis	e AL n AG t̪ AC o AM m AF o AM l AE o AM ɡ AC ɪ AL s AI
entre	ɛ AL n AG t AC r AN ɛ AL
epidemi	ɛ AL p AH i AL d̪ AC ɛ AL m AF i AL
epistel	ɛ AL p AH ɪ AL s AI t AC ə AL l AE
epistola	ɛ AL p AH ɪ AL s AI t AC o AM l AE a AL
eropa	ə AL r AN o AM p AH a AL
eror	e AL r AN ɔ AM r AN
esai	ɛ AL s AI a AL i̯ AB
eselon	ɛ AL s AI ə AL l AE ɔ AM n AG
esens	ɛ AL s AI ɛ AL n AG s AI
esensi	ɛ AL s AI ɛ AL n AG s AI i AL
esensial	ɛ AL s AI ɛ AL n AG s AI i AL a AL l AE
eskalasi	ɛ AL s AI k AC a AL l AE a AL s AI i AL
eskalator	ɛ AL s AI k AC a AL l AE a AL t AC ɔ AM r AN
eskas	ɛ AL s AI k AC a AL s AI
estival	ɛ AL s AI t̪ AC i AL v BA a AL l AE
etanol	e AL t̪ AC a AL n AG ɔ AM l AE
etiket	ɛ AL t AC i AL k AC ɛ AL t̚
evangeli	ɛ AL v BA a AL ŋ AG ɡ AC e AL l AE i AL
faal	f BA a AL a AL l AE
fabel	f BA a AL b AH ə AL l AE
fabrik	f BA a AL b AH r AN ɪ AL k AC
fail	f BA a AL ɪ AL l AE
fakih	f BA a AL k AC ɪ AL h AA
faksi	f BA a AL k̚ s AI i AL
faktur	f BA a AL k̚ t AC ʊ AM r AN
fals	f BA a AL l AE ə̆ BB s AI
falsafah	f BA a AL l AE s AI a AL f BA a AL h AA
familisida	f BA a AL m AF i AL l AE i AL s AI i AL d AC a AL
famplet	f BA a AL m AF f BA l AE ɛ AL t̪̚
fanservis	f BA a AL n AG s AI ɛ AL r AN v BA ɪ AL s AI
farmakologi	f BA a AL r AN m AF a AL k AC o AM l AE o AM ɡ AC i AL
farmakologis	f BA a AL r AN m AF a AL k AC o AM l AE o AM ɡ AC ɪ AL s AI
farmasis	f BA a AL r AN m AF a AL s AI ɪ AL s AI
fas	f BA a AL s AI
fasad	f BA a AL s AI a AL t̪ AC
fasade	f BA a AL s AI a AL d AC ə AL
fase	f BA a AL s AI ə AL
faset	f BA a AL s AI ɛ AL t AC
fasilitas	f BA a AL s AI i AL l AE i AL t̪ AC a AL s AI
fatal	f BA a AL t AC a AL l AE
federal	f BA ɛ AL d AC ə AL r AN a AL l AE
federasi	f BA ɛ AL d AC ə AL r AN a AL s AI i AL
fekunditas	f BA e AL k AC ʊ AM n AG d̪ AC i AL t̪ AC a AL s AI
fesyen	f BA e AL ʃ AI ə AL n AG
fetor	f BA e AL t̪ AC ɔ AM r AN
figur	f BA i AL ɡ AC ʊ AM r AN
figura	f BA i AL ɡ AC u AM r AN a AL
filibuster	f BA i AL l AE i AL b AH ʊ AM s AI t AC ə AL r AN
film	f BA ɪ AL l AE m AF
filologi	f BA i AL l AE o AM l AE o AM ɡ AC i AL
filosofi	f BA i AL l AE o AM s AI o AM f BA i AL
filsafat	f BA ɪ AL l AE s AI a AL f BA a AL t̚
filsuf	f BA ɪ AL l AE s AI ʊ AM f BA
filter	f BA ɪ AL l AE t AC ə AL r AN
filtrasi	f BA ɪ AL l AE t AC r AN a AL s AI i AL
firdaus	f BA ɪ AL r AN d̪ AC a AL ʊ AM s AI
firma	f BA ɪ AL r AN m AF a AL
firman	f BA ɪ AL r AN m AF a AL n AG
fisik	f BA i AL s AI ɪ AL k AC
fisika	f BA i AL s AI i AL k AC a AL
fisiologi	f BA i AL s AI i AL o AM l AE o AM ɡ AC i AL
fisis	f BA i AL s AI ɪ AL s AI
fitur	f BA i AL t AC ʊ AM r AN
flambe	f BA l AE a AL m AF b AH e AL
fon	f BA ɔ AM n AG
fondasi	f BA ɔ AM n AG d̪ AC a AL s AI i AL
fora	f BA o AM r AN a AL
forensik	f BA o AM r AN ɛ AL n AG s AI i AL k AC
forma	f BA ɔ AM r AN m AF a AL
formasi	f BA ɔ AM r AN m AF a AL s AI i AL
format	f BA ɔ AM r AN m AF a AL t̪̚
formatur	f BA ɔ AM r AN m AF a AL t̪ AC ʊ AM r AN
forum	f BA o AM r AN ʊ AM m AF
foto	f BA o AM t̪ AC o AM
fotograf	f BA o AM t̪ AC o AM ɡ AC r AN a AL f BA
fotografer	f BA o AM t̪ AC o AM ɡ AC r AN a AL f BA ə AL r AN
fotografi	f BA o AM t̪ AC o AM ɡ AC r AN a AL f BA i AL
fotografis	f BA o AM t̪ AC o AM ɡ AC r AN a AL f BA ɪ AL s AI
fraksi	f BA r AN a AL k AC s AI i AL
fraktur	f BA r AN a AL k AC t̪ AC ʊ AM r AN
frasa	f BA r AN a AL s AI a AL
fulus	f BA u AM l AE ʊ AM s AI
fundamen	f BA ʊ AM n AG d̪ AC a AL m AF e AL n AG
fungsi	f BA ʊ AM ŋ AG s AI i AL
furnitur	f BA ʊ AM r AN n AG i AL t AC ʊ AM r AN
fusi	f BA u AM s AI i AL
futon	f BA u AM t AC ɔ AM n AG
gaban	ɡ AC a AL b AH a AL n AG
gaji	ɡ AC a AL d AC ʒ AI i AL
gancang	ɡ AC a AL n AG t AC ʃ AI a AL ŋ AG
ganco	ɡ AC a AL n AG t AC ʃ AI o AM
gancu	ɡ AC a AL n AG t AC ʃ AI u AM
ganda	ɡ AC a AL n AG d̪ AC a AL
gandum	ɡ AC a AL n AG d AC ʊ AM m AF
gangren	ɡ AC a AL ŋ AG r AN ɛ AL n AG
ganja	ɡ AC a AL n AG d AC ʒ AI a AL
ganjil	ɡ AC a AL n AG d AC ʒ AI ɪ AL l AE
garam	ɡ AC a AL r AN a AL m AF
garasi	ɡ AC a AL r AN a AL s AI i AL
garda	ɡ AC a AL r AN d AC a AL
gardan	ɡ AC a AL r AN d AC a AL n AG
gardu	ɡ AC a AL r AN d̪ AC u AM
garis	ɡ AC a AL r AN ɪ AL s AI
garisan	ɡ AC a AL r AN ɪ AL s AI a AL n AG
garnisun	ɡ AC a AL r AN n AG i AL s AI ʊ AM n AG
garpu	ɡ AC a AL r AN p AH u AM
gas	ɡ AC a AL s AI
gasal	ɡ AC a AL s AI a AL l AE
gatra	ɡ AC a AL t AC r AN a AL
gawai	ɡ AC a AL w AJ a AL i̯ AB
gede	ɡ AC ə AL d AC e AL
gehu	ɡ AC e AL h AA u AM
geiser	ɡ AC e AL i AL s AI ə AL r AN
gelana	ɡ AC ə AL l AE a AL n AG a AL
gelap	ɡ AC ə AL l AE a AL p AH
gelas	ɡ AC ə AL l AE a AL s AI
gembala	ɡ AC ə AL m AF b AH a AL l AE a AL
gembira	ɡ AC ə AL m AF b AH i AL r AN a AL
geminte	ɡ AC ə AL m AF i AL n AG t AC ə AL
genap	ɡ AC ə AL n AG a AL p AH
gendewa	ɡ AC ə AL n AG d̪ AC ɛ AL w AJ a AL
genius	ɡ AC e AL n AG i AL ʊ AM s AI
geofisika	ɡ AC e AL o AM f BA i AL s AI i AL k AC a AL
geografi	ɡ AC e AL o AM ɡ AC r AN a AL f BA i AL
geologi	ɡ AC e AL o AM l AE o AM ɡ AC i AL
geometri	ɡ AC e AL o AM m AF ɛ AL t AC r AN i AL
geram	ɡ AC ə AL r AN a AL m AF
gereja	ɡ AC ə AL r AN ɛ AL d AC ʒ AI a AL
gerendel	ɡ AC ə AL r AN ɛ AL n AG d AC ɛ AL l AE
gergaji	ɡ AC ə AL r AN ɡ AC a AL d AC ʒ AI i AL
gerigi	ɡ AC ə AL r AN i AL ɡ AC i AL
gerilya	ɡ AC ə AL r AN ɪ AL l AE j AB a AL
gerinda	ɡ AC ə AL r AN ɪ AL n AG d̪ AC a AL
geripir	ɡ AC ə AL r AN i AL p AH ɪ AL r AN
geta	ɡ AC ə AL t AC a AL
gi	ɡ AC i AL
gim	ɡ AC ɪ AL m AF
gincu	ɡ AC ɪ AL n AG t AC ʃ AI u AM
giok	ɡ AC i AL ɔ AM ʔ AK
girilaya	ɡ AC i AL r AN i AL l AE a AL j AB a AL
gizi	ɡ AC i AL z AI i AL
gliter	ɡ AC l AE i AL t̪ AC ə AL r AN
gocap	ɡ AC o AM t AC ʃ AI a AL p̚
goceng	ɡ AC o AM t AC ʃ AI ɛ AL ŋ AG
gocujang	ɡ AC o AM t AC ʃ AI u AM d AC ʒ AI a AL ŋ AG
gokil	ɡ AC o AM k AC ɪ AL l AE
goni	ɡ AC o AM n AG i AL
gonore	ɡ AC o AM n AG o AM r AN e AL
gorden	ɡ AC ɔ AM r AN d AC ɛ AL n AG
got	ɡ AC ɔ AM t AC
grad	ɡ AC r AN a AL t AC
gradasi	ɡ AC r AN a AL d AC a AL s AI i AL
gradien	ɡ AC r AN a AL d̪ AC i AL ɛ AL n AG
grafik	ɡ AC r AN a AL f BA i AL k̚
grafika	ɡ AC r AN a AL f BA i AL k AC a AL
grafis	ɡ AC r AN a AL f BA ɪ AL s AI
grasi	ɡ AC r AN a AL s AI i AL
gratis	ɡ AC r AN a AL t AC ɪ AL s AI
grendel	ɡ AC r AN ɛ AL n AG d AC ɛ AL l AE
guci	ɡ AC u AM t AC ʃ AI i AL
gul	ɡ AC ʊ AM l AE
gulma	ɡ AC ʊ AM l AE m AF a AL
hablur	h AA a AL p̚ l AE ʊ AM r AN
haid	h AA a AL ɪ AL t AC
hak	h AA a AL ʔ AK
halang	h AA a AL l AE a AL ŋ AG
halangan	h AA a AL l AE a AL ŋ AG a AL n AG
haleluya	h AA a AL l AE e AL l AE u AM j AB a AL
halsduk	h AA a AL l AE s AI d AC ʊ AM k̚
halte	h AA a AL l AE t AC ə AL
haminte	h AA a AL m AF i AL n AG t AC ə AL
hamper	h AA a AL m AF p AH ə AL r AN
hana	h AA a AL n AG a AL
hanami	h AA a AL n AG a AL m AF i AL
handai	h AA a AL n AG d̪ AC a AL i̯ AB
hanger	h AA a AL ŋ AG ə AL r AN
hanggar	h AA a AL ŋ AG ɡ AC a AL r AN
hartal	h AA a AL r AN t̪ AC a AL l AE
has	h AA a AL s AI
hawa	h AA a AL w AJ a AL
hem	h AA ɛ AL m AF
hemoroid	h AA e AL m AF o AM r AN o AM i AL t̚
hendel	h AA ɛ AL n AG d AC ə AL l AE
hepar	h AA e AL p AH a AL r AN
hidrologi	h AA ɪ AL t̪̚ r AN o AM l AE o AM ɡ AC i AL
hijau	h AA i AL d AC ʒ AI a AL u̯ AJ
hio	h AA i AL o̯ AJ
hipotek	h AA i AL p AH o AM t AC ɛ AL k AC
histori	h AA ɪ AL s AI t̪ AC o AM r AN i AL
historis	h AA ɪ AL s AI t̪ AC o AM r AN ɪ AL s AI
hoaks	h AA o AM a AL k AC s AI
hoki	h AA o AM k AC i AL
hook	h AA ʊ AM k̚
horizon	h AA o AM r AN i AL z AI ɔ AM n AG
hotel	h AA o AM t AC ɛ AL l AE
huakiau	h AA u AM a AL k AC i AL a AL u̯ AJ
hubungan	h AA u AM b AH ʊ AM ŋ AG a AL n AG
hujan	h AA u AM d AC ʒ AI a AL n AG
humaniora	h AA u AM m AF a AL n AG i AL o AM r AN a AL
hunkue	h AA ʊ AM n AG k AC u AM e̯ AB
hyang	hʲ AA a AL ŋ AG
ibu	ɪ AL b AH u AM
ide	i AL d̪ AC e AL
ideal	ɪ AL d̪ AC e AL a AL l AE
identitas	i AL d̪ AC ɛ AL n AG t̪ AC i AL t AC a AL s AI
ifumi	ɪ AL f BA u AM m AF i AL
ijmal	ɪ AL d AC ʒ AI m AF a AL l AE
ikhlas	i AL x AI l AE a AL s AI
ikhtiar	ɪ AL x AI t AC i AL a AL r AN
ikhtisar	ɪ AL x AI t̪ AC i AL s AI a AL r AN
ikon	i AL k AC ɔ AM n AG
ilmiah	ɪ AL l AE m AF i AL a AL h AA
ilmu	ɪ AL l AE m AF u AM
imigrasi	i AL m AF ɪ AL ɡ AC r AN a AL s AI i AL
imitasi	ɪ AL m AF i AL t AC a AL s AI i AL
imla	ɪ AL m AF l AE a AL
implikasi	ɪ AL m AF p AH l AE i AL k AC a AL s AI i AL
impor	ɪ AL m AF p AH ɔ AM r AN
impresi	ɪ AL m AF p AH r AN ɛ AL s AI i AL
impresif	ɪ AL m AF p AH r AN ɛ AL s AI ɪ AL f BA
inci	ɪ AL n AG t AC ʃ AI i AL
india	ɪ AL n AG d̪ AC i AL a̯
indikasi	ɪ AL n AG d AC i AL k AC a AL s AI i AL
indraloka	ɪ AL n AG d AC r AN a AL l AE o AM k AC a AL
infak	ɪ AL n AG f BA a AL k AC
infanteri	ɪ AL n AG f BA a AL n AG t AC ə AL r AN i AL
infeksi	ɪ AL n AG f BA ɛ AL k AC s AI i AL
informatika	ɪ AL n AG f BA ɔ AM r AN m AF a AL t̪ AC i AL k AC a AL
inhalasi	ɪ AL n AG h AA a AL l AE a AL s AI i AL
inisiatif	ɪ AL n AG i AL s AI i AL a AL t AC ɪ AL f BA
injeksi	ɪ AL n AG d AC ʒ AI ɛ AL k AC s AI i AL
inkrah	ɪ AL n AG k AC r AN a AL h AA
inkues	ɪ AL n AG k AC u AM ɛ AL s AI
inlander	ɪ AL n AG l AE a AL n AG d̪ AC ə AL r AN
inokulasi	i AL n AG o AM k AC u AM l AE a AL s AI i AL
inovasi	ɪ AL n AG o AM v BA a AL s AI i AL
insan	ɪ AL n AG s AI a AL n AG
insek	ɪ AL n AG s AI ɛ AL k AC
insentif	ɪ AL n AG s AI ɛ AL n AG t AC ɪ AL f BA
insinyur	ɪ AL n AG s AI i AL ɲ AG ʊ AM r AN
inspeksi	ɪ AL n AG s AI p AH ɛ AL k̚ s AI i AL
inspektur	ɪ AL n AG s AI p AH ɛ AL k̚ t AC ʊ AM r AN
instalasi	ɪ AL n AG s AI t AC a AL l AE a AL s AI i AL
instan	ɪ AL n AG s AI t AC a AL n AG
instansi	ɪ AL n AG s AI t AC a AL n AG s AI i AL
institut	ɪ AL n AG s AI t AC i AL t AC ʊ AM t AC
intan	ɪ AL n AG t AC a AL n AG
integrasi	ɪ AL n AG t AC ə AL ɡ AC r AN a AL s AI i AL
inteligensi	ɪ AL n AG t AC ə AL l AE i AL d AC ʒ AI ɛ AL n AG s AI i AL
inteligensia	ɪ AL n AG t AC ə AL l AE i AL d AC ʒ AI ɛ AL n AG s AI i AL a̯
intelijen	ɪ AL n AG t AC ə AL l AE i AL d AC ʒ AI ɛ AL n AG
interaksi	ɪ AL n AG t AC ə AL r AN a AL k̚ s AI i AL
internat	ɪ AL n AG t AC ə AL r AN n AG a AL t AC
internir	ɪ AL n AG t AC ə AL r AN n AG ɪ AL r AN
interpelasi	ɪ AL n AG t AC ə AL r AN p AH ɛ AL l AE a AL s AI i AL
interpretasi	ɪ AL n AG t̪ AC ə AL r AN p AH r AN ə AL t̪ AC a AL s AI i AL
interpretatif	ɪ AL n AG t̪ AC ə AL r AN p AH r AN ə AL t̪ AC a AL t̪ AC ɪ AL f BA
introdusir	ɪ AL n AG t AC r AN o AM d AC u AM s AI ɪ AL r AN
intuisi	ɪ AL n AG t AC u AM i AL s AI i AL
intuitif	ɪ AL n AG t AC u AM i AL t AC ɪ AL f BA
invalid	ɪ AL n AG v BA a AL l AE ɪ AL t AC
invasi	ɪ AL n AG v BA a AL s AI i AL
investigasi	ɪ AL n AG v BA ɛ AL s AI t AC i AL ɡ AC a AL s AI i AL
invois	ɪ AL n AG v BA o AM ɪ AL s AI
irak	i AL r AN a AL k̚
iran	i AL r AN a AL n AG
irigasi	ɪ AL r AN i AL ɡ AC a AL s AI i AL
isaril	ɪ AL s AI r AN a AL ɪ AL l AE
isolasi	i AL s AI o AM l AE a AL s AI i AL
israel	ɪ AL s AI r AN a AL e AL l AE
istal	ɪ AL s AI t AC a AL l AE
iuran	i AL ʊ AM r AN a AL n AG
izin	i AL z AI ɪ AL n AG
jabatan	d AC ʒ AI a AL b AH a AL t AC a AL n AG
jago	d AC ʒ AI a AL ɡ AC o AM
jagra	d AC ʒ AI a AL ɡ AC r AN a AL
jajan	d AC ʒ AI a AL d AC ʒ AI a AL n AG
jaket	d AC ʒ AI a AL k AC ɛ AL t AC
jaksa	d AC ʒ AI a AL k̚ s AI a AL
jalang	d AC ʒ AI a AL l AE a AL ŋ AG
jalur	d AC ʒ AI a AL l AE ʊ AM r AN
jam	d AC ʒ AI a AL m AF
jambu	d AC ʒ AI a AL m AF b AH u AM
janda	d AC ʒ AI a AL n AG d̪ AC a AL
jangkar	d AC ʒ AI a AL ŋ AG k AC a AL r AN
janji	d AC ʒ AI a AL n AG d AC ʒ AI i AL
jannah	d AC ʒ AI a AL n AG n AG a AL h AA
jari	ɟ AC ä ɾ BC ɪ AL
jaringan	d AC ʒ AI a AL r AN ɪ AL ŋ AG a AL n AG
jasa	d AC ʒ AI a AL s AI a AL
jatarupa	d AC ʒ AI a AL t AC a AL r AN u AM p AH a AL
jawatan	d AC ʒ AI a AL w AJ a AL t AC a AL n AG
jaya	d AC ʒ AI a AL j AB a AL
jejak	d AC ʒ AI ə AL d AC ʒ AI a AL ʔ AK
jemaah	d AC ʒ AI ə AL m AF a AL a AL h AA
jemaat	d AC ʒ AI ə AL m AF a AL a AL t AC
jendela	d AC ʒ AI ə AL n AG d̪ AC ɛ AL l AE a AL
jenderal	d AC ʒ AI ə AL n AG d̪ AC ə AL r AN a AL l AE
jenuh	d AC ʒ AI ə AL n AG ʊ AM h AA
jeriken	d AC ʒ AI ɛ AL r AN i AL k AC ɛ AL n AG
jibun	d AC ʒ AI i AL b AH ʊ AM n AG
jimat	d AC ʒ AI i AL m AF a AL t AC
jinayah	d AC ʒ AI i AL n AG a AL j AB a AL h AA
jingga	d AC ʒ AI ɪ AL ŋ AG ɡ AC a AL
jip	d AC ʒ AI ɪ AL p AH
johan	j AB o AM h AA a AL n AG
jok	d AC ʒ AI ɔ AM ʔ AK
joki	d AC ʒ AI o AM k AC i AL
jubah	j AB u AM b AH a AL h AA
juhi	d AC ʒ AI u AM h AA i AL
junior	d AC ʒ AI u AM n AG i AL ɔ AM r AN
jurnal	d AC ʒ AI ʊ AM r AN n AG a AL l AE
jus	d AC ʒ AI ʊ AM s AI
kabel	k AC a AL b AH ə AL l AE
kacang	k AC a AL t AC ʃ AI a AL ŋ AG
kacau	k AC a AL c AC a AL u̯ AJ
kacoa	k AC a AL t AC ʃ AI o AM a AL
kacoak	k AC a AL t AC ʃ AI o AM a AL ʔ AK
kader	k AC a AL d AC ə AL r AN
kadera	k AC a AL d̪ AC ɛ AL r AN a AL
kadet	k AC a AL d AC ɛ AL t AC
kado	k AC a AL d AC o AM
kafe	k AC a AL f BA e AL
kafir	k AC a AL f BA ɪ AL r AN
kahak	k AC a AL h AA a AL k AC
kail	k AC a AL ɪ AL l AE
kain	k AC a AL ɪ AL n AG
kakao	k AC a AL k AC a AL o̯ AJ
kakawin	k AC a AL k AC a AL w AJ ɪ AL n AG
kakerlak	k AC a AL k AC ə AL r AN l AE a AL k̚
kaladuta	k AC a AL l AE a AL d AC u AM t AC a AL
kalah	k AC a AL l AE a AL h AA
kalajengking	k AC a AL l AE a AL d AC ʒ AI ə AL ŋ AG k AC i AL ŋ AG
kaldu	k AC a AL l AE d̪ AC u AM
kalem	k AC a AL l AE ə AL m AF
kalender	k AC a AL l AE ɛ AL n AG d AC ə AL r AN
kaliber	k AC a AL l AE i AL b AH ə AL r AN
kalimantan	k AC a AL l AE i AL m AF a AL n AG t AC a AL n AG
kalimat	k AC a AL l AE i AL m AF a AL t̚
kalk	k AC a AL l AE ə̆ BB ʔ AK
kalkir	k AC a AL l AE k AC ɪ AL r AN
kalor	k AC a AL l AE ɔ AM r AN
kamar	k AC a AL m AF a AL r AN
kamboja	k AC a AL m AF b AH o AM d AC ʒ AI a AL
kamera	k AC a AL m AF ɛ AL r AN a AL
kamerad	k AC a AL m AF ə AL r AN a AL t̪̚
kamisa	k AC a AL m AF i AL s AI a AL
kamp	k AC a AL m AF p AH
kampanye	k AC a AL m AF p AH a AL ɲ AG ə AL
kampas	k AC a AL m AF p AH a AL s AI
kamping	k AC a AL m AF p AH ɪ AL ŋ AG
kampiun	k AC a AL m AF p AH i AL u AM n AG
kampus	k AC a AL m AF p AH ʊ AM s AI
kamrad	k AC a AL m AF r AN a AL t̪̚
kamsen	k AC a AL m AF s AI ɛ AL n AG
kamsia	k AC a AL m AF s AI i AL a̯
kanal	k AC a AL n AG a AL l AE
kanan	k AC a AL n AG a AL n AG
kanca	k AC a AL n AG t AC ʃ AI a AL
kandang	k AC a AL n AG d̪ AC a AL ŋ AG
kangen	k AC a AL ŋ AG ə AL n AG
kangkung	k AC a AL ŋ AG k AC ʊ AM ŋ AG
kangsa	k AC a AL ŋ AG s AI a AL
kanker	k AC a AL ŋ AG k AC ə AL r AN
kanon	k AC a AL n AG ɔ AM n AG
kans	k AC a AL n AG s AI
kansel	k AC a AL n AG s AI ə AL l AE
kanselir	k AC a AL n AG s AI ə AL l AE ɪ AL r AN
kanser	k AC a AL n AG s AI ə AL r AN
kanvas	k AC a AL n AG v BA a AL s AI
kaos	k AC a AL ɔ AM s AI
kapasitor	k AC a AL p AH a AL s AI i AL t AC ɔ AM r AN
kapitalis	k AC a AL p AH i AL t AC a AL l AE ɪ AL s AI
kapitulasi	k AC a AL p AH i AL t AC u AM l AE a AL s AI i AL
kapuk	k AC a AL p AH u AM ʔ AK
karang	k AC a AL r AN a AL ŋ AG
karantina	k AC a AL r AN a AL n AG t AC i AL n AG a AL
karat	k AC a AL r AN a AL t̪̚
karcis	k AC a AL r AN t AC ʃ AI ɪ AL s AI
kardus	k AC a AL r AN d AC ʊ AM s AI
karena	k AC a AL r AN ə AL n AG a AL
karet	k AC a AL r AN ɛ AL t AC
karier	k AC a AL r AN i AL ɛ AL r AN
karisma	k AC a AL r AN ɪ AL s AI m AF a AL
karper	k AC a AL r AN p AH ə AL r AN
karti	k AC a AL r AN t̪ AC i AL
karton	k AC a AL r AN t AC ɔ AM n AG
kartotek	k AC a AL r AN t AC o AM t AC ɛ AL k AC
karung	k AC a AL r AN ʊ AM ŋ AG
karyawan	k AC a AL r AN j AB a AL w AJ a AL n AG
kas	k AC a AL s AI
kasa	k AC a AL s AI a AL
kasasi	k AC a AL s AI a AL s AI i AL
kasi	k AC a AL s AI i AL
kasir	k AC a AL s AI ɪ AL r AN
kasta	k AC a AL s AI t̪ AC a AL
kasti	k AC a AL s AI t AC i AL
kasus	k AC a AL s AI ʊ AM s AI
kataka	k AC a AL t AC a AL k AC a AL
katakomba	k AC a AL t AC a AL k AC ɔ AM m AF b AH a AL
katalis	k AC a AL t AC a AL l AE ɪ AL s AI
katalisator	k AC a AL t AC a AL l AE i AL s AI a AL t AC ɔ AM r AN
katalog	k AC a AL t AC a AL l AE ɔ AM ɡ AC
katapel	k AC a AL t AC a AL p AH ɛ AL l AE
katarsis	k AC a AL t AC a AL r AN s AI ɪ AL s AI
katekis	k AC a AL t AC ə AL k AC ɪ AL s AI
katekumen	k AC a AL t AC ə AL k AC u AM m AF ə AL n AG
katering	k AC a AL t AC ə AL r AN ɪ AL ŋ AG
katolik	k AC a AL t AC o AM l AE ɪ AL k AC
katrij	k AC a AL t AC r AN ɪ AL d AC ʒ AI
katrol	k AC a AL t AC r AN ɔ AM l AE
katwal	k AC a AL t̚ w AJ a AL l AE
kaus	k AC a AL ʊ AM s AI
kaveling	k AC a AL v BA ə AL l AE ɪ AL ŋ AG
kawi	k AC a AL w AJ i AL
kawin	k AC a AL w AJ ɪ AL n AG
kaya	k AC a AL j AB a AL
kayak	k AC a AL j AB a AL ʔ AK
kayangan	k AC a AL j AB a AL ŋ AG a AL n AG
keamanan	k AC ə AL a AL m AF a AL n AG a AL n AG
kecemasan	k AC ə AL t AC ʃ AI ə AL m AF a AL s AI a AL n AG
kecoa	k AC ə AL t AC ʃ AI o AM a AL
kecoak	k AC ə AL t AC ʃ AI o AM a AL ʔ AK
kecuak	k AC ə AL t AC ʃ AI u AM a AL ʔ AK
kedai	k AC ə AL d AC a AL i̯ AB
kedelai	k AC ə AL d AC ə AL l AE a AL i̯ AB
kedewaan	k AC ə AL d AC ɛ AL w AJ a AL a̯ n AG
keindraan	k AC ə AL ɪ AL n AG d AC r AN a AL a AL n AG
kejahatan	k AC ə AL d AC ʒ AI a AL h AA a AL t̪̚ a AL n AG
kejaksaan	k AC ə AL d AC ʒ AI a AL k̚ s AI a AL a AL n AG
keju	k AC e AL d AC ʒ AI u AM
keki	k AC ɛ AL k AC i AL
kelahi	k AC ə AL l AE a AL h AA i AL
kelam	k AC ə AL l AE a AL m AF
kelas	k AC ə AL l AE a AL s AI
kelasi	k AC ə AL l AE a AL s AI i AL
kelebut	k AC ə AL l AE ə AL b AH ʊ AM t̚
keledai	k AC ə AL l AE ə AL d AC a AL i̯ AB
kelenteng	k AC ə AL l AE ɛ AL n AG t AC ɛ AL ŋ AG
kelir	k AC ə AL l AE ɪ AL r AN
kelos	k AC ə AL l AE ɔ AM s AI
keluyuk	k AC ə AL l AE u AM j AB ʊ AM k AC
kemalangan	k AC ə AL m AF a AL l AE a AL ŋ AG a AL n AG
kembara	k AC ə AL m AF b AH a AL r AN a AL
kemboja	k AC ə AL m AF b AH o AM d AC ʒ AI a AL
kemeja	k AC ə AL m AF ɛ AL d AC ʒ AI a AL
kementerian	k AC ə AL m AF ə AL n AG t AC ə AL r AN i AL a AL n AG
kemiri	k AC ə AL m AF i AL r AN i AL
kemoceng	k AC ə AL m AF o AM t AC ʃ AI ɛ AL ŋ AG
kempa	k AC ə AL m AF p AH a AL
kempo	k AC ɛ AL m AF p AH o AM
kemudi	k AC ə AL m AF u AM d̪ AC i AL
kencang	k AC ə AL n AG t AC ʃ AI a AL ŋ AG
kenceng	k AC ɛ AL n AG t AC ʃ AI ɛ AL ŋ AG
kendali	k AC ə AL n AG d̪ AC a AL l AE i AL
kendara	k AC ə AL n AG d AC a AL r AN a AL
kenduri	k AC ə AL n AG d AC u AM r AN i AL
kenop	k AC ə AL n AG ɔ AM p AH
kensel	k AC ɛ AL n AG s AI ə AL l AE
kental	k AC ə AL n AG t AC a AL l AE
kentut	k AC ə AL n AG t AC ʊ AM t AC
kepegawaian	k AC ə AL p AH ə AL ɡ AC a AL w AJ a AL i̯ AB a AL n AG
kepo	k AC ɛ AL p AH o AM
kepsek	k AC ə AL p̚ s AI ə AL k̚
kerah	k AC ə AL r AN a AL h AA
keran	k AC ə AL r AN a AL n AG
kerangkeng	k AC ə AL r AN a AL ŋ AG k AC ɛ AL ŋ AG
kerani	k AC ə AL r AN a AL n AG i AL
kereta	k AC ə AL r AN ɛ AL t̪ AC a AL
kerja	k AC ə AL r AN d AC ʒ AI a AL
kerkop	k AC ə AL r AN k AC ɔ AM p AH
kermi	k AC ə AL r AN m AF i AL
keron	k AC ə AL r AN ɔ AM n AG
kerul	k AC ə AL r AN ʊ AM l AE
kerun	k AC ə AL r AN ʊ AM n AG
kes	k AC ɛ AL s AI
kesatria	k AC ə AL s AI a AL t AC r AN i AL a̯
kesatuan	k AC ə AL s AI a AL t̪ AC u AM a̯ n AG
keselamatan	k AC ə AL s AI ə AL l AE a AL m AF a AL t̪ AC a AL n AG
keskul	k AC ə AL s AI k AC ʊ AM l AE
kesumba	k AC ə AL s AI ʊ AM m AF b AH a AL
ketel	k AC ɛ AL t̪ AC ɛ AL l AE
ketenteraman	k AC ə AL t̪ AC ə AL n AG t̪ AC ə AL r AN a AL m AF a AL n AG
keti	k AC ə AL t̪ AC i AL
khalwat	x AI a AL l AE w AJ a AL t̚
khanjar	x AI a AL n AG d AC ʒ AI a AL r AN
khas	x AI a AL s AI
khasi	x AI a AL s AI i AL
khayal	x AI a AL j AB a AL l AE
khianat	x AI i AL a AL n AG a AL t̪̚
khitan	x AI i AL t̪ AC a AL n AG
khoja	x AI o AM d AC ʒ AI a AL
khotbah	kʰ AD ɔ AM t̪̚ b AH a AL h AA
kia	k AC i AL a̯
kiani	k AC i AL a AL n AG i AL
kilat	k AC i AL l AE a AL t̪̚
kiln	k AC ɪ AL l AE ə̆ BB n AG
kimci	k AC ɪ AL m AF t AC ʃ AI i AL
kimia	k AC i AL m AF i AL a̯
kio	k AC i AL o̯ AJ
kios	k AC i AL ɔ AM s AI
kiper	k AC i AL p AH ə AL r AN
kipsiau	k AC ɪ AL p AH s AI i AL a AL u̪
kir	k AC ɪ AL r AN
kisah	k AC i AL s AI a AL h AA
kismis	k AC ɪ AL s AI m AF ɪ AL s AI
kista	k AC ɪ AL s AI t AC a AL
klab	k AC l AE a AL p̚
klaim	k AC l AE a AL ɪ̯ AB m AF
klan	k AC l AE a AL n AG
klapertar	k AC l AE a AL p AH ə AL r AN t AC a AL r AN
klasik	k AC l AE a AL s AI ɪ AL k AC
klasis	k AC l AE a AL s AI ɪ AL s AI
klaster	k AC l AE a AL s AI t AC ə AL r AN
klausa	k AC l AE a AL u̯ AJ s AI a AL
klerek	k AC l AE e AL r AN ə AL k AC
klien	k AC l AE i AL ə AL n AG
klik	k AC l AE ɪ AL k̚
klinik	k AC l AE i AL n AG ɪ AL k AC
klinisi	k AC l AE i AL n AG i AL s AI i AL
kliring	k AC l AE i AL r AN ɪ AL ŋ AG
klise	k AC l AE i AL s AI ə AL
klub	k AC l AE ʊ AM p AH
kluster	k AC l AE ʊ AM s AI t AC ə AL r AN
knop	k AC ə AL n AG ɔ AM p̚
koalisi	k AC o AM a AL l AE i AL s AI i AL
kober	k AC o AM b AH ə AL r AN
kode	k AC o AM d AC ə AL
kodi	k AC o AM d̪ AC i AL
kodifikasi	k AC o AM d AC i AL f BA i AL k AC a AL s AI i AL
koefisien	k AC o AM ɛ AL f BA i AL s AI i AL ɛ AL n AG
kohor	k AC o AM h AA ɔ AM r AN
koin	k AC o AM ɪ AL n AG
kok	k AC o AM ʔ AK
kol	k AC ɔ AM l AE
kolaborasi	k AC o AM l AE a AL b AH o AM r AN a AL s AI i AL
kolaps	k AC o AM l AE a AL p AH s AI
kolegium	k AC o AM l AE e AL ɡ AC i AL ʊ AM m AF
koleksi	k AC o AM l AE ɛ AL k AC s AI i AL
kolekte	k AC o AM l AE ɛ AL k AC t AC ə AL
kolese	k AC o AM l AE e AL s AI ə AL
kolf	k AC ɔ AM l AE f BA
koloke	k AC o AM l AE o AM k AC e AL
kolokium	k AC o AM l AE o AM k AC i AL ʊ AM m AF
kolom	k AC o AM l AE ɔ AM m AF
kolone	k AC o AM l AE o AM n AG ə AL
koloni	k AC o AM l AE o AM n AG i AL
kolportir	k AC ɔ AM l AE p AH ɔ AM r AN t AC ɪ AL r AN
koma	k AC o AM m AF a AL
koman	k AC o AM m AF a AL n AG
komanditer	k AC o AM m AF a AL n AG d AC i AL t AC ɛ AL r AN
komando	k AC o AM m AF a AL n AG d AC o AM
kombuca	k AC ɔ AM m AF b AH u AM t AC ʃ AI a AL
kombukha	k AC ɔ AM m AF b AH u AM x AI a AL
komen	k AC o AM m AF ɛ AL n AG
komendur	k AC o AM m AF ə AL n AG d AC ʊ AM r AN
komentar	k AC o AM m AF ɛ AL n AG t̪ AC a AL r AN
komik	k AC o AM m AF ɪ AL k AC
komika	k AC o AM m AF i AL k AC a AL
komisar	k AC o AM m AF i AL s AI a AL r AN
komisaris	k AC o AM m AF i AL s AI a AL r AN ɪ AL s AI
komisioner	k AC o AM m AF i AL s AI i AL o AM n AG ɛ AL r AN
komitmen	k AC o AM m AF ɪ AL t AC m AF ə AL n AG
kompak	k AC ɔ AM m AF p AH a AL k AC
kompeni	k AC o AM m AF p AH ə AL n AG i AL
kompleks	k AC ɔ AM m AF p AH l AE ɛ AL k AC s AI
komponen	k AC ɔ AM m AF p AH o AM n AG ɛ AL n AG
komponis	k AC ɔ AM m AF p AH o AM n AG ɪ AL s AI
kompor	k AC ɔ AM m AF p AH ɔ AM r AN
komprehensif	k AC ɔ AM m AF p AH r AN e AL h AA ɛ AL n AG s AI ɪ AL f BA
komputer	k AC ɔ AM m AF p AH u AM t AC ə AL r AN
komunal	k AC o AM m AF u AM n AG a AL l AE
komune	k AC o AM m AF u AM n AG ə AL
komuni	k AC o AM m AF u AM n AG i AL
komunisme	k AC o AM m AF u AM n AG ɪ AL s AI m AF ə AL
komunistis	k AC o AM m AF u AM n AG ɪ AL s AI t̪ AC ɪ AL s AI
komunitas	k AC o AM m AF u AM n AG i AL t AC a AL s AI
kondensator	k AC ɔ AM n AG d AC ɛ AL n AG s AI a AL t AC ɔ AM r AN
kondisi	k AC ɔ AM n AG d AC i AL s AI i AL
konduite	k AC ɔ AM n AG d̪ AC u AM i AL t AC ə AL
konfeksi	k AC ɔ AM n AG f BA ɛ AL k̚ s AI i AL
kongko	k AC ɔ AM ŋ AG k AC o AM
kongkoan	k AC ɔ AM ŋ AG k AC o AM a AL n AG
kongregasi	k AC ɔ AM ŋ AG r AN e AL ɡ AC a AL s AI i AL
kongres	k AC ɔ AM ŋ AG r AN ɛ AL s AI
kongsi	k AC ɔ AM ŋ AG s AI i AL
konkret	k AC ɔ AM n AG k AC r AN ɛ AL t AC
konkuisnador	k AC ɔ AM n AG k AC u AM ɪ AL s AI n AG a AL d AC ɔ AM r AN
konsesi	k AC ɔ AM n AG s AI ɛ AL s AI i AL
konsil	k AC ɔ AM n AG s AI ɪ AL l AE
konsili	k AC ɔ AM n AG s AI i AL l AE i AL
konsinyasi	k AC ɔ AM n AG s AI i AL ɲ AG a AL s AI i AL
konsistori	k AC ɔ AM n AG s AI ɪ AL s AI t AC o AM r AN i AL
konstanta	k AC ɔ AM n AG s AI t AC a AL n AG t AC a AL
konstituante	k AC ɔ AM n AG s AI t̪ AC i AL t̪ AC u AM a AL n AG t̪ AC ə AL
konstituen	k AC ɔ AM n AG s AI t̪ AC i AL t̪ AC u AM ɛ AL n AG
konstitusi	k AC ɔ AM n AG s AI t AC i AL t AC u AM s AI i AL
konstitusional	k AC ɔ AM n AG s AI t AC i AL t AC u AM s AI i AL o AM n AG a AL l AE
konstruksi	k AC ɔ AM n AG s AI t AC r AN ʊ AM k AC s AI i AL
konsumsi	k AC o AM n AG s AI u AM m AF s AI i AL
kontak	k AC o AM n AG t AC a AL k̚
kontaminasi	k AC ɔ AM n AG t̪ AC a AL m AF i AL n AG a AL s AI i AL
kontan	k AC ɔ AM n AG t AC a AL n AG
konter	k AC ɔ AM n AG t AC ə AL r AN
kontinen	k AC ɔ AM n AG t̪ AC i AL n AG ɛ AL n AG
kontrak	k AC ɔ AM n AG t AC r AN a AL k AC
kontribusi	k AC ɔ AM n AG t̪ AC r AN i AL b AH u AM s AI i AL
kontrol	k AC ɔ AM n AG t AC r AN ɔ AM l AE
kontrolir	k AC ɔ AM n AG t AC r AN o AM l AE ɪ AL r AN
konveksi	k AC ɔ AM n AG v BA ɛ AL k AC s AI i AL
konvensi	k AC ɔ AM n AG v BA ɛ AL n AG s AI i AL
konyan	k AC o AM ɲ AG a AL n AG
kopel	k AC o AM p AH ə AL l AE
kopling	k AC o AM p̚ l AE i AL ŋ AG
koran	k AC o AM r AN a AL n AG
korban	k AC ɔ AM r AN b AH a AL n AG
korea	k AC ɔ AM r AN e AL a̯
koreksi	k AC o AM r AN ɛ AL k AC s AI i AL
korma	k AC ɔ AM r AN m AF a AL
korona	k AC o AM r AN o AM n AG a AL
korporasi	k AC ɔ AM r AN p AH o AM r AN a AL s AI i AL
korsi	k AC ɔ AM r AN s AI i AL
korting	k AC ɔ AM r AN t AC ɪ AL ŋ AG
kos	k AC ɔ AM s AI
kosen	k AC o AM s AI ɛ AL n AG
koteng	k AC o AM t AC ɛ AL ŋ AG
koyok	k AC o AM j AB ɔ AM ʔ AK
kram	k AC r AN a AL m AF
krat	k AC r AN a AL t̪̚
kreasi	k AC r AN ɛ AL a AL s AI i AL
kreatif	k AC r AN ɛ AL a AL t AC ɪ AL f BA
kreativitas	k AC r AN ɛ AL a AL t AC i AL v BA i AL t AC a AL s AI
kredit	k AC r AN ɛ AL d AC ɪ AL t̪̚
kreditan	k AC r AN e AL d̪ AC i AL t̪ AC a AL n AG
kreditor	k AC r AN ɛ AL d AC i AL t̪ AC ɔ AM r AN
kreditur	k AC r AN ɛ AL d AC i AL t̪ AC ʊ AM r AN
krem	k AC r AN ɛ AL m AF
kremasi	k AC r AN ɛ AL m AF a AL s AI i AL
kres	k AC r AN ɛ AL s AI
krim	k AC r AN ɪ AL m AF
kriminal	k AC r AN i AL m AF i AL n AG a AL l AE
kriminil	k AC r AN i AL m AF i AL n AG ɪ AL l AE
krisis	k AC r AN i AL s AI ɪ AL s AI
krisma	k AC r AN ɪ AL s AI m AF a AL
kristal	k AC r AN ɪ AL s AI t AC a AL l AE
kritik	k AC r AN i AL t̪ AC ɪ AL k AC
kritikus	k AC r AN i AL t̪ AC i AL k AC ʊ AM s AI
kritis	k AC r AN i AL t̪ AC ɪ AL s AI
kritisi	k AC r AN i AL t̪ AC i AL s AI i AL
kriya	k AC r AN i AL j AB a AL
kroket	k AC r AN o AM k AC ɛ AL t̚
kromo	k AC r AN ɔ AM m AF ɔ AM
kronis	k AC r AN o AM n AG ɪ AL s AI
kronologi	k AC r AN o AM n AG o AM l AE o AM ɡ AC i AL
kronologis	k AC r AN o AM n AG o AM l AE o AM ɡ AC ɪ AL s AI
kru	k AC r AN u AM
kuaci	k AC u AM a̯ t AC ʃ AI i AL
kuali	k AC u AM a̯ l AE i AL
kualitas	k AC u AM a AL l AE i AL t AC a AL s AI
kuasa	k AC u AM a AL s AI a AL
kubah	k AC u AM b AH a AL h AA
kubis	k AC u AM b AH ɪ AL s AI
kubur	k AC u AM b AH ʊ AM r AN
kuburan	k AC u AM b AH ʊ AM r AN a AL n AG
kubus	k AC u AM b AH ʊ AM s AI
kue	k AC u AM e̯ AB
kueri	k AC u AM ɛ AL r AN i AL
kuesioner	k AC u AM ɛ AL s AI i AL o AM n AG ɛ AL r AN
kuis	k AC u AM ɪ AL s AI
kuisioner	k AC u AM ɪ AL s AI i AL o AM n AG ɛ AL r AN
kulkas	k AC ʊ AM l AE k AC a AL s AI
kulpa	k AC ʊ AM l AE p AH a AL
kultur	k AC ʊ AM l AE t AC ʊ AM r AN
kuluyuk	k AC u AM l AE u AM j AB ʊ AM k AC
kuman	k AC u AM m AF a AL n AG
kumba	k AC ʊ AM m AF b AH a AL
kumbakara	k AC ʊ AM m AF b AH a AL k AC a AL r AN a AL
kunci	k AC ʊ AM n AG t AC ʃ AI i AL
kungfu	k AC ʊ AM ŋ AG f BA u AM
kunyit	k AC u AM ɲ AG ɪ AL t̚
kuota	k AC u AM o AM t AC a AL
kuotum	k AC u AM o AM t AC ʊ AM m AF
kuplet	k AC ʊ AM p AH l AE ɛ AL t̪̚
kurban	k AC ʊ AM r AN b AH a AL n AG
kuria	k AC u AM r AN i AL a̯
kurir	k AC u AM r AN ɪ AL r AN
kurkuma	k AC ʊ AM r AN k AC u AM m AF a AL
kurma	k AC ʊ AM r AN m AF a AL
kursi	k AC ʊ AM r AN s AI i AL
kursus	k AC u AM r AN s AI u AM s AI
kurus	k AC u AM r AN ʊ AM s AI
kurva	k AC ʊ AM r AN v BA a AL
kusala	k AC u AM s AI a AL l AE a AL
kutu	k AC u AM t AC u AM
kwetiau	k AC w AJ e AL t AC i AL a AL u AM
laba	l AE a AL b AH a AL
laboratorium	l AE a AL b AH o AM r AN a AL t AC o AM r AN i AL ʊ AM m AF
lacur	l AE a AL t AC ʃ AI ʊ AM r AN
laga	l AE a AL ɡ AC a AL
lagu	l AE a AL ɡ AC u AM
lakban	l AE a AL k̚ b AH a AL n AG
lakmus	l AE a AL k AC m AF ʊ AM s AI
lamina	l AE a AL m AF i AL n AG a AL
lampion	l AE a AL m AF p AH i AL ɔ AM n AG
lampu	l AE a AL m AF p AH u AM
lanbau	l AE a AL n AG b AH a AL u̯ AJ
lancang	l AE a AL n AG t AC ʃ AI a AL ŋ AG
lancar	l AE a AL n AG t AC ʃ AI a AL r AN
langgar	l AE a AL ŋ AG ɡ AC a AL r AN
langsam	l AE a AL ŋ AG s AI a AL m AF
langsir	l AE a AL ŋ AG s AI ɪ AL r AN
lanhir	l AE a AL n AG h AA ɪ AL r AN
lansir	l AE a AL n AG s AI ɪ AL r AN
lanskap	l AE a AL n AG s AI k AC a AL p̚
lapor	l AE a AL p AH ɔ AM r AN
laporan	l AE a AL p AH ɔ AM r AN a AL n AG
las	l AE a AL s AI
lata	l AE a AL t AC a AL
latah	l AE a AL t̪ AC a AL h AA
laut	l AE a AL ʊ AM t̪̚
layar	l AE a AL j AB a AL r AN
leding	l AE ɛ AL d AC ɪ AL ŋ AG
legal	l AE ɛ AL ɡ AC a AL l AE
legasi	l AE ɛ AL ɡ AC a AL s AI i AL
legislasi	l AE ɛ AL ɡ AC ɪ AL s AI l AE a AL s AI i AL
legislatif	l AE ɛ AL ɡ AC ɪ AL s AI l AE a AL t AC ɪ AL f BA
legitimasi	l AE ɛ AL ɡ AC i AL t AC i AL m AF a AL s AI i AL
lektur	l AE ɛ AL k AC t AC ʊ AM r AN
lem	l AE ɛ AL m AF
lemari	l AE ə AL m AF a AL r AN i AL
lembaga	l AE ə AL m AF b AH a AL ɡ AC a AL
lembu	l AE ə AL m AF b AH u AM
lemot	l AE ə AL m AF ɔ AM t̪̚
lenso	l AE e AL n AG s AI o AM
lentera	l AE ə AL n AG t AC ɛ AL r AN a AL
lepa	l AE ɛ AL p AH a AL
lerai	l AE ə AL r AN a AL i̯ AB
les	l AE ɛ AL s AI
lesi	l AE ə AL s AI i AL
leter	l AE ɛ AL t AC ə AL r AN
letnan	l AE ɛ AL t̪̚ n AG a AL n AG
level	l AE ɛ AL v BA ə AL l AE
lever	l AE ɛ AL v BA ə AL r AN
lezat	l AE ə AL z AI a AL t̪̚
liang	l AE i AL a̯ ŋ AG
liberal	l AE i AL b AH ə AL r AN a AL l AE
lid	l AE ɪ AL t AC
lift	l AE ɪ AL f BA
liga	l AE i AL ɡ AC a AL
lihai	l AE i AL h AA a AL i̯ AB
likuid	l AE i AL k AC u AM ɪ AL t̪̚
likuida	l AE i AL k AC u AM ɪ AL d̪ AC a AL
likuidasi	l AE i AL k AC u AM i AL d̪ AC a AL s AI i AL
likuidator	l AE i AL k AC u AM i AL d̪ AC a AL t̪ AC ɔ AM r AN
likuiditas	l AE i AL k AC u AM i AL d̪ AC i AL t̪ AC a AL s AI
limau	l AE i AL m AF a AL u̯ AJ
limpa	l AE ɪ AL m AF p AH a AL
lin	l AE ɪ AL n AG
lindu	l AE i AL n AG d AC u AM
lingga	l AE ɪ AL ŋ AG ɡ AC a AL
lingkungan	l AE ɪ AL ŋ AG k AC ʊ AM ŋ AG a AL n AG
lini	l AE i AL n AG i AL
liong	l AE i AL ɔ AM ŋ AG
lipas	l AE i AL p AH a AL s AI
lis	l AE ɪ AL s AI
lisensi	l AE i AL s AI ɛ AL n AG s AI i AL
listrik	l AE ɪ AL s AI t AC r AN ɪ AL k̚
literatur	l AE i AL t AC ə AL r AN a AL t AC ʊ AM r AN
liturgi	l AE i AL t AC ʊ AM r AN ɡ AC i AL
loak	l AE o AM a AL ʔ AK
logam	l AE o AM ɡ AC a AL m AF
logika	l AE o AM ɡ AC i AL k AC a AL
logistik	l AE o AM ɡ AC ɪ AL s AI t AC ɪ AL k AC
lokal	l AE o AM k AC a AL l AE
lokastiti	l AE o AM k AC a AL s AI t AC i AL t AC i AL
lokatraya	l AE o AM k AC a AL t AC r AN a AL j AB a AL
lonceng	l AE ɔ AM n AG t AC ʃ AI ɛ AL ŋ AG
lonte	l AE ɔ AM n AG t̪ AC e AL
lor	l AE ɔ AM r AN
los	l AE ɔ AM s AI
lot	l AE ɔ AM t AC
loteng	l AE o AM t AC ɛ AL ŋ AG
lotre	l AE ɔ AM t AC r AN e AL
madu	m AF a AL d̪ AC u AM
madukara	m AF a AL d̪ AC u AM k AC a AL r AN a AL
madya	m AF a AL d̪ AC j AB a AL
magasin	m AF a AL ɡ AC a AL s AI ɪ AL n AG
magi	m AF a AL ɡ AC i AL
magister	m AF a AL ɡ AC ɪ AL s AI t AC ə AL r AN
magistrat	m AF a AL ɡ AC ɪ AL s AI t̪ AC r AN a AL t̪̚
mahaduta	m AF a AL h AA a AL d AC u AM t AC a AL
mahaguru	m AF a AL h AA a AL ɡ AC u AM r AN u AM
mahal	m AF a AL h AA a AL l AE
mahar	m AF a AL h AA a AL r AN
mahasiswa	m AF a AL h AA a AL s AI ɪ AL s AI w AJ a AL
mahkamah	m AF a AL h AA k AC a AL m AF a AL h AA
maho	m AF a AL h AA o AM
makam	m AF a AL k AC a AL m AF
makaron	m AF a AL k AC a AL r AN ɔ AM n AG
makarun	m AF a AL k AC a AL r AN ʊ AM n AG
makelar	m AF a AL k AC ə AL l AE a AL r AN
maket	m AF a AL k AC ɛ AL t AC
malaikat	m AF a AL l AE a AL i AL k AC a AL t AC
malaise	m AF a AL l AE a AL i̯ AB s AI ə AL
malapetaka	m AF a AL l AE a AL p AH ə AL t̪ AC a AL k AC a AL
malaria	m AF a AL l AE a AL r AN i AL a̯
malaysia	m AF a AL l AE a AL j AB s AI i AL a̯
maligai	m AF a AL l AE i AL ɡ AC a AL i̯ AB
mandala	m AF a AL n AG d̪ AC a AL l AE a AL
mandalika	m AF a AL n AG d̪ AC a AL l AE i AL k AC a AL
mandarin	m AF a AL n AG d̪ AC a AL r AN ɪ AL n AG
mandor	m AF a AL n AG d AC ɔ AM r AN
maneken	m AF a AL n AG ə AL k AC ɛ AL n AG
mangsa	m AF a AL ŋ AG s AI a AL
manhwa	m AF a AL n AG h AA w AJ a AL
mani	m AF a AL n AG i AL
manik	m AF a AL n AG ɪ AL k AC
manual	m AF a AL n AG u AM a AL l AE
manusia	m AF a AL n AG u AM s AI i AL a̯
mara	m AF a AL r AN a AL
marcapada	m AF a AL r AN t AC ʃ AI a AL p AH a AL d AC a AL
mare	m AF a AL r AN ə AL
markah	m AF a AL r AN k AC a AL h AA
mars	m AF a AL r AN s AI
marsose	m AF a AL r AN s AI o AM s AI e AL
martil	m AF a AL r AN t AC ɪ AL l AE
martir	m AF a AL r AN t AC ɪ AL r AN
masa	m AF a AL s AI a AL
masif	m AF a AL s AI ɪ AL f BA
masin	m AF a AL s AI ɪ AL n AG
masinis	m AF a AL s AI i AL n AG ɪ AL s AI
maskapai	m AF a AL s AI k AC a AL p AH a AL i̯ AB
maskara	m AF a AL s AI k AC a AL r AN a AL
massa	m AF a AL s AI s AI a AL
master	m AF a AL s AI t̪ AC ə AL r AN
masuk	m AF a AL s AI ʊ AM k AC
matematika	m AF a AL t AC e AL m AF a AL t AC i AL k AC a AL
materi	m AF a AL t AC e AL r AN i AL
material	m AF a AL t AC e AL r AN i AL a AL l AE
materialistis	m AF a AL t̪ AC e AL r AN i AL a AL l AE ɪ AL s AI t̪ AC ɪ AL k̚
materiel	m AF a AL t AC e AL r AN i AL ə AL l AE
materiil	m AF a AL t AC e AL r AN i AL ɪ AL l AE
matra	m AF a AL t̚ r AN a AL
matros	m AF a AL t̚ r AN ɔ AM s AI
maut	m AF a AL u AM t AC
mayor	m AF a AL j AB ɔ AM r AN
mayoritas	m AF a AL j AB o AM r AN i AL t̪ AC a AL s AI
mebel	m AF ɛ AL b AH ə AL l AE
medali	m AF ə AL d AC a AL l AE i AL
media	m AF e AL d AC i AL a̯
median	m AF e AL d AC i AL a AL n AG
medikasi	m AF ɛ AL d̪ AC i AL k AC a AL s AI i AL
medis	m AF ɛ AL d̪ AC ɪ AL s AI
meditasi	m AF ɛ AL d̪ AC i AL t̪ AC a AL s AI i AL
medium	m AF e AL d AC i AL ʊ AM m AF
mega	m AF ɛ AL ɡ AC a AL
meja	m AF ɛ AL d AC ʒ AI a AL
meka	m AF ɛ AL k AC a AL
melati	m AF ə AL l AE a AL t̪ AC i AL
membantu	m AF ə AL m AF b AH a AL n AG t̪ AC u AM
membongmeh	m AF ə AL ŋ AG b AH ɔ AM ŋ AG m AF e AL h AA
mendira	m AF ə AL n AG d̪ AC i AL r AN a AL
mengoposisi	m AF ə AL ŋ AG o AM p AH o AM s AI i AL s AI i AL
menir	m AF ə AL n AG ɪ AL r AN
menstruasi	m AF ɛ AL n AG s AI t AC r AN u AM a AL s AI i AL
mentega	m AF ə AL n AG t AC ɛ AL ɡ AC a AL
merana	m AF ə AL r AN a AL n AG a AL
mercu	m AF ə AL r AN t AC ʃ AI u AM
mercusuar	m AF ə AL r AN t AC ʃ AI u AM s AI u AM a AL r AN
merdeka	m AF ə AL r AN d̪ AC ɛ AL k AC a AL
merdu	m AF ə AL r AN d̪ AC u AM
merek	m AF ɛ AL r AN ə AL k̚
merino	m AF ə AL r AN i AL n AG o AM
meru	m AF e AL r AN u AM
mes	m AF ɛ AL s AI
meses	m AF ɛ AL s AI ə AL s AI
mesin	m AF ə AL s AI ɪ AL n AG
mesra	m AF ə AL s AI r AN a AL
mester	m AF ɛ AL s AI t AC ə AL r AN
metastase	m AF ɛ AL t AC a AL s AI t AC a AL s AI ə AL
metastasis	m AF ɛ AL t AC a AL s AI t AC a AL s AI i AL s AI
meter	m AF ɛ AL t AC ə AL r AN
meterai	m AF ə AL t̪ AC ə AL r AN a AL i AL
metrum	m AF ɛ AL t AC r AN ʊ AM m AF
mi	m AF i AL
migas	m AF i AL ɡ AC a AL s AI
migrain	m AF i AL ɡ AC r AN a AL i AL n AG
milenial	m AF i AL l AE e AL n AG i AL a AL l AE
milenium	m AF i AL l AE e AL n AG i AL ʊ AM m AF
milieu	m AF i AL l AE i AL ə AL u̯ AJ
milisi	m AF i AL l AE i AL s AI i AL
militer	m AF i AL l AE i AL t AC ɛ AL r AN
mimbar	m AF ɪ AL m AF b AH a AL r AN
mimisan	m AF i AL m AF ɪ AL s AI a AL n AG
mina	m AF i AL n AG a AL
minor	m AF i AL n AG ɔ AM r AN
minyak	m AF i AL ɲ AG a AL k AC
misa	m AF i AL s AI a AL
misi	m AF i AL s AI i AL
misionaris	m AF i AL s AI i AL o AM n AG a AL r AN ɪ AL s AI
miskram	m AF ɪ AL s AI k AC r AN a AL m AF
mistar	m AF ɪ AL s AI t AC a AL r AN
misteri	m AF ɪ AL s AI t AC e AL r AN i AL
mitra	m AF ɪ AL t̚ r AN a AL
modal	m AF o AM d̪ AC a AL l AE
mode	m AF o AM d AC ə AL
model	m AF o AM d AC ɛ AL l AE
modern	m AF o AM d AC ɛ AL r AN ə̆ BB n AG
modernisme	m AF o AM d AC ɛ AL r AN ə̆ BB n AG ɪ AL s AI m AF ə AL
modiste	m AF o AM d AC ɪ AL s AI t AC ə AL
modul	m AF o AM d̪ AC ʊ AM l AE
modus	m AF o AM d AC ʊ AM s AI
mohon	m AF ɔ AM h AA ɔ AM n AG
mohor	m AF o AM h AA ɔ AM r AN
mokat	m AF o AM k AC a AL t̚
mokbang	m AF ɔ AM k AC b AH a AL ŋ AG
molekul	m AF o AM l AE ə AL k AC ʊ AM l AE
monsinyur	m AF ɔ AM n AG s AI i AL ɲ AG ʊ AM r AN
montir	m AF ɔ AM n AG t AC ɪ AL r AN
mopit	m AF o AM p AH ɪ AL t AC
mortar	m AF ɔ AM r AN t AC a AL r AN
mortem	m AF ɔ AM r AN t̪ AC ə AL m AF
mortir	m AF ɔ AM r AN t AC ɪ AL r AN
mosi	m AF o AM s AI i AL
mua	m AF u AM a̯
mubazir	m AF u AM b AH a AL z AI ɪ AL r AN
mudik	m AF u AM d AC ɪ AL k AC
mufakat	m AF u AM f BA a AL k AC a AL t AC
munci	m AF ʊ AM n AG t AC ʃ AI i AL
muncikari	m AF ʊ AM n AG t AC ʃ AI i AL k AC a AL r AN i AL
murid	m AF u AM r AN ɪ AL t̚
musala	m AF u AM s AI a AL l AE a AL
museum	m AF ʊ AM s AI j AB ʊ AM m AF
musik	m AF u AM s AI ɪ AL k̚
musikus	m AF u AM s AI i AL k AC ʊ AM s AI
musim	m AF u AM s AI ɪ AL m AF
musisi	m AF u AM s AI i AL s AI i AL
mutiara	m AF u AM t̪ AC i AL a̯ r AN a AL
mutu	m AF u AM t̪ AC u AM
nabe	n AG a AL b AH e AL
nadi	n AG a AL d AC i AL
nafsu	n AG a AL f BA s AI u AM
naga	n AG a AL ɡ AC a AL
najis	n AG a AL d AC ʒ AI ɪ AL s AI
namaskara	n AG a AL m AF a AL s AI k AC a AL r AN a AL
nasib	n AG a AL s AI ɪ AL p̚
natal	n AG a AL t̪ AC a AL l AE
nayaka	n AG a AL j AB a AL k AC a AL
necis	n AG ɛ AL t AC ʃ AI ɪ AL s AI
negara	n AG ə AL ɡ AC a AL r AN a AL
negatif	n AG ɛ AL ɡ AC a AL t AC ɪ AL f BA
neraca	n AG ə AL r AN a AL t AC ʃ AI a AL
ners	n AG ə AL r AN s AI
net	n AG ɛ AL t̪ AC
neto	n AG e AL t AC o AM
netral	n AG ɛ AL t AC r AN a AL l AE
niaga	n AG i AL a AL ɡ AC a AL
nilai	n AG i AL l AE a AL i̯ AB
ninja	n AG ɪ AL n AG d AC ʒ AI a AL
nirguna	n AG ɪ AL r AN ɡ AC u AM n AG a AL
nirleka	n AG ɪ AL r AN l AE ɛ AL k AC a AL
nirmala	n AG ɪ AL r AN m AF a AL l AE a AL
nisan	n AG i AL s AI a AL n AG
nisbi	n AG ɪ AL s AI b AH i AL
niscaya	n AG ɪ AL s AI t AC ʃ AI a AL j AB a AL
nista	n AG ɪ AL s AI t AC a AL
nomer	n AG o AM m AF ə AL r AN
nominal	n AG o AM m AF i AL n AG a AL l AE
nomor	n AG o AM m AF ɔ AM r AN
nonelektrik	n AG ɔ AM n AG ɛ AL l AE ɛ AL k AC t̪ AC r AN ɪ AL k AC
nonfisik	n AG ɔ AM n AG f BA i AL s AI ɪ AL k̚
nonfiskal	n AG ɔ AM n AG f BA ɪ AL s AI k AC a AL l AE
nonsens	n AG ɔ AM n AG s AI ɛ AL n AG s AI
nonsubsidi	n AG ɔ AM n AG s AI ʊ AM p̚ s AI i AL d AC i AL
nontunai	n AG ɔ AM n AG t AC u AM n AG a AL i̯ AB
norma	n AG ɔ AM r AN m AF a AL
nota	n AG o AM t̪ AC a AL
notaris	n AG o AM t AC a AL r AN ɪ AL s AI
novel	n AG o AM v BA ɛ AL l AE
novum	n AG o AM v BA ʊ AM m AF
nuklir	n AG ʊ AM k AC l AE ɪ AL r AN
nutrisi	n AG u AM t AC r AN i AL s AI i AL
nyata	ɲ AG a AL t̪ AC a AL
nyawa	ɲ AG a AL w AJ a AL
obat	o AM b AH a AL t AC
objek	ɔ AM p AH d AC ʒ AI ɛ AL k AC
obstruksi	ɔ AM p̚ s AI t AC r AN ʊ AM k AC s AI i AL
oditur	ɔ AM d̪ AC i AL t̪ AC ʊ AM r AN
odol	o AM d AC ɔ AM l AE
ofset	ɔ AM f BA s AI ɛ AL t̪̚
oikumene	o AM i̯ AB k AC u AM m AF e AL n AG e AL
oksigen	ɔ AM k AC s AI i AL ɡ AC ɛ AL n AG
oktroi	o AM k̚ t AC r AN o AM i̯ AB
okulasi	o AM k AC u AM l AE a AL s AI i AL
okupasi	o AM k AC u AM p AH a AL s AI i AL
olahraga	o AM l AE a AL h AA r AN a AL ɡ AC a AL
oli	o AM l AE i AL
om	o AM m AF
omslah	ɔ AM m AF s AI l AE a AL h AA
omzet	ɔ AM m AF z AI ɛ AL t AC
onderneming	ɔ AM n AG d AC ə AL r AN n AG e AL m AF ɪ AL ŋ AG
onslah	ɔ AM n AG s AI l AE a AL h AA
operasi	o AM p AH ə AL r AN a AL s AI i AL
oplah	ɔ AM p̚ l AE a AL h AA
opname	ɔ AM p AH n AG a AL m AF ə AL
oposisi	ɔ AM p AH o AM s AI i AL s AI i AL
opseter	ɔ AM p AH s AI ɛ AL t AC ə AL r AN
opsi	ɔ AM p̚ s AI i AL
opsir	ɔ AM p AH s AI ɪ AL r AN
orang	ɔ AM r AN ä ŋ AG
orde	ɔ AM r AN d AC ə AL
order	ɔ AM r AN d AC ə AL r AN
ordi	ɔ AM r AN d̪ AC i AL
ordo	ɔ AM r AN d AC o AM
ordonansi	ɔ AM r AN d AC o AM n AG a AL n AG s AI i AL
organ	ɔ AM r AN ɡ AC a AL n AG
organogram	ɔ AM r AN ɡ AC a AL n AG o AM ɡ AC r AN a AL m AF
orisinal	ɔ AM r AN i AL s AI i AL n AG a AL l AE
osuari	o AM s AI u AM a AL r AN i AL
otomat	ɔ AM t AC o AM m AF a AL t̪ AC
otomatis	ɔ AM t AC o AM m AF a AL t̪ AC ɪ AL s AI
otomatisasi	ɔ AM t AC o AM m AF a AL t̪ AC i AL s AI a AL s AI i AL
otonomi	o AM t AC o AM n AG o AM m AF i AL
otoritas	ɔ AM t̪ AC o AM r AN i AL t̪ AC a AL s AI
otoriter	ɔ AM t AC o AM r AN i AL t̪ AC ɛ AL r AN
otoritet	ɔ AM t̪ AC o AM r AN i AL t̪ AC ɛ AL t̪̚
oven	o AM v BA ə AL n AG
pabrik	p AH a AL p̚ r AN ɪ AL k AC
pacar	p AH a AL t AC ʃ AI a AL r AN
pacaran	p AH a AL t AC ʃ AI a AL r AN a AL n AG
padmasana	p AH a AL t̚ m AF a AL s AI a AL n AG a AL
pagar	p AH a AL ɡ AC a AL r AN
pagina	p AH a AL ɡ AC i AL n AG a AL
pagoda	p AH a AL ɡ AC o AM d̪ AC a AL
pai	p AH a AL i̯ AB
pailit	p AH a AL i̯ AB l AE ɪ AL t AC
pajak	p AH a AL d AC ʒ AI a AL ʔ AK
pak	p AH a AL ʔ AK
paker	p AH a AL k AC ə AL r AN
paket	p AH a AL k AC ɛ AL t AC
pakpui	p AH a AL ʔ AK p AH u AM i̯ AB
paksa	p AH a AL k AC s AI a AL
pakta	p AH a AL k AC t̪ AC a AL
pakuncen	p AH a AL k AC ʊ AM n AG t AC ʃ AI ɛ AL n AG
pal	p AH a AL l AE
palagan	p AH a AL l AE a AL ɡ AC a AL n AG
palka	p AH a AL l AE k AC a AL
palsu	p AH a AL l AE s AI u AM
pamer	p AH a AL m AF ɛ AL r AN
pamflet	p AH a AL m AF f BA l AE ɛ AL t̪̚
pamper	p AH a AL m AF p AH ə AL r AN
panau	p AH a AL n AG a AL u̯ AJ
pancaroba	p AH a AL n AG t AC ʃ AI a AL r AN o AM b AH a AL
panci	p AH a AL ɲ AG t AC ʃ AI i AL
pandai	p AH a AL n AG d̪ AC a AL i̯ AB
pandu	p AH a AL n AG d AC u AM
panen	p AH a AL n AG ɛ AL n AG
panenan	p AH a AL n AG ɛ AL n AG a AL n AG
pangan	p AH a AL ŋ AG a AL n AG
panggung	p AH a AL ŋ AG ɡ AC ʊ AM ŋ AG
panitera	p AH a AL n AG i AL t AC ə AL r AN a AL
panji	p AH a AL n AG d AC ʒ AI i AL
pantas	p AH a AL n AG t AC a AL s AI
panti	p AH a AL n AG t̪ AC i AL
pantofel	p AH a AL n AG t̪ AC o AM f BA ə AL l AE
papirus	p AH a AL p AH i AL r AN ʊ AM s AI
parabel	p AH a AL r AN a AL b AH ə AL l AE
paradiso	p AH a AL r AN a AL d̪ AC i AL s AI o AM
paraf	p AH a AL r AN a AL f BA
paragraf	p AH a AL r AN a AL ɡ AC r AN a AL f BA
paralel	p AH a AL r AN a AL l AE ɛ AL l AE
parasit	p AH a AL r AN a AL s AI ɪ AL t AC
parau	p AH a AL r AN a AL u̯ AJ
parfum	p AH a AL r AN f BA ʊ AM m AF
pariwara	p AH a AL r AN i AL w AJ a AL r AN a AL
parket	p AH a AL r AN k AC ɛ AL t AC
parkir	p AH a AL r AN k AC ɪ AL r AN
parsel	p AH a AL r AN s AI ə AL l AE
partai	p AH a AL r AN t AC a AL i̯ AB
partikel	p AH a AL r AN t AC i AL k AC ə AL l AE
partisipasi	p AH a AL r AN t AC i AL s AI i AL p AH a AL s AI i AL
paru	p AH a AL r AN u AM
pas	p AH a AL s AI
pascasarjana	p AH a AL s AI t AC ʃ AI a AL s AI a AL r AN d AC ʒ AI a AL n AG a AL
pasfoto	p AH a AL s AI f BA o AM t AC o AM
pasiva	p AH a AL s AI i AL v BA a AL
pasok	p AH a AL s AI ɔ AM k̚
paspor	p AH a AL s AI p AH ɔ AM r AN
pasta	p AH a AL s AI t AC a AL
pastel	p AH a AL s AI t AC ɛ AL l AE
pasukan	p AH a AL s AI ʊ AM k̚ a AL n AG
paten	p AH a AL t AC ɛ AL n AG
pater	p AH a AL t AC ə AL r AN
pati	p AH a AL t AC i AL
patih	p AH a AL t AC ɪ AL h AA
patologi	p AH a AL t AC o AM l AE o AM ɡ AC i AL
patri	p AH a AL t̪ AC r AN i AL
patriark	p AH a AL t̚ r AN i AL a AL r AN k AC
patroli	p AH a AL t AC r AN o AM l AE i AL
patrun	p AH a AL t AC r AN ʊ AM n AG
paviliun	p AH a AL v BA i AL l AE i AL ʊ AM n AG
peci	p AH ɛ AL t AC ʃ AI i AL
pedati	p AH ə AL d AC a AL t AC i AL
pegawai	p AH ə AL ɡ AC a AL w AJ a AL i̯ AB
peksi	p AH ə AL k AC s AI i AL
pel	p AH ɛ AL l AE
pelangkin	p AH ə AL l AE a AL ŋ AG k AC ɪ AL n AG
pelat	p AH ə AL l AE a AL t̪̚
pelayanan	p AH ə AL l AE a AL j AB a AL n AG a AL n AG
pelesir	p AH ə AL l AE ə AL s AI ɪ AL r AN
pelita	p AH ə AL l AE i AL t AC a AL
pelitur	p AH ə AL l AE i AL t̪ AC ʊ AM r AN
pelor	p AH ɛ AL l AE ɔ AM r AN
pelpolisi	p AH ɛ AL l AE p AH o AM l AE i AL s AI i AL
peluru	p AH ə AL l AE u AM r AN u AM
pembantu	p AH ə AL m AF b AH a AL n AG t̪ AC u AM
pemberat	p AH ə AL m AF b AH ə AL r AN a AL t̪̚
pemilihan	p AH ə AL m AF i AL l AE ɪ AL h AA a AL n AG
pen	p AH ɛ AL n AG
pena	p AH ɛ AL n AG a AL
pendidikan	p AH ə AL n AG d AC i AL d AC ɪ AL k AC a AL n AG
pendopo	p AH ə AL n AG d AC o AM p AH o AM
pengacara	p AH ə AL ŋ AG a AL t AC ʃ AI a AL r AN a AL
pengadilan	p AH ə AL ŋ AG a AL d̪ AC ɪ AL l AE a AL n AG
pengajian	p AH ə AL ŋ AG a AL d AC ʒ AI i AL a AL n AG
pengangkutan	p AH ə AL ŋ AG a AL ŋ AG k AC ʊ AM t̪ AC a AL n AG
pengarah	p AH ə AL ŋ AG a AL r AN a AL h AA
pengembangan	p AH ə AL ŋ AG ə AL m AF b AH a AL ŋ AG a AL n AG
pengemudi	p AH ə AL ŋ AG ə AL m AF u AM d AC i AL
pengetahuan	p AH ə AL ŋ AG ə AL t AC a AL u AM a AL n AG
penggaris	p AH ə AL ŋ AG ɡ AC a AL r AN ɪ AL s AI
penggawa	p AH ə AL ŋ AG ɡ AC a AL w AJ a AL
pengkajian	p AH ə AL ŋ AG k AC a AL d AC ʒ AI i AL a AL n AG
pengujian	p AH ə AL ŋ AG u AM d AC ʒ AI i AL a AL n AG
penis	p AH ɛ AL n AG ɪ AL s AI
peniti	p AH ə AL n AG i AL t̪ AC i AL
penjahit	p AH ə AL n AG d AC ʒ AI a AL h AA ɪ AL t̚
penjara	p AH ə AL n AG d AC ʒ AI a AL r AN a AL
penolong	p AH ə AL n AG o AM l AE ɔ AM ŋ AG
pensil	p AH ɛ AL n AG s AI ɪ AL l AE
pensiun	p AH ɛ AL n AG s AI i AL ʊ AM n AG
pentakosta	p AH ɛ AL n AG t̪ AC a AL k AC ɔ AM s AI t̪ AC a AL
pentil	p AH ɛ AL n AG t AC ɪ AL l AE
penyusun	p AH ə AL ɲ AG u AM s AI ʊ AM n AG
pepaya	p AH ə AL p AH a AL j AB a AL
per	p AH ɛ AL r AN
perai	p AH ə AL r AN a AL i̯ AB
perancis	p AH ə AL r AN a AL n AG t AC ʃ AI ɪ AL s AI
perang	p AH e AL r AN a AL ŋ AG
perbal	p AH ə AL r AN b AH a AL l AE
perbawa	p AH ə AL r AN b AH a AL w AJ a AL
perca	p AH ə AL r AN t AC ʃ AI a AL
perek	p AH ə AL r AN ɛ AL k̚
performa	p AH ə AL r AN f BA ɔ AM r AN m AF a AL
perhubungan	p AH ə AL r AN h AA u AM b AH ʊ AM ŋ AG a AL n AG
peri	p AH ə AL r AN i AL
peribahasa	p AH ə AL r AN i AL b AH a AL h AA a AL s AI a AL
periksa	p AH ə AL r AN ɪ AL k AC s AI a AL
perilaku	p AH ə AL r AN i AL l AE a AL k AC u AM
pering	p AH ə AL r AN ɪ AL ŋ AG
periode	p AH e AL r AN i AL o AM d AC ə AL
periodik	p AH e AL r AN i AL o AM d AC ɪ AL k AC
perisai	p AH ə AL r AN i AL s AI a AL i̯ AB
perkasa	p AH r AN a AL k AC a AL s AI a AL
perkedel	p AH ə AL r AN k AC ə AL d AC ɛ AL l AE
perkosa	p AH ə AL r AN k AC o AM s AI a AL
perleng	p AH ə AL r AN l AE ɛ AL ŋ AG
perlip	p AH ə AL r AN l AE ɪ AL p AH
perlop	p AH ə AL r AN l AE o AM p AH
perlup	p AH ə AL r AN l AE ʊ AM p AH
permak	p AH ə AL r AN m AF a AL ʔ AK
permen	p AH ə AL r AN m AF ɛ AL n AG
permisi	p AH ə AL r AN m AF i AL s AI i AL
peron	p AH ɛ AL r AN ɔ AM n AG
perpuluhan	p AH ə AL r AN p AH u AM l AE ʊ AM h AA a AL n AG
pers	p AH ɛ AL r AN s AI
persekutuan	p AH ə AL r AN s AI ə AL k AC u AM t AC u AM a AL n AG
persepuluhan	p AH ə AL r AN s AI ə AL p AH u AM l AE ʊ AM h AA a AL n AG
persero	p AH ə AL r AN s AI ɛ AL r AN o AM
perseroan	p AH ə AL r AN s AI ɛ AL r AN o AM a AL n AG
persil	p AH ɛ AL r AN s AI ɪ AL l AE
persis	p AH ə AL r AN s AI ɪ AL s AI
persona	p AH ə AL r AN s AI o AM n AG a AL
pertapa	p AH ə AL r AN t AC a AL p AH a AL
perum	p AH ə AL r AN ʊ AM m AF
perusahaan	p AH ə AL r AN u AM s AI a AL h AA a AL a AL n AG
perwara	p AH ə AL r AN w AJ a AL r AN a AL
perwira	p AH ə AL r AN w AJ i AL r AN a AL
pes	p AH ɛ AL s AI
pesantian	p AH ə AL s AI a AL n AG t AC i AL a AL n AG
pesarean	p AH ə AL s AI a AL r AN ɛ AL a AL n AG
pesero	p AH ə AL s AI ɛ AL r AN o AM
pesta	p AH ɛ AL s AI t̪ AC a AL
pet	p AH ɛ AL t̪̚
petaka	p AH ə AL t̪ AC a AL k AC a AL
peti	p AH ə AL t̪ AC i AL
petir	p AH ə AL t̪ AC ɪ AL r AN
petroleum	p AH e AL t AC r AN o AM l AE e AL u AM m AF
piagam	p AH i AL a̯ ɡ AC a AL m AF
piala	p AH i AL a AL l AE a AL
piawai	p AH i AL a AL w AJ a AL i̯ AB
pidato	p AH i AL d AC a AL t AC o AM
pigura	p AH i AL ɡ AC u AM r AN a AL
pilar	p AH i AL l AE a AL r AN
pileg	p AH i AL l AE ɛ AL ɡ AC
pin	p AH ɪ AL n AG
pindakas	p AH ɪ AL n AG d̪ AC a AL k AC a AL s AI
pipa	p AH i AL p AH a AL
pirang	p AH i AL r AN a AL ŋ AG
pisau	p AH i AL s AI a AL u̯ AJ
pispot	p AH ɪ AL s AI p AH ɔ AM t AC
piung	p AH i AL ʊ AM ŋ AG
pivot	p AH i AL v BA ɔ AM t̪̚
plakat	p AH l AE a AL k AC a AL t AC
plan	p AH l AE a AL n AG
planing	p AH l AE a AL n AG ɪ AL ŋ AG
plantase	p AH l AE a AL n AG t̪ AC a AL s AI ə AL
plasebo	p AH l AE a AL s AI e AL b AH o AM
plasenta	p AH l AE a AL s AI ɛ AL n AG t AC a AL
plastik	p AH l AE a AL s AI t̪ AC ɪ AL k̚
plastis	p AH l AE a AL s AI t̪ AC ɪ AL s AI
platform	p AH l AE a AL t AC f BA ɔ AM r AN m AF
plaza	p AH l AE a AL z AI a AL
plombir	p AH l AE ɔ AM m AF b AH ɪ AL r AN
plural	p AH l AE u AM r AN a AL l AE
pluralistik	p AH l AE u AM r AN a AL l AE ɪ AL s AI t AC ɪ AL k AC
pluralistis	p AH l AE u AM r AN a AL l AE ɪ AL s AI t AC ɪ AL s AI
pohon	p AH ɔ AM h AA ɔ AM n AG
poin	p AH o AM ɪ AL n AG
pokrol	p AH ɔ AM k AC r AN ɔ AM l AE
pol	p AH ɔ AM l AE
poldan	p AH ɔ AM l AE d AC a AL n AG
polder	p AH ɔ AM l AE d AC ə AL r AN
poli	p AH o AM l AE i AL
polisi	p AH o AM l AE i AL s AI i AL
politeknik	p AH o AM l AE i AL t AC ɛ AL k AC n AG ɪ AL k AC
politik	p AH ɔ AM l AE l AE i AL t AC ɪ AL k̚
politikus	p AH o AM l AE i AL t AC i AL k AC ʊ AM s AI
polmah	p AH ɔ AM l AE m AF a AL h AA
pompa	p AH ɔ AM m AF p AH a AL
pondok	p AH o AM n AG d AC o AM ʔ AK
ponten	p AH ɔ AM n AG t AC ɛ AL n AG
pop	p AH ɔ AM p̚
popi	p AH o AM p AH i AL
populer	p AH o AM p AH u AM l AE ɛ AL r AN
porno	p AH ɔ AM r AN n AG o AM
pornografi	p AH ɔ AM r AN n AG o AM ɡ AC r AN a AL f BA i AL
porok	p AH o AM r AN ɔ AM k̚
porselen	p AH ɔ AM r AN s AI ə AL l AE ɛ AL n AG
porsi	p AH ɔ AM r AN s AI i AL
porta	p AH ɔ AM r AN t̪ AC a AL
portal	p AH ɔ AM r AN t AC a AL l AE
portir	p AH ɔ AM r AN t AC ɪ AL r AN
portugal	p AH ɔ AM r AN t AC u AM ɡ AC a AL l AE
portugis	p AH ɔ AM r AN t AC u AM ɡ AC ɪ AL s AI
pos	p AH ɔ AM s AI
posisi	p AH o AM s AI i AL s AI i AL
positif	p AH o AM s AI i AL t AC ɪ AL f BA
potehi	p AH o AM t AC ɛ AL h AA i AL
potensi	p AH o AM t AC ɛ AL n AG s AI i AL
potia	p AH o AM t AC i AL a̯
potlot	p AH o AM t̚ l AE o AM t̚
pradana	p AH r AN a AL d AC a AL n AG a AL
prah	p AH r AN a AL h AA
prahoto	p AH r AN a AL h AA o AM t AC o AM
praja	p AH r AN a AL d AC ʒ AI a AL
prakarsa	p AH r AN a AL k AC a AL r AN s AI a AL
prakerja	p AH r AN a AL k AC ə AL r AN d AC ʒ AI a AL
praktikan	p AH r AN a AL k AC t̪ AC i AL k AC a AL n AG
praktikum	p AH r AN a AL k AC t̪ AC i AL k AC ʊ AM m AF
praktis	p AH r AN a AL k AC t AC ɪ AL s AI
pralaya	p AH r AN a AL l AE a AL j AB a AL
pramudi	p AH r AN a AL m AF u AM d̪ AC i AL
pramugari	p AH r AN a AL m AF u AM ɡ AC a AL r AN i AL
pramurukti	p AH r AN a AL m AF u AM r AN ʊ AM k AC t̪ AC i AL
prancis	p AH r AN a AL n AG t AC ʃ AI ɪ AL s AI
prasasti	p AH r AN a AL s AI a AL s AI t AC i AL
prasmanan	p AH r AN a AL s AI m AF a AL n AG a AL n AG
pratama	p AH r AN a AL t AC a AL m AF a AL
predikat	p AH r AN e AL d AC i AL k AC a AL t AC
preman	p AH r AN ɛ AL m AF a AL n AG
premi	p AH r AN e AL m AF i AL
presbiterium	p AH r AN e AL s AI b AH i AL t AC e AL r AN i AL ʊ AM m AF
presidensial	p AH r AN ɛ AL s AI i AL d AC ɛ AL n AG s AI i AL a AL l AE
presidentil	p AH r AN ɛ AL s AI i AL d AC ɛ AL n AG t AC ɪ AL l AE
presisi	p AH r AN e AL s AI i AL s AI i AL
prestasi	p AH r AN ɛ AL s AI t̪ AC a AL s AI i AL
prestise	p AH r AN ɛ AL s AI t̪ AC i AL s AI ə AL
prestisius	p AH r AN ɛ AL s AI t̪ AC i AL s AI i AL ʊ AM s AI
prevalensi	p AH r AN e AL v BA a AL l AE ɛ AL n AG s AI i AL
priayi	p AH r AN i AL a AL j AB i AL
pribumi	p AH r AN i AL b AH u AM m AF i AL
primadona	p AH r AN i AL m AF a AL d̪ AC o AM n AG a AL
primas	p AH r AN i AL m AF a AL s AI
pris	p AH r AN ɪ AL s AI
privilese	p AH r AN i AL v BA i AL l AE ɛ AL s AI ə AL
pro	p AH r AN o AM
problem	p AH r AN o AM b AH l AE e AL m AF
prodeo	p AH r AN o AM d AC e AL o̯ AJ
profesi	p AH r AN o AM f BA ɛ AL s AI i AL
profil	p AH r AN o AM f BA ɪ AL l AE
program	p AH r AN ɔ AM ɡ AC r AN a AL m AF
programa	p AH r AN ɔ AM ɡ AC r AN a AL m AF a AL
proletar	p AH r AN o AM l AE ə AL t AC a AL r AN
prop	p AH r AN ɔ AM p AH
propaganda	p AH r AN o AM p AH a AL ɡ AC a AL n AG d AC a AL
protokol	p AH r AN o AM t AC o AM k AC ɔ AM l AE
protokoler	p AH r AN o AM t AC o AM k AC o AM l AE ɛ AL r AN
provinsi	p AH r AN o AM v BA ɪ AL n AG s AI i AL
provokasi	p AH r AN o AM v BA o AM k AC a AL s AI i AL
puak	p AH u AM a AL k̚
pujangga	p AH u AM d AC ʒ AI a AL ŋ AG ɡ AC a AL
pul	p AH ʊ AM l AE
pulpen	p AH ʊ AM l AE p AH ɛ AL n AG
pulsa	p AH ʊ AM l AE s AI a AL
puluh	p AH u AM l AE ʊ AM h AA
punah	p AH u AM n AG a AL h AA
pupa	p AH u AM p AH a AL
purba	p AH ʊ AM r AN b AH a AL
purnasarjana	p AH u AM r AN n AG a AL s AI a AL r AN d AC ʒ AI a AL n AG a AL
purwa	p AH ʊ AM r AN w AJ a AL
pusaka	p AH u AM s AI a AL k AC a AL
pusat	p AH u AM s AI a AL t̪̚
pusing	p AH u AM s AI ɪ AL ŋ AG
putri	p AH u AM t AC r AN i AL
putusan	p AH u AM t̪ AC ʊ AM s AI a AL n AG
rabat	r AN a AL b AH a AL t̚
rabi	r AN a AL b AH i AL
racun	r AN a AL t AC ʃ AI ʊ AM n AG
rad	r AN a AL t AC
radiasi	r AN a AL d AC i AL a AL s AI i AL
raharja	r AN a AL h AA a AL r AN d AC ʒ AI a AL
rahim	r AN a AL h AA ɪ AL m AF
rajawali	r AN a AL d AC ʒ AI a AL w AJ a AL l AE i AL
raksa	r AN a AL k AC s AI a AL
rakyat	r AN a AL ʔ AK j AB a AL t AC
rama	r AN a AL m AF a AL
randa	r AN a AL n AG d̪ AC a AL
rangkaian	r AN a AL ŋ AG k AC a AL i̯ AB a AL n AG
rantai	r AN a AL n AG t AC a AL i̯ AB
rapel	r AN a AL p AH ɛ AL l AE
rapor	r AN a AL p AH ɔ AM r AN
rasi	r AN a AL s AI i AL
rasul	r AN a AL s AI ʊ AM l AE
rat	r AN a AL t̪̚
ratna	r AN a AL t AC n AG a AL
raun	r AN a AL ʊ AM n AG
rayon	r AN a AL j AB ɔ AM n AG
razia	r AN a AL z AI i AL a̯
reaksi	r AN e AL a AL k AC s AI i AL
real	r AN ɛ AL a AL l AE
realis	r AN ɛ AL a AL l AE ɪ AL s AI
realisasi	r AN ɛ AL a AL l AE i AL s AI a AL s AI i AL
realisme	r AN ɛ AL a AL l AE ɪ AL s AI m AF ə AL
realistik	r AN ɛ AL a AL l AE ɪ AL s AI t̪ AC ɪ AL k̚
realistis	r AN ɛ AL a AL l AE ɪ AL s AI t̪ AC ɪ AL s AI
realitas	r AN ɛ AL a̝ l AE i̽ AL t AC ɐ AM s AI
rebewes	r AN e AL b AH ə AL w AJ e AL s AI
redaksi	r AN ə AL d̪ AC a AL k AC s AI i AL
redaktur	r AN ə AL d̪ AC a AL k AC t̪ AC ʊ AM r AN
refleks	r AN ɛ AL f BA l AE ɛ AL k AC s AI
regi	r AN e AL ɡ AC i AL
register	r AN e AL ɡ AC ɪ AL s AI t̪ AC ə AL r AN
registrasi	r AN e AL ɡ AC ɪ AL s AI t̪ AC r AN a AL s AI i AL
regisur	r AN e AL ɡ AC i AL s AI ʊ AM r AN
reglemen	r AN e AL ɡ AC l AE ə AL m AF e AL n AG
regulasi	r AN e AL ɡ AC u AM l AE a AL s AI i AL
reka	r AN ɛ AL k AC a AL
rekan	r AN ə AL k AC a AL n AG
reken	r AN ɛ AL k AC ə AL n AG
reklame	r AN ɛ AL k AC l AE a AL m AF ə AL
reklasering	r AN e AL k AC l AE a AL s AI ɛ AL r AN ɪ AL ŋ AG
rekoleksi	r AN e AL k AC o AM l AE ɛ AL k AC s AI i AL
rekreasi	r AN e AL k AC r AN ɛ AL a AL s AI i AL
rekreatif	r AN e AL k AC r AN ɛ AL a AL t AC ɪ AL f BA
rekrut	r AN e AL k AC r AN ʊ AM t AC
rekuiem	r AN e AL k AC u AM i̯ AB e AL m AF
rel	r AN ɛ AL l AE
relaks	r AN ɛ AL l AE a AL k AC s AI
relasi	r AN e AL l AE a AL s AI i AL
relatif	r AN e AL l AE a AL t AC ɪ AL f BA
religi	r AN e AL l AE i AL ɡ AC i AL
remedi	r AN ɛ AL m AF ə AL d̪ AC i AL
remedial	r AN ɛ AL m AF ə AL d̪ AC i AL a AL l AE
remisi	r AN ɛ AL m AF i AL s AI i AL
rencana	r AN ə AL n AG t AC ʃ AI a AL n AG a AL
renda	r AN ɛ AL n AG d̪ AC a AL
rentenir	r AN ɛ AL n AG t AC ə AL n AG ɪ AL r AN
repertoar	r AN e AL p AH ə AL r AN t̪ AC o AM a AL r AN
repetisi	r AN e AL p AH ə AL t AC i AL s AI i AL
replik	r AN ɛ AL p AH l AE ɪ AL k AC
replika	r AN ɛ AL p AH l AE i AL k AC a AL
reportase	r AN e AL p AH ɔ AM r AN t AC a AL s AI ə AL
representasi	r AN e AL p AH r AN ə AL s AI ɛ AL n AG t̪ AC a AL s AI i AL
reptil	r AN ɛ AL p̚ t̪ AC ɪ AL l AE
republik	r AN e AL p AH u AM b AH l AE ɪ AL k AC
republikan	r AN e AL p AH ʊ AM p AH l AE ɪ AL k AC a AL n AG
republiken	r AN e AL p AH ʊ AM p AH l AE ɪ AL k AC e AL n AG
resensi	r AN ɛ AL s AI ɛ AL n AG s AI i AL
resepsi	r AN ə AL s AI ɛ AL p AH s AI i AL
reserse	r AN ə AL s AI ɛ AL r AN s AI ə AL
reserve	r AN ə AL s AI e AL r AN v BA ə AL
residen	r AN e AL s AI i AL d̪ AC ɛ AL n AG
residivis	r AN ɛ AL s AI i AL d AC i AL v BA ɪ AL s AI
resiko	r AN e AL s AI i AL k AC o AM
resimen	r AN e AL s AI i AL m AF ɛ AL n AG
resor	r AN e AL s AI ɔ AM r AN
respek	r AN ɛ AL s AI p AH ɛ AL k AC
respons	r AN ɛ AL s AI p AH ɔ AM n AG s AI
restan	r AN ɛ AL s AI t AC a AL n AG
restoran	r AN e AL s AI t AC o AM r AN a AL n AG
restorasi	r AN ɛ AL s AI t AC o AM r AN a AL s AI i AL
restriksi	r AN ɛ AL s AI t AC r AN ɪ AL k AC s AI i AL
resume	r AN e AL s AI u AM m AF e AL
retail	r AN e AL t AC a AL ɪ AL l AE
retret	r AN ɛ AL t̚ r AN ɛ AL t̚
retur	r AN e AL t AC ʊ AM r AN
revisi	r AN e AL v BA i AL s AI i AL
reviu	r AN ɛ AL v BA i AL u̯ AJ
rezim	r AN ɛ AL z AI ɪ AL m AF
riben	r AN i AL b AH ɛ AL n AG
riil	r AN i AL ɪ AL l AE
rileks	r AN i AL l AE ɛ AL k AC s AI
rim	r AN ɪ AL m AF
ring	r AN ɪ AL ŋ AG
riset	r AN i AL s AI ə AL t̚
ritel	r AN i AL t AC ɛ AL l AE
ritus	r AN i AL t AC ʊ AM s AI
roda	r AN o AM d̪ AC a AL
rodi	r AN o AM d̪ AC i AL
roh	r AN ɔ AM h AA
rok	r AN ɔ AM k AC
rokok	r AN o AM k AC o AM ʔ AK
rol	r AN ɔ AM l AE
rolade	r AN o AM l AE a AL d̪ AC ə AL
ronda	r AN ɔ AM n AG d AC a AL
ronde	r AN ɔ AM n AG d̪ AC ə AL
rosario	r AN o AM s AI a AL r AN i AL o̯ AJ
roti	r AN o AM t̪ AC i AL
royal	r AN o AM j AB a AL l AE
rua	r AN u AM a̯
rubah	r AN u AM b AH a AL h AA
rubrik	r AN u AM b AH r AN ɪ AL k AC
rugi	r AN u AM ɡ AC i AL
ruh	r AN ʊ AM h AA
rumboter	r AN ʊ AM m AF b AH o AM t AC ə AL r AN
rupa	r AN u AM p AH a AL
ruptur	r AN ʊ AM p AH t AC ʊ AM r AN
saba	s AI a AL b AH a AL
sablon	s AI a AL b AH l AE ɔ AM n AG
sadel	s AI a AL d AC ə AL l AE
sado	s AI a AL d̪ AC o AM
safir	s AI a AL f BA ɪ AL r AN
sahabat	s AI a AL h AA a AL b AH a AL t̪̚
sahaja	s AI a AL h AA a AL d AC ʒ AI a AL
saham	s AI a AL h AA a AL m AF
sains	s AI a AL ɪ AL n AG s AI
saintifik	s AI a AL ɪ AL n AG t AC i AL f BA ɪ AL k AC
sajadah	s AI a AL d AC ʒ AI a AL d̪ AC a AL h AA
sak	s AI a AL k AC
saka	s AI a AL k AC a AL
sakar	s AI a AL k AC a AL r AN
sakelek	s AI a AL k AC ə AL l AE ə AL ʔ AK
saki	s AI a AL k AC i AL
saklek	s AI a AL k AC l AE ə AL k AC
sakramen	s AI a AL k AC r AN a AL m AF ɛ AL n AG
sakramentalia	s AI a AL k AC r AN a AL m AF ɛ AL n AG t AC a AL l AE i AL a̯
sakrilegi	s AI a AL k AC r AN i AL l AE e AL ɡ AC i AL
sakristi	s AI a AL k AC r AN ɪ AL s AI t AC i AL
saksama	s AI a AL k AC s AI a AL m AF a AL
saku	s AI a AL k AC u AM
salat	s AI a AL l AE a AL t AC
saldo	s AI a AL l AE d AC o AM
salep	s AI a AL l AE ə AL p̚
salib	s AI a AL l AE ɪ AL p AH
salip	s AI a AL l AE ɪ AL p AH
salon	s AI a AL l AE ɔ AM n AG
salto	s AI a AL l AE t AC o AM
salut	s AI a AL l AE ʊ AM t AC
samapta	s AI a AL m AF a AL p AH t AC a AL
samseng	s AI a AL m AF s AI ɛ AL ŋ AG
samsu	s AI a AL m AF s AI u AM
sandi	s AI a AL n AG d̪ AC i AL
sandiwara	s AI a AL n AG d̪ AC i AL w AJ a AL r AN a AL
sanggama	s AI a AL ŋ AG ɡ AC a AL m AF a AL
sangkakala	s AI a AL ŋ AG k AC a AL k AC a AL l AE a AL
sanitasi	s AI a AL n AG i AL t̪ AC a AL s AI i AL
santa	s AI a AL n AG t AC a AL
santan	s AI a AL n AG t AC a AL n AG
santo	s AI a AL n AG t AC o AM
sapir	s AI a AL p AH ɪ AL r AN
sapo	s AI a AL p AH o AM
sara	s AI a AL r AN a AL
saraf	s AI a AL r AN a AL f BA
sarekat	s AI a AL r AN ɛ AL k AC a AL t̪̚
sari	s AI a AL r AN i AL
sarjana	s AI a AL r AN d AC ʒ AI a AL n AG a AL
sasis	s AI a AL s AI ɪ AL s AI
saudagar	s AI a AL u̯ AJ d AC a AL ɡ AC a AL r AN
saus	s AI a AL ʊ AM s AI
sayembara	s AI a AL j AB ə AL m AF b AH a AL r AN a AL
sedekah	s AI ə AL d̪ AC ə AL k AC a AL h AA
segera	s AI ə AL ɡ AC ə AL r AN a AL
seiyu	s AI e AL i AL j AB u AM
sejarah	s AI ə AL d AC ʒ AI a AL r AN a AL h AA
sekaut	s AI ə AL k AC a AL ʊ AM t AC
sekeram	s AI ə AL k AC ɛ AL r AN a AL m AF
sekilwak	s AI ə AL k AC ɪ AL l AE w AJ a AL k AC
sekip	s AI ə AL k AC ɪ AL p AH
sekolah	s AI ə AL k AC o AM l AE a AL h AA
sekon	s AI ə AL k AC ɔ AM n AG
sekop	s AI ə AL k AC ɔ AM p AH
sekretariat	s AI ɛ AL k AC r AN ə AL t̪ AC a AL r AN i AL a AL t̪̚
sekretaris	s AI ɛ AL k AC r AN ə AL t AC a AL r AN ɪ AL s AI
sekte	s AI e AL k AC t AC ə AL
sektor	s AI ɛ AL k AC t AC ɔ AM r AN
sekuler	s AI ɛ AL k AC u AM l AE ɛ AL r AN
sekulir	s AI ə AL k AC u AM l AE ɪ AL r AN
sekuritas	s AI ə AL k AC u AM r AN i AL t AC a AL s AI
sekutu	s AI ə AL k AC u AM t AC u AM
sel	s AI ɛ AL l AE
selai	s AI ə AL l AE a AL i̯ AB
selamat	s AI ə AL l AE a AL m AF a AL t̪̚
selamatan	s AI ə AL l AE a AL m AF a AL t̪ AC a AL n AG
selatan	s AI ə AL l AE a AL t̪ AC a AL n AG
seleksi	s AI ə AL l AE ɛ AL k AC s AI i AL
selot	s AI l AE ɔ AM t AC
selotip	s AI e AL l AE o AM t AC ɪ AL p AH
seluler	s AI ɛ AL l AE u AM l AE ɛ AL r AN
semadi	s AI ə AL m AF a AL d̪ AC i AL
semalam	s AI ə AL m AF a AL l AE a AL m AF
semara	s AI ə AL m AF a AL r AN a AL
sembahyang	s AI ə AL m AF b AH a AL h AA j AB a AL ŋ AG
semesta	s AI ə AL m AF ə AL s AI t AC a AL
sempadan	s AI ə AL m AF p AH a AL d̪ AC a AL n AG
sempak	s AI ɛ AL m AF p AH a AL k AC
sen	s AI ɛ AL n AG
sena	s AI e AL n AG a AL
senapan	s AI ə AL n AG a AL p AH a AL n AG
senapati	s AI e AL n AG a AL p AH a AL t AC i AL
senar	s AI ə AL n AG a AL r AN
senaya	s AI e AL n AG a AL j AB a AL
sendi	s AI ə AL n AG d̪ AC i AL
seng	s AI e AL ŋ AG
sengkel	s AI ɛ AL ŋ AG k AC ɛ AL l AE
sengketa	s AI ə AL ŋ AG k AC ɛ AL t AC a AL
seni	s AI ə AL n AG i AL
senja	s AI ə AL n AG d AC ʒ AI a AL
senpi	s AI ə AL n AG p AH i AL
sensor	s AI ɛ AL n AG s AI ɔ AM r AN
sensus	s AI ɛ AL n AG s AI ʊ AM s AI
sentiong	s AI ə AL n AG t AC i AL ɔ AM ŋ AG
sentra	s AI ɛ AL n AG t̪ AC r AN a AL
senyawa	s AI ə AL ɲ AG a AL w AJ a AL
sep	s AI ɛ AL p AH
seperitus	s AI ə AL p AH ə AL r AN ɪ AL t̪ AC ʊ AM s AI
sepiritus	s AI ə AL p AH i AL r AN ɪ AL t̪ AC ʊ AM s AI
sepuit	s AI ə AL p AH u AM i AL t AC
sepul	s AI ə AL p AH ʊ AM l AE
sepuluh	s AI ə AL p AH u AM l AE ʊ AM h AA
seput	s AI ə AL p AH ʊ AM t AC
serangga	s AI ə AL r AN a AL ŋ AG ɡ AC a AL
serapah	s AI ə AL r AN a AL p AH a AL h AA
serasi	s AI ə AL r AN a AL s AI i AL
seraya	s AI ə AL r AN a AL j AB a AL
serba	s AI ə AL r AN b AH a AL
serbet	s AI ə AL r AN b AH ɛ AL t AC
serikat	s AI ə AL r AN i AL k AC a AL t̚
sero	s AI e AL r AN o AM
sersan	s AI ɛ AL r AN s AI a AL n AG
sertifikasi	s AI ɛ AL r AN t AC i AL f BA i AL k AC a AL s AI i AL
servis	s AI ɛ AL r AN v BA ɪ AL s AI
sesi	s AI ɛ AL s AI i AL
set	s AI ɛ AL t AC
setal	s AI ə AL t AC a AL l AE
setat	s AI ə AL t AC a AL t AC
setek	s AI ə AL t AC ɛ AL k AC
setel	s AI ə AL t AC ɛ AL l AE
setem	s AI ə AL t AC ɛ AL m AF
seter	s AI ə AL t AC ɛ AL r AN
seteru	s AI ə AL t AC ə AL r AN u AM
setia	s AI ə AL t AC i AL a̯
setip	s AI ə AL t AC ɪ AL p AH
setir	s AI ə AL t AC ɪ AL r AN
setom	s AI ə AL t AC ɔ AM m AF
setop	s AI ə AL t AC ɔ AM p̚
setor	s AI ə AL t̪ AC ɔ AM r AN
setrat	s AI ə AL t AC r AN a AL t AC
setrip	s AI ə AL t AC r AN ɪ AL p AH
setum	s AI ə AL t AC ʊ AM m AF
setup	s AI ə AL t AC ʊ AM p AH
sewa	s AI ɛ AL w AJ a AL
sidang	s AI i AL d̪ AC a AL ŋ AG
sidi	s AI i AL d AC i AL
sif	s AI ɪ AL f BA
sifat	s AI i AL p AH a AL t AC
siklus	s AI ɪ AL k AC l AE ʊ AM s AI
siksa	s AI ɪ AL k AC s AI a AL
sila	s AI i AL l AE a AL
simpel	s AI ɪ AL m AF p AH ə AL l AE
sinci	s AI ɪ AL n AG c AC i AL
sincia	s AI ɪ AL n AG t AC ʃ AI i AL a̯
sindikat	s AI ɪ AL n AG d̪ AC i AL k AC a AL t̪ AC
sinema	s AI ɪ AL n AG e AL m AF a AL
sinetron	s AI ɪ AL n AG ɛ AL t̚ r AN ɔ AM n AG
singa	s AI i AL ŋ AG a AL
singkek	s AI ɪ AL ŋ AG k AC ɛ AL k AC
siniar	s AI i AL n AG i AL a AL r AN
sinode	s AI i AL n AG o AM d AC ə AL
sintetik	s AI ɪ AL n AG t AC ɛ AL t AC ɪ AL k AC
sintetis	s AI ɪ AL n AG t AC ɛ AL t AC ɪ AL s AI
sinus	s AI i AL n AG ʊ AM s AI
sinyal	s AI i AL ɲ AG a AL l AE
sinyo	s AI i AL ɲ AG o AM
sioca	s AI i AL o̯ AJ t AC ʃ AI a AL
siomai	s AI i AL o AM m AF a AL i̯ AB
sip	s AI ɪ AL p AH
sipahi	s AI i AL p AH a AL h AA i AL
sipir	s AI i AL p AH ɪ AL r AN
sirene	s AI i AL r AN e AL n AG ə AL
sirkit	s AI ɪ AL r AN k AC ɪ AL t̪̚
sirkol	s AI ɪ AL r AN k AC o AM l AE
sirkuit	s AI ɪ AL r AN k AC u AM ɪ AL t̪̚
sirkulasi	s AI ɪ AL r AN k AC u AM l AE a AL s AI i AL
sirkumsisi	s AI i AL r AN k AC ʊ AM m AF s AI i AL s AI i AL
sirna	s AI ɪ AL r AN n AG a AL
sistem	s AI ɪ AL s AI t AC ə AL m AF
sistematik	s AI ɪ AL s AI t̪ AC e AL m AF a AL t AC ɪ AL k AC
sistematika	s AI ɪ AL s AI t̪ AC e AL m AF a AL t AC i AL k AC a AL
sistematis	s AI ɪ AL s AI t̪ AC e AL m AF a AL t AC ɪ AL s AI
sistim	s AI ɪ AL s AI t̪ AC i AL m AF
sitat	s AI i AL t AC a AL t AC
siwa	s AI i AL w AJ a AL
skedul	s AI k AC ɛ AL d AC ʊ AM l AE
skenario	s AI k AC e AL n AG a AL r AN i AL o̯ AJ
sketsa	s AI k AC ɛ AL t̚ s AI a AL
skop	s AI k AC ɔ AM p AH
skrip	s AI k AC r AN ɪ AL p̚
skuad	s AI k AC u AM a AL t AC
slip	s AI l AE i AL p AH
smokel	s AI m AF o AM k AC ə AL l AE
soak	s AI o AM a AL ʔ AK
sobat	s AI o AM b AH a AL t̪̚
soe	s AI o AM e AL
sohun	s AI o AM h AA ʊ AM n AG
soja	s AI o AM d AC ʒ AI a AL
soket	s AI o AM k AC ɛ AL t̪̚
sol	s AI ɔ AM l AE
solar	s AI o AM l AE a AL r AN
solder	s AI ɔ AM l AE d AC ɛ AL r AN
sombong	s AI ɔ AM m AF b AH ɔ AM ŋ AG
sorgum	s AI ɔ AM r AN ɡ AC ʊ AM m AF
soroban	s AI o AM r AN o AM b AH a AL n AG
sosi	s AI o AM s AI i AL
sosial	s AI o AM s AI i AL a AL l AE
sosin	s AI o AM s AI ɪ AL n AG
sosis	s AI o AM s AI ɪ AL s AI
sositet	s AI o AM s AI i AL t AC ɛ AL t AC
soya	s AI o AM j AB a AL
spanyol	s AI p AH a AL ɲ AG ɔ AM l AE
sparing	s AI p AH a AL r AN ɪ AL ŋ AG
spasi	s AI p AH a AL s AI i AL
spekulan	s AI p AH ɛ AL k AC u AM l AE a AL n AG
spekulasi	s AI p AH ɛ AL k AC u AM l AE a AL s AI i AL
spekulatif	s AI p AH ɛ AL k AC u AM l AE a AL t AC ɪ AL f BA
spekulator	s AI p AH ɛ AL k AC u AM l AE a AL t AC ɔ AM r AN
spesialis	s AI p AH ɛ AL s AI i AL a AL l AE ɪ AL s AI
spirit	s AI p AH i AL r AN ɪ AL t̪̚
spiritus	s AI p AH i AL r AN ɪ AL t̪ AC ʊ AM s AI
spoed	s AI p AH ʊ AM t AC
spora	s AI p AH o AM r AN a AL
spot	s AI p AH ɔ AM t AC
sputum	s AI p AH u AM t AC ʊ AM m AF
staf	s AI ə̆ BB t AC a AL p̚
stambom	s AI t AC a AL m AF b AH ɔ AM m AF
stambuk	s AI t AC a AL m AF b AH ʊ AM k AC
standar	s AI t AC a AL n AG d̪ AC a AL r AN
stele	s AI t AC e AL l AE e AL
stempel	s AI t̪ AC ɛ AL m AF p AH ə AL l AE
steril	s AI t̪ AC ɛ AL r AN ɪ AL l AE
stipendium	s AI t AC i AL p AH ɛ AL n AG d AC i AL ʊ AM m AF
stok	s AI t̪ AC ɔ AM k̚
stopkontak	s AI t AC ɔ AM p̚ k AC o AM n AG t AC a AL k̚
strata	s AI t AC r AN a AL t AC a AL
strategi	s AI t AC r AN a AL t AC ɛ AL ɡ AC i AL
strategis	s AI t AC r AN a AL t AC ɛ AL ɡ AC ɪ AL s AI
stratifikasi	s AI t̪ AC r AN a AL t̪ AC i AL f BA i AL k AC a AL s AI i AL
stratum	s AI t AC r AN a AL t AC ʊ AM m AF
stres	s AI t AC r AN ɛ AL s AI
studen	s AI t AC u AM d AC ə AL n AG
suar	s AI u AM a̯ r AN
subsider	s AI ʊ AM b AH s AI i AL d AC ɛ AL r AN
subsidi	s AI ʊ AM p̚ s AI i AL d AC i AL
subversif	s AI ʊ AM p AH v BA ɛ AL r AN s AI ɪ AL f BA
sugesti	s AI u AM ɡ AC ɛ AL s AI t AC i AL
suhu	s AI u AM h AA u AM
sukacita	s AI u AM k AC a AL t AC ʃ AI i AL t AC a AL
sukses	s AI ʊ AM k AC s AI ɛ AL s AI
sun	s AI ʊ AM n AG
sunah	s AI u AM n AG a AL h AA
sunat	s AI u AM n AG a AL t̪̚
sup	s AI ʊ AM p̚
suralaya	s AI u AM r AN a AL l AE a AL j AB a AL
susila	s AI u AM s AI i AL l AE a AL
suspensi	s AI ʊ AM s AI p AH ɛ AL n AG s AI i AL
sutradara	s AI ʊ AM t AC r AN a AL d AC a AL r AN a AL
swapraja	s AI w AJ a AL p AH r AN a AL d AC ʒ AI a AL
swike	s AI w AJ i AL k AC e AL
swipoa	s AI w AJ i AL p AH o AM a̯
syahid	ʃ AI a AL h AA ɪ AL t AC
syahwat	ʃ AI a AL h AA w AJ a AL t AC
syarikat	ʃ AI a AL r AN i AL k AC a AL t̪̚
syiwa	ʃ AI i AL w AJ a AL
syok	ʃ AI ɔ AM k AC
tabernakel	t AC a AL b AH ə AL r AN n AG a AL k AC ə AL l AE
tabir	t̪ AC a AL b AH ɪ AL r AN
taifun	t AC a AL i̯ AB f BA u AM n AG
tajir	t AC a AL d AC ʒ AI ɪ AL r AN
tajuk	t AC a AL d AC ʒ AI ʊ AM k̚
takdir	t AC a AL k̚ d AC ɪ AL r AN
taktik	t AC a AL k AC t AC ɪ AL k AC
tala	t̪ AC a AL l AE a AL
talam	t̪ AC a AL l AE a AL m AF
tamagoyaki	t̪ AC a AL m AF a AL ɡ AC o AM j AB a AL k AC i AL
tamak	t AC a AL m AF a AL ʔ AK
taman	t AC a AL m AF a AL n AG
tamasya	t AC a AL m AF a AL ʃ AI a AL
tamu	t̪ AC a AL m AF u AM
tandu	t̪ AC a AL n AG d̪ AC u AM
tang	t AC a AL ŋ AG
tanggal	t AC a AL ŋ AG ɡ AC a AL l AE
tanglung	t AC a AL ŋ AG l AE ʊ AM ŋ AG
tani	t̪ AC a AL n AG i AL
tankobon	t̪ AC a AL n AG k AC o AM b AH ɔ AM n AG
tantri	t AC a AL n AG t AC r AN i AL
taoci	t AC a AL o AM t AC ʃ AI i AL
taoco	t AC a AL o AM t AC ʃ AI o AM
taoge	t AC a AL o AM ɡ AC e AL
tapai	t̪ AC a AL p AH a AL i̯ AB
tapioka	t AC a AL p AH i AL o AM k AC a AL
tara	t AC a AL r AN a AL
tarik	t AC a AL r AN i AL ʔ AK
tarikh	t AC a AL r AN ɪ AL x AI
tasrih	t AC a AL s AI r AN ɪ AL h AA
tata	t̪ AC a AL t̪ AC a AL
tawas	t̪ AC a AL w AJ a AL s AI
teater	t̪ AC ɛ AL a AL t̪ AC ə AL r AN
tebal	t AC ə AL b AH a AL l AE
tebu	t AC ə AL b AH u AM
tega	t AC ɛ AL ɡ AC a AL
tegal	t AC ə AL ɡ AC a AL l AE
tegel	t AC ɛ AL ɡ AC ə AL l AE
teguh	t̪ AC ə AL ɡ AC ʊ AM h AA
teja	t AC ɛ AL d AC ʒ AI a AL
teken	t AC ɛ AL k AC ə AL n AG
teknik	t AC ɛ AL k AC n AG ɪ AL k AC
teknisi	t AC ɛ AL k AC n AG i AL s AI i AL
teknologi	t AC ɛ AL k AC n AG o AM l AE o AM ɡ AC i AL
teko	t AC e AL k AC o AM
tekoan	t AC e AL k AC o AM a AL n AG
teks	t AC ɛ AL k AC s AI
telat	t AC ə AL l AE a AL t AC
teman	t̪ AC ə AL m AF a AL n AG
tembaga	t AC ə AL m AF b AH a AL ɡ AC a AL
tempa	t AC ə AL m AF p AH a AL
tempayan	t̪ AC ə AL m AF p AH a AL j AB a AL n AG
temperatur	t AC ɛ AL m AF p AH ə AL r AN a AL t AC ʊ AM r AN
templat	t̪ AC ɛ AL m AF p AH l AE a AL t̪̚
tenaga	t̪ AC ə AL n AG a AL ɡ AC a AL
tenar	t AC ə AL n AG a AL r AN
tenda	t̪ AC ɛ AL n AG d̪ AC a AL
tendensi	t AC ɛ AL n AG d AC ɛ AL n AG s AI i AL
tender	t AC ɛ AL n AG d AC ə AL r AN
tenor	t AC ɛ AL n AG ɔ AM r AN
tentamen	t AC ɛ AL n AG t AC a AL m AF ɛ AL n AG
tenteram	t̪ AC ə AL n AG t̪ AC ə AL r AN a AL m AF
teoretis	t̪ AC e AL o AM r AN e AL t̪ AC ɪ AL s AI
tera	t̪ AC ə AL r AN a AL
terapi	t AC ə AL r AN a AL p AH i AL
teras	t̪ AC ɛ AL r AN a AL s AI
terigu	t AC ə AL r AN i AL ɡ AC u AM
terka	t AC ə AL r AN k AC a AL
termae	t AC ɛ AL r AN m AF a AL e AL
termos	t AC ɛ AL r AN m AF ɔ AM s AI
teror	t̪ AC ɛ AL r AN ɔ AM r AN
teroris	t AC ɛ AL r AN o AM r AN ɪ AL s AI
tes	t̪ AC ɛ AL s AI
testamen	t AC ɛ AL s AI t AC a AL m AF ɛ AL n AG
tetapi	t AC ə AL t AC a AL p AH i AL
tetikus	t AC ə AL t AC i AL k AC ʊ AM s AI
tetua	t AC ə AL t AC u AM a̯
tewas	t AC ɛ AL w AJ a AL s AI
thailand	t AC a AL i̯ AB l AE a AL n AG
tiket	t AC i AL k AC ɛ AL t AC
tim	t AC ɪ AL m AF
tin	t AC ɪ AL n AG
ting	t AC ɪ AL ŋ AG
tingkat	t AC ɪ AL ŋ AG k AC a AL t AC
tingtur	t AC ɪ AL ŋ AG t AC ʊ AM r AN
tiongkok	t AC i AL ɔ AM ŋ AG k AC ɔ AM k AC
tipe	t AC i AL p AH ə AL
tirai	t̪ AC i AL r AN a AL i̯ AB
tiras	t̪ AC i AL r AN a AL s AI
tisu	t AC i AL s AI u AM
titel	t̪ AC i AL t̪ AC ə AL l AE
tituler	t AC i AL t AC u AM l AE ɛ AL r AN
togel	t AC o AM ɡ AC ɛ AL l AE
tolan	t AC o AM l AE a AL n AG
tolong	t̪ AC o AM l AE ɔ AM ŋ AG
tombol	t AC ɔ AM m AF b AH ɔ AM l AE
toner	t̪ AC o AM n AG ə AL r AN
tongcai	t AC ɔ AM ŋ AG t AC ʃ AI a AL i̯ AB
tongsan	t AC ɔ AM ŋ AG s AI a AL n AG
tonil	t̪ AC o AM n AG ɪ AL l AE
topan	t AC o AM p AH a AL n AG
topeng	t AC o AM p AH ɛ AL ŋ AG
trailer	t AC r AN a AL i̯ AB l AE ɛ AL r AN
traktir	t AC r AN a AL k̚ t AC ɪ AL r AN
transien	t̪ AC r AN a AL n AG s AI i AL ɛ AL n AG
transit	t AC r AN a AL n AG s AI ɪ AL t AC
transpor	t̪ AC r AN a AL n AG s AI p AH ɔ AM r AN
transportasi	t̪ AC r AN a AL n AG s AI p AH ɔ AM r AN t̪ AC a AL s AI i AL
tras	t̪ AC ə̆ BB r AN a AL s AI
trayek	t AC r AN a AL j AB ɛ AL k AC
tribune	t AC r AN i AL b AH ʊ AM n AG
troika	t̪ AC r AN o AM i̯ AB k AC a AL
troli	t̪ AC r AN o AM l AE i AL
trotoar	t̪ AC r AN o AM t̪ AC o AM a AL r AN
truk	t̪ AC r AN ʊ AM k̚
tuala	t̪ AC u AM a AL l AE a AL
tuan	t AC u AM a AL n AG
tuduh	t AC u AM d AC ʊ AM h AA
tulung	t̪ AC u AM l AE ʊ AM ŋ AG
tuna	t AC u AM n AG a AL
tunadaksa	t AC u AM n AG a AL d AC a AL k AC s AI a AL
tunai	t AC u AM n AG a AL i̯ AB
tuts	t AC ʊ AM t AC s AI
udara	ʊ AM d̪ AC a AL r AN a AL
udik	u AM d AC ɪ AL k AC
uji	ʊ AM d AC ʒ AI i AL
ujian	ʊ AM d AC ʒ AI i AL a AL n AG
umpama	ʊ AM m AF p AH a AL m AF a AL
undang	ʊ AM n AG d̪ AC a AL ŋ AG
undi	ʊ AM n AG d AC i AL
uni	ʊ AM n AG i AL
unikorn	ʊ AM n AG i AL k AC ɔ AM r AN ə̆ BB n AG
universitas	u AM n AG i AL v BA ə AL r AN s AI i AL t AC a AL s AI
universitet	u AM n AG i AL v BA ə AL r AN s AI i AL t AC ɛ AL t AC
untai	ʊ AM n AG t̪ AC a AL i̯ AB
untuk	u AM n AG t AC u AM ʔ AK
upeti	u AM p AH ə AL t AC i AL
usia	ʊ AM s AI i AL a̯
utang	u AM t̪ AC a AL ŋ AG
uterus	ʊ AM t AC ɛ AL r AN ʊ AM s AI
vak	v BA a AL ʔ AK
vakansi	v BA a AL k AC a AL n AG s AI i AL
vakbon	v BA a AL ʔ AK b AH ɔ AM n AG
vakum	v BA a AL k AC ʊ AM m AF
valid	v BA a AL l AE ɪ AL t̪ AC
vas	v BA a AL s AI
vena	v BA ɛ AL n AG a AL
verba	v BA ɛ AL r AN b AH a AL
verbal	v BA ə AL r AN b AH a AL l AE
vigili	v BA i AL ɡ AC i AL l AE i AL
vikariat	v BA i AL k AC a AL r AN i AL a AL t AC
vikaris	v BA i AL k AC a AL r AN ɪ AL s AI
virus	v BA i AL r AN ʊ AM s AI
visitator	v BA i AL s AI i AL t AC a AL t AC ɔ AM r AN
visiun	v BA i AL s AI i AL ʊ AM n AG
visual	v BA i AL s AI u AM a AL l AE
vokasi	v BA o AM k AC a AL s AI i AL
vonis	v BA o AM n AG ɪ AL s AI
wabah	w AJ a AL b AH a AL h AA
wagon	w AJ a AL ɡ AC ɔ AM n AG
waham	w AJ a AL h AA a AL m AF
wajan	w AJ a AL d AC ʒ AI a AL n AG
wara	w AJ a AL r AN a AL
warga	w AJ a AL r AN ɡ AC a AL
warta	w AJ a AL r AN t̪ AC a AL
waslap	w AJ a AL s AI l AE a AL p AH
wastra	w AJ a AL s AI t AC r AN a AL
waterpas	w AJ a AL t AC ə AL r AN p AH a AL s AI
wawasan	w AJ a AL w AJ a AL s AI a AL n AG
webtun	w AJ ɛ AL p AH t AC ʊ AM n AG
wedana	w AJ ə AL d AC a AL n AG a AL
wesel	w AJ ɛ AL s AI ə AL l AE
wet	w AJ ɛ AL t AC
wibawa	w AJ i AL b AH a AL w AJ a AL
wijaya	w AJ i AL d AC ʒ AI a AL j AB a AL
wimana	w AJ i AL m AF a AL n AG a AL
wisata	w AJ i AL s AI a AL t AC a AL
wisma	w AJ ɪ AL s AI m AF a AL
wisuda	w AJ i AL s AI u AM d AC a AL
wiwaha	w AJ i AL w AJ a AL h AA a AL
wiweka	w AJ i AL w AJ e AL k AC a AL
wiyata	w AJ i AL j AB a AL t AC a AL
wolanda	w AJ o AM l AE a AL n AG d AC a AL
wonton	w AJ ɔ AM n AG t̪ AC ɔ AM n AG
yaksa	j AB a AL k AC s AI a AL
yayasan	j AB a AL j AB a AL s AI a AL n AG
yogia	j AB o AM ɡ AC i AL a̯
yunani	j AB u AM n AG a AL n AG i AL
yunior	j AB u AM n AG i AL ɔ AM r AN
yupa	j AB u AM p AH a AL
yurisdiksi	j AB u AM r AN ɪ AL s AI d̪ AC ɪ AL k AC s AI i AL
yuvenil	y AM u AM v BA ə AL n AG ɪ AL l AE
yuwana	j AB u AM w AJ a AL n AG a AL
zendeling	z AI ɛ AL n AG d AC ə AL l AE ɪ AL ŋ AG
zending	z AI ɛ AL n AG d AC ɪ AL ŋ AG
zeni	z AI ə AL n AG i AL
zirah	z AI i AL r AN a AL h AA
ā	ə AL
ē	ə AL
