abakus	a AD b a AD k ʊ AJ s
abang	a AD b a AD ŋ
abdomen	a AD p d o AG m ə AM n
abduksi	a AD p̚ d̪ ʊ AJ k̚ s i AF
abdusen	a AD p̚ d u AH s ə AM n
abikara	a AD b i AF k a AD r a AD
abiturien	a AD b i AF t̪ u AH r i AF e AE n
ablaut	a AD p l a AD ʊ AJ t̪̚
abolisi	a AD b o AG l i AF s i AF
absolut	a AD p̚ s o AG l ʊ AJ t̚
acak	a AD t ʃ a AD k̚
acala	a AD t ʃ a AD l a AD
acara	a AD t ʃ a AD r a AD
ace	a AD t ʃ ə AM
acingara	a AD t ʃ i AF ŋ a AD r a AD
acintia	a AD t ʃ ɪ AL n t i AF a̯
acu	a AD t ʃ u AH
adangiyah	a AD d a AD ŋ i AF j AB a AD h AA
adegan	a AD d̪ ə AM ɡ a AD n
adiguna	a AD d i AF ɡ u AH n a AD
adiksi	a AD d ɪ AL k s i AF
adilaga	a AD d̪ i AF l a AD ɡ a AD
adimarga	a AD d i AF m a AD r ɡ a AD
adipati	a AD d i AF p a AD t i AF
adipura	a AD d i AF p u AH r a AD
aditorium	a AD d̪ i AF t o AG r i AF ʊ AJ m
adiwira	a AD d i AF w AC i AF r a AD
administrasi	a AD t̚ m i AF n ɪ AL s t r a AD s i AF
administratif	a AD t̚ m i AF n ɪ AL s t r a AD t ɪ AL f
admisi	a AD t m i AF s i AF
adnan	a AD t̪ n a AD n
adolesens	a AD d o AG l ɛ AM s ə AM n s
adolu	a AD d̪ o AG l u AH
adreng	a AD t̪̚ r ə AM ŋ
aduksi	a AD d̪ ʊ AJ k̚ s i AF
adusen	a AD d u AH s ɛ AM n
adven	a AD t v ɛ AM n
advokat	a AD t̚ v o AG k a AD t̚
aeni	a AD e AE n i AF
aerosol	a AD e AE r o AG s ɔ AI l
aerosolisasi	a AD e AE r o AG s o AG l i AF s a AD s i AF
afek	a AD f ɛ AM k̚
afeksi	a AD f ɛ AM k̚ s i AF
afektif	a AD f ɛ AM k̚ t ɪ AL f
afkir	a AD f k ɪ AL r
afogato	a AD f o AG ɡ a AD t o AG
aga	a AD ɡ a AD
agak	a AD ɡ a AD ʔ
agama	a AD ɡ a AD m a AD
agenda	a AD ɡ ɛ AM n d a AD
agensi	a AD ɡ ɛ AM n s i AF
agio	a AD ɡ i AF o̯ BC
agitasi	a AD ɡ i AF t a AD s i AF
agitatif	a AD ɡ i AF t̪ a AD t̪ ɪ AL f
agitator	a AD ɡ i AF t̪ a AD t̪ ɔ AI r
agni	a AD ɡ n i AF
agnyana	a AD ɡ ɲ a AD n a AD
agresif	a AD ɡ r ɛ AM s ɪ AL f
agustusan	a AD ɡ ʊ AJ s t ʊ AJ s a AD n
airawata	a AD i̯ AB r a AD w AC a AD t a AD
aja	a AD d ʒ a AD
ajaib	a AD d ʒ a AD ɪ AL p
ajun	a AD d ʒ ʊ AJ n
akasa	a AD k a AD s a AD
akcaya	a AD k s a AD j AB a AD
aki	a AD k i AF
akor	a AD k ɔ AI r
akrobatik	a AD k r o AG b a AD t ɪ AL k
akrobatis	a AD k r o AG b a AD t ɪ AL s
akromion	a AD k̚ r o AG m i AF ɔ AI n
akropolis	a AD k̚ r o AG p o AG l ɪ AL s
akses	a AD k s ɛ AM s
aksesori	a AD k̚ s e AE s o AG r i AF
akson	a AD k̚ s ɔ AI n
aktentas	a AD k̚ t ə AM n t a AD s
akting	a AD k̚ t i AF ŋ
aktinometer	a AD k̚ t i AF n o AG m ɛ AM t ə AM r
aktiva	a AD k t̪ i AF v a AD
aktual	a AD k t u AH a AD l
akuafaba	a AD k u AH a̯ f a AD b a AD
akun	a AD k ʊ AJ n
akuntan	a AD k ʊ AJ n t a AD n
ala	a AD l a AD
alab	a AD l a AD p̚
alaf	a AD l a AD f
alamas	a AD l a AD m a AD s
albahdir	a AD l b a AD h AA d ɪ AL r
albania	a AD l b a AD n i AF a̯
alber	a AD l b ə AM r
album	a AD l b ʊ AJ m
alena	a AD l ɛ AM n a AD
alergi	a AD l ɛ AM r ɡ i AF
algoritma	a AD l ɡ o AG r ɪ AL t̪ m a AD
algoritme	a AD l ɡ o AG r ɪ AL t̪ m ə AM
alibi	a AD l i AF b i AF
alinea	a AD l i AF n e AE a AD
aljabar	a AD l d ʒ a AD b a AD r
alkes	a AD l k ə AM s
allah	ɔ AI ɫ ɫ ɔ AI h AA
almanak	a AD l m a AD n a AD ʔ
almasih	a AD l m a AD s ɪ AL h AA
alokasi	a AD l o AG k a AD s i AF
along	a AD l ɔ AI ŋ
alpaka	a AD l p a AD k a AD
alpeka	a AD l p ə AM k a AD
alter	a AD l t̪ ɛ AM r
alveolus	a AD l v e AE o AG l ʊ AJ s
amal	a AD m a AD l
amalaka	a AD m a AD l a AD k a AD
amatir	a AD m a AD t̪ ɪ AL r
ambah	a AD m b a AD h AA
ambang	a AD m b a AD ŋ
ambar	a AD m b a AD r
ambara	a AD m b a AD r a AD
ambeien	a AD m b e AE i AF ə AM n
ambeksura	a AD m b ə AM k̚ s u AH r a AD
amber	a AD m b ə AM r
ambigu	a AD m b i AF ɡ u AH
ambulatori	a AD m b u AH l a AD t o AG r i AF
amoi	a AD m o AG i̯ AB
amplifikasi	a AD m p l i AF f i AF k a AD s i AF
amprah	a AD m p r a AD h AA
ampula	a AD m p u AH l a AD
ampun	a AD m p ʊ AJ n
amtenar	a AD m t ə AM n a AD r
amulet	a AD m u AH l ɛ AM t
ananta	a AD n a AD n t a AD
anatomi	a AD n a AD t o AG m i AF
anca	a AD n t ʃ a AD
ancoa	a AD n t ʃ o AG a̯
andai	a AD n d̪ a AD i̯ AB
andil	a AD n d ɪ AL l
andong	a AD n d̪ ɔ AI ŋ
anemer	a AD n e AE m ə AM r
angel	a AD ŋ ɛ AM l
anggota	a AD ŋ ɡ o AG t̪ a AD
anggur	a AD ŋ ɡ ʊ AJ r
angkat	a AD ŋ k a AD t
angker	a AD ŋ k ə AM r
angket	a AD ŋ k ɛ AM t̚
angkong	a AD ŋ k ɔ AI ŋ
angsio	a AD ŋ s i AF o̯ BC
anime	a AD n i AF m e AE
anjing	a AD n d ʒ ɪ AL ŋ
anjir	a AD n d ʒ ɪ AL r
ansar	a AD n s a AD r
antariksa	a AD n t a AD r ɪ AL k s a AD
antarmuka	a AD n t a AD r m u AH k a AD
antik	a AD n t i AF ʔ
antologi	a AD n t̪ o AG l o AG ɡ i AF
antre	a AD n t r e AE
antropologi	a AD n t r o AG p o AG l o AG ɡ i AF
antusias	a AD n t u AH s i AF a AD s
anugerah	a AD n u AH ɡ ə AM r a AD h AA
anugrahamurti	a AD n u AH ɡ r a AD h AA a AD m ʊ AJ r t i AF
anyelir	a AD ɲ ə AM l ɪ AL r
aparatur	a AD p a AD r a AD t ʊ AJ r
aparatus	a AD p a AD r a AD t̪ ʊ AJ s
apel	a AD p ɛ AM l
aplikasi	a AD p l i AF k a AD s i AF
aplus	a AD p l ʊ AJ s
apokalips	a AD p o AG k a AD l ɪ AL p s
apokrifa	a AD p o AG k r i AF f a AD
apoteker	a AD p o AG t̪ e AE k ə AM r
apung	a AD p ʊ AJ ŋ
arbitrase	a AD r b ɪ AL t r a AD s ə AM
arbitrer	a AD r b ɪ AL t r ɛ AM r
arca	a AD r t ʃ a AD
arde	a AD r d ə AM
ares	a AD r ɛ AM s
arkade	a AD r k a AD d̪ ə AM
arkeologi	a AD r k e AE o AG l o AG ɡ i AF
arnal	a AD r n a AD l
arsitek	a AD r s i AF t ɛ AM k̚
arsitektur	a AD r s i AF t ɛ AM k̚ t ʊ AJ r
artefak	a AD r t ə AM f a AD k̚
arteri	a AD r t e AE r i AF
artikel	a AD r t i AF k ə AM l
arupadatu	a AD r u AH p a AD d̪ a AD t̪ u AH
as	a AD s
asa	a AD s a AD
asana	a AD s a AD n a AD
asas	a AD s a AD s
asdos	a AD s d̪ ɔ AI s
aset	a AD s ɛ AM t̪̚
asisten	a AD s ɪ AL s t̪ ɛ AM n
asmaradahana	a AD s m a AD r a AD d a AD h AA a AD n a AD
asosiasi	a AD s o AG s i AF a AD s i AF
aspiran	a AD s p i AF r a AD n
asprak	a AD s p r a AD k̚
astaka	a AD s t̪ a AD k a AD
astrologi	a AD s t r o AG l o AG ɡ i AF
astronomi	a AD s t r o AG n o AG m i AF
astungkara	a AD s t ʊ AJ ŋ k a AD r a AD
asuransi	a AD s u AH r a AD n s i AF
atase	a AD t̪ a AD s e AE
ateret	a AD t ə AM r ɛ AM t̚
atlet	a AD t l ɛ AM t
atletik	a AD t l ɛ AM t ɪ AL k
atmosfer	a AD t̪̚ m ɔ AI s f ɛ AM r
atom	a AD t o AG m
atonemen	a AD t o AG n ɛ AM m ə AM n
atribut	a AD t r i AF b ʊ AJ t
auditor	a AD u̯ AC d̪ i AF t ɔ AI r
auditorium	a AD u̯ AC d̪ i AF t o AG r i AF ʊ AJ m
aula	a AD u̯ AC l a AD
aura	a AD u̯ AC r a AD
auskultasi	a AD ʊ AJ s k ʊ AJ l t a AD s i AF
autopsi	o AG t ɔ AI p s i AF
awan	a AD w AC a AD n
awang	a AD w AC a AD ŋ
awatara	a AD w AC a AD t a AD r a AD
badai	b a AD d̪ a AD i̯ AB
badan	b a AD d a AD n
bagasi	b a AD ɡ a AD s i AF
bahagia	b a AD h AA a AD ɡ j AB a AD
bahan	b a AD h AA a AD n
bahari	b a AD h AA a AD r i AF
bahlul	b a AD h AA l ʊ AJ l
bait	b a AD ɪ AL t̪̚
baji	b a AD d ʒ i AF
baju	b a AD d ʒ u AH
bakalaureat	b a AD k a AD l a AD u̯ AC r e AE a AD t̚
bakar	b a AD k a AD r
bakteri	b a AD k̚ t e AE r i AF
bakteriologi	b a AD k t e AE r i AF o AG l o AG ɡ i AF
baku	b a AD k u AH
bal	b a AD l
balans	b a AD l a AD n s
balas	b a AD l a AD s
balgam	b a AD l ɡ a AD m
balkon	b a AD l k ɔ AI n
balon	b a AD l ɔ AI n
baluarti	b a AD l u AH a AD r t̪ i AF
balut	b a AD l ʊ AJ t̪
ban	b a AD n
bandana	b a AD n d a AD n a AD
bandar	b a AD n d a AD r
banderol	b a AD n d̪ ə AM r ɔ AI l
banget	b a AD ŋ ə AM t
bangga	b a AD ŋ ɡ a AD
bangkai	b a AD ŋ k a AD i̯ AB
bangkrut	b a AD ŋ k r ʊ AJ t
bangsal	b a AD ŋ s a AD l
bankir	b a AD n k ɪ AL r
banrol	b a AD n r ɔ AI l
bansos	b a AD n s ɔ AI s
bantu	b a AD n t̪ u AH
bantuan	b a AD n t u AH a AD n
banyak	b a AD ɲ a AD ʔ
baper	b a AD p ə AM r
baptis	b a AD p t ɪ AL s
barber	b a AD r b ə AM r
bardi	b a AD r d i AF
baris	b a AD r ɪ AL s
barok	b a AD r ɔ AI k̚
baru	b a AD r u AH
bas	b a AD s
basa	b a AD s a AD
basemen	b a AD s ə AM m ɛ AM n
basi	b a AD s i AF
basil	b a AD s ɪ AL l
basis	b a AD s ɪ AL s
baskom	b a AD s k ɔ AI m
bastar	b a AD s t a AD r
batas	b a AD t̪ a AD s
baterai	b a AD t ə AM r a AD i̯ AB
batil	b a AD t̪ ɪ AL l
batrik	b a AD t̚ r ɪ AL k
bau	b a AD u̯ AC
baut	b a AD ʊ AJ t
bawasir	b a AD w AC a AD s ɪ AL r
bayonet	b a AD j AB o AG n ɛ AM t
bazoka	b a AD z o AG k a AD
becak	b ɛ AM t ʃ a AD ʔ
beda	b ɛ AM d a AD
bedil	b ə AM d̪ ɪ AL l
bedinde	b ə AM d ɪ AL n d ə AM
begandering	b ə AM ɡ a AD n d ə AM r ɪ AL ŋ
behandel	b ə AM h AA a AD n d ə AM l
behel	b ɛ AM h AA ə AM l
bejana	b ə AM d ʒ a AD n a AD
bejibun	b ə AM d ʒ i AF b ʊ AJ n
bek	b ɛ AM k
bekal	b ə AM k a AD l
bekel	b ɛ AM k ə AM l
beken	b ə AM k ɛ AM n
beker	b ɛ AM k ə AM r
bekerja	b ə AM k ə AM r d ʒ a AD
bekleding	b ə AM k l e AE d ɪ AL ŋ
bekles	b ɛ AM k l ɛ AM s
beku	b ə AM k u AH
belek	b ɛ AM l ɛ AM k
belenggu	b ə AM l ə AM ŋ ɡ u AH
belikat	b ə AM l i AF k a AD t̪
belut	b ə AM l ʊ AJ t̚
bemper	b ɛ AM m p ə AM r
benang	b ə AM n a AD ŋ
benar	b ə AM n a AD r
bencana	b ə AM n t ʃ a AD n a AD
benci	b ə AM n t ʃ i AF
bendara	b ə AM n d a AD r a AD
bendesa	b ə AM n d ɛ AM s a AD
bendi	b ɛ AM n d̪ i AF
bensin	b ɛ AM n s ɪ AL n
bento	b ɛ AM n t o AG
benua	b ə AM n u AH a̯
beol	b ɛ AM ɔ AI l
beraja	b ə AM r a AD d ʒ a AD
berani	b ə AM r a AD n i AF
beras	b ə AM r a AD s
berat	b ə AM r a AD t
beredel	b ə AM r ɛ AM d ɛ AM l
bergejala	b ə AM r ɡ e AE d ʒ a AD l a AD
beri	b ɛ AM r i AF
beriani	b ə AM r i AF a AD n i AF
berita	b ə AM r i AF t a AD
berkat	b ə AM r k a AD t
berlian	b ə AM r l i AF a AD n
berpacaran	b ə AM r p a AD t ʃ a AD r a AD n
besi	b ə AM s i AF
beslit	b ɛ AM s l ɪ AL t̚
bestek	b ɛ AM s t ɛ AM k̚
bestir	b ə AM s t ɪ AL r
besuk	b ə AM s ʊ AJ k
biang	b i AF a̯ ŋ
bias	b i AF a AD s
bibliotek	b ɪ AL p l i AF o AG t ɛ AM k
bija	b i AF d ʒ a AD
binen	b i AF n ɛ AM n
bintang	b ɪ AL n t a AD ŋ
biologi	b i AF o AG l o AG ɡ i AF
bioma	b i AF o̯ BC m a AD
biomassa	b i AF o AG m a AD s s a AD
bir	b ɪ AL r
birama	b i AF r a AD m a AD
birokrat	b i AF r o AG k r a AD t
bis	b ɪ AL s
bisa	b i AF s a AD
bisnis	b ɪ AL s n ɪ AL s
bistik	b ɪ AL s t ɪ AL k̚
bit	b ɪ AL t
blok	b l ɔ AI k̚
blokade	b l o AG k a AD d ə AM
bloknot	b l ɔ AI k̚ n ɔ AI t̚
bludrek	b l ʊ AJ d r ə AM k
blumkol	b l ʊ AJ m k ɔ AI l
blus	b l ʊ AJ s
boa	b o AG a̯
boba	b o AG b a AD
bocuan	b o AG t ʃ u AH a̯ n
bodi	b o AG d i AF
boga	b o AG ɡ a AD
bohlam	b ɔ AI h AA l a AD m
boi	b o AG i AF
bokeh	b o AG k ɛ AM h AA
bokep	b o AG k ɛ AM p
bokser	b ɔ AI k s ə AM r
boksu	b ɔ AI k̚ s u AH
bola	b o AG l a AD
bolpen	b ɔ AI l p ɛ AM n
bolpoin	b o AG l p o AG i AF n
bom	b ɔ AI m
bombastis	b ɔ AI m b a AD s t ɪ AL s
boneka	b o AG n ɛ AM k a AD
bong	b ɔ AI ŋ
bonus	b o AG n ʊ AJ s
boplang	b ɔ AI p l a AD ŋ
boreh	b o AG r ɛ AM h AA
borjuis	b ɔ AI r d ʒ u AH ɪ AL s
bos	b ɔ AI s
botang	b o AG t a AD ŋ
botani	b o AG t a AD n i AF
botol	b o AG t ɔ AI l
brankas	b r a AD n k a AD s
branwir	b r a AD n w AC ɪ AL r
brata	b r a AD t a AD
brevet	b r ɛ AM v ɛ AM t
brompit	b r ɔ AI m p ɪ AL t
bros	b r ɔ AI s
brosur	b r o AG s ʊ AJ r
brutal	b r u AH t a AD l
bruto	b r u AH t o AG
bucin	b u AH t ʃ ɪ AL n
bui	b u AH i̯ AB
bujet	b u AH d ʒ ɛ AM t
bujeter	b u AH d ʒ ɛ AM t ɛ AM r
buk	b ʊ AJ k
buket	b u AH k ɛ AM t̪
bulai	b u AH l a AD i̯ AB
bulevar	b u AH l ə AM v a AD r
bulsak	b ʊ AJ l s a AD k
bum	b ʊ AJ m
bumerang	b u AH m ə AM r a AD ŋ
bumper	b ʊ AJ m p ə AM r
bundar	b ʊ AJ n d a AD r
bunker	b ʊ AJ ŋ k ə AM r
bunyi	b u AH ɲ i AF
bursa	b ʊ AJ r s a AD
buruk	b u AH r u AH ʔ
busi	b u AH s i AF
butik	b u AH t ɪ AL k
ca	t ʃ a AD
cabo	t ʃ a AD b o AG
cadangan	t ʃ a AD d a AD ŋ a AD n
cagak	t ʃ a AD ɡ a AD k
caima	t ʃ a AD i̯ AB m a AD
cair	t ʃ a AD ɪ AL r
caisim	t ʃ a AD i̯ AB s ɪ AL m
cakiak	t ʃ a AD k i AF a AD ʔ
calo	t ʃ a AD l o AG
calui	t ʃ a AD l u AH i̯ AB
cambuk	t ʃ a AD m b ʊ AJ k
camca	t ʃ a AD m t ʃ a AD
canai	t ʃ a AD n a AD i̯ AB
canda	t ʃ a AD n d a AD
candi	t ʃ a AD n d i AF
candradimuka	t ʃ a AD n d̪ r a AD d̪ i AF m u AH k a AD
candu	t ʃ a AD n d u AH
cangcimen	t ʃ a AD ŋ t ʃ i AF m ɛ AM n
cantik	t ʃ a AD n t i AF ʔ
cap	t ʃ a AD p
capcai	t ʃ a AD p t ʃ a AD i̯ AB
capek	t ʃ a AD p ɛ AM ʔ
caper	t ʃ a AD p ə AM r
capgome	t ʃ a AD p ɡ o AG m e AE
caraka	t ʃ a AD r a AD k a AD
cas	t ʃ a AD s
cat	t ʃ a AD t̚
cawan	t ʃ a AD w AC a AD n
ceban	t ʃ ə AM b a AD n
cek	t ʃ ɛ AM ʔ
ceki	t ʃ ə AM k i AF
celana	t ʃ ə AM l a AD n a AD
cemas	t ʃ ə AM m a AD s
cemeti	t ʃ ə AM m ə AM t̪ i AF
cengbeng	t ʃ ɛ AM ŋ b ɛ AM ŋ
cengkau	t ʃ ə AM ŋ k a AD u̯ AC
cengki	t ʃ ə AM ŋ k i AF
cengli	t ʃ ɛ AM ŋ l i AF
centeng	t ʃ ə AM n t ɛ AM ŋ
cerai	t ʃ ə AM r a AD i̯ AB
ceramah	t ʃ ə AM r a AD m a AD h AA
cermin	t ʃ ə AM r m ɪ AL n
cerna	t ʃ ə AM r n a AD
cerpu	t ʃ ə AM r p u AH
ciak	t ʃ i AF a̯ k̚
cialat	t ʃ i AF a̯ l a AD t̚
cikuwa	t ʃ i AF k u AH w AC a AD
cina	t ʃ i AF n a AD
cincai	t ʃ ɪ AL n t ʃ a AD i̯ AB
cincau	t ʃ i AF n t ʃ a AD u̯ AC
cincin	t ʃ ɪ AL n t ʃ ɪ AL n
cincu	t ʃ i AF n t ʃ u AH
cinta	t ʃ ɪ AL n t a AD
cip	t ʃ ɪ AL p
cipta	t ʃ ɪ AL p t a AD
citra	t ʃ ɪ AL t̚ r a AD
comblang	t ʃ ɔ AI m b l a AD ŋ
compoh	t ʃ ɔ AI m p ɔ AI h AA
congki	t ʃ ɔ AI ŋ k i AF
congsam	t ʃ ɔ AI ŋ s a AD m
coro	t ʃ o AG r o AG
cuan	t ʃ u AH a̯ n
cuci	t ʃ u AH t ʃ i AF
cukai	t ʃ u AH k a AD i̯ AB
cukimai	t ʃ u AH k i AF m a AD i̯ AB
cukin	t ʃ u AH k ɪ AL n
cukong	t ʃ u AH k ɔ AI ŋ
curek	t ʃ u AH r ə AM ʔ
cuti	t ʃ u AH t̪ i AF
dabing	d a AD b ɪ AL ŋ
dacin	d a AD t ʃ ɪ AL n
dada	d̪ a AD d̪ a AD
dadah	d a AD d a AD h AA
dading	d a AD d ɪ AL ŋ
dadu	d̪ a AD d̪ u AH
daftar	d̪ a AD f t a AD r
dahak	d̪ a AD h AA a AD k
dak	d a AD k
daksa	d a AD k s a AD
dakwa	d̪ a AD ʔ w AC a AD
dakwah	d̪ a AD ʔ w AC a AD h AA
dalang	d̪ a AD l a AD ŋ
dalih	d a AD l ɪ AL h AA
dam	d a AD m
damai	d a AD m a AD i̯ AB
damar	d̪ a AD m a AD r
dapur	d a AD p ʊ AJ r
darurat	d a AD r u AH r a AD t̚
data	d a AD t a AD
datum	d a AD t ʊ AJ m
debat	d̪ e AE b a AD t̪̚
debet	d e AE b ə AM t̪̚
debetor	d e AE b ə AM t̪ ɔ AI r
debit	d e AE b ɪ AL t̪̚
debitor	d e AE b i AF t̪ ɔ AI r
debitur	d e AE b i AF t̪ ʊ AJ r
dedapur	d̪ ə AM d̪ a AD p ʊ AJ r
defamasi	d e AE f a AD m a AD s i AF
definisi	d̪ e AE f i AF n i AF s i AF
defisit	d e AE f i AF s ɪ AL t̪̚
dek	d ɛ AM k
dekade	d e AE k a AD d ə AM
deklarasi	d ɛ AM k l a AD r a AD s i AF
dekonsentrasi	d e AE k ɔ AI n s ɛ AM n t r a AD s i AF
dekor	d ɛ AM k ɔ AI r
dekorasi	d ɛ AM k o AG r a AD s i AF
dekret	d ə AM k r ɛ AM t̪
delapan	d ə AM l a AD p a AD n
delegasi	d e AE l ə AM ɡ a AD s i AF
deler	d ə AM l ɛ AM r
delik	d ə AM l ɪ AL k
delinkuensi	d e AE l ɪ AL n k u AH ɛ AM n s i AF
delta	d ɛ AM l t a AD
delusi	d̪ e AE l u AH s i AF
demagog	d e AE m a AD ɡ ɔ AI k̚
demokrasi	d e AE m o AG k r a AD s i AF
demokrat	d̪ e AE m o AG k r a AD t̪̚
denda	d̪ ə AM n d̪ a AD
denominasi	d e AE n o AG m i AF n a AD s i AF
deodoran	d̪ e AE o AG d̪ o AG r a AD n
departemen	d ə AM p a AD r t ə AM m ɛ AM n
deposito	d e AE p o AG s i AF t o AG
derap	d ə AM r a AD p
derivatif	d ɛ AM r i AF v a AD t ɪ AL f
derji	d ə AM r d ʒ i AF
derma	d ə AM r m a AD
dermaga	d̪ ə AM r m a AD ɡ a AD
desa	d ɛ AM s a AD
desain	d e AE s a AD ɪ AL n
desersi	d̪ ɛ AM s ɛ AM r s i AF
deskripsi	d̪ ɛ AM s k r ɪ AL p s i AF
destar	d ə AM s t a AD r
detasemen	d e AE t a AD s ə AM m ɛ AM n
deteksi	d̪ e AE t̪ e AE k̚ s i AF
detektif	d̪ e AE t̪ e AE k̚ t̪ ɪ AL f
detergen	d e AE t̪ ə AM r ɡ e AE n
detik	d ə AM t ɪ AL ʔ
deviasi	d̪ e AE v i AF a̯ s i AF
dewala	d ɛ AM w AC a AD l a AD
dewasa	d ɛ AM w AC a AD s a AD
diabetes	d i AF a AD b ɛ AM t ə AM s
diagnosis	d i AF a AD ɡ n o AG s ɪ AL s
diakones	d i AF a AD k o AG n ə AM s
dian	d̪ i AF a AD n
diare	d̪ i AF a AD r e AE
diari	d i AF a AD r i AF
diaspora	d i AF a AD s p o AG r a AD
diktat	d ɪ AL k t a AD t
dikte	d̪ i AF ʔ t̪ e AE
diktum	d ɪ AL k t ʊ AJ m
dim	d ɪ AL m
dimensi	d̪ i AF m ɛ AM n s i AF
din	d ɪ AL n
dinamo	d i AF n a AD m o AG
dinar	d̪ i AF n a AD r
dinas	d i AF n a AD s
dinasti	d̪ i AF n a AD s t̪ i AF
dini	d i AF n i AF
dioses	d̪ i AF o AG s ə AM s
dipertuan	d̪ i AF p ə AM r t u AH a AD n
diplomasi	d ɪ AL p l o AG m a AD s i AF
diplomatik	d ɪ AL p l o AG m a AD t ɪ AL k
diplomatis	d ɪ AL p l o AG m a AD t ɪ AL s
direk	d i AF r ɛ AM ʔ
direksi	d i AF r ɛ AM k s i AF
direktori	d i AF r ɛ AM k t o AG r i AF
direktur	d i AF r ɛ AM k t ʊ AJ r
dirgantara	d ɪ AL r ɡ a AD n t a AD r a AD
dirigen	d i AF r i AF ɡ ɛ AM n
disel	d i AF s ɛ AM l
disiplin	d̪ i AF s ɪ AL p̚ l ɪ AL n
disket	d ɪ AL s k ɛ AM t
diskon	d i AF s k o AG n
diskonto	d ɪ AL s k ɔ AI n t o AG
diskresi	d̪ ɪ AL s k r ɛ AM s i AF
diskret	d̪ ɪ AL s k r ɛ AM t̪̚
diskriminasi	d ɪ AL s k r i AF m i AF n a AD s i AF
diskualifikasi	d ɪ AL s k u AH a AD l i AF f i AF k a AD s i AF
diskus	d̪ ɪ AL s k ʊ AJ s
diskusi	d̪ ɪ AL s k u AH s i AF
dispensasi	d ɪ AL s p ɛ AM n s a AD s i AF
dispenser	d ɪ AL s p ɛ AM n s ə AM r
dispersi	d̪ ɪ AL s p ɛ AM r s i AF
distansi	d̪ ɪ AL s t̪ a AD n s i AF
distrik	d ɪ AL s t r ɪ AL k̚
divisi	d i AF v i AF s i AF
dobel	d o AG b ə AM l
doi	d o AG i̯ AB
dok	d ɔ AI k
dokar	d̪ o AG k a AD r
doksologi	d ɔ AI k s o AG l o AG ɡ i AF
doktrin	d ɔ AI k t r ɪ AL n
dol	d ɔ AI l
dom	d ɔ AI m
domain	d̪ o AG m a AD ɪ AL n
domba	d ɔ AI m b a AD
domine	d̪ o AG m i AF n e AE
domisili	d o AG m i AF s i AF l i AF
donatir	d̪ o AG n a AD t̪ ɪ AL r
donator	d̪ o AG n a AD t̪ ɔ AI r
donatur	d̪ o AG n a AD t̪ ʊ AJ r
dongker	d ɔ AI ŋ k ə AM r
dop	d ɔ AI p
doping	d o AG p ɪ AL ŋ
dorslah	d ɔ AI r s l a AD h AA
dosir	d̪ o AG s ɪ AL r
draf	d̪ r a AD f
drai	d̪ r a AD i̯ AB
drainase	d̪ r a AD i AF n a AD s ə AM
drakor	d̪ r a AD k ɔ AI r
drama	d̪ r a AD m a AD
duaja	d u AH a AD d ʒ a AD
duet	d̪ u AH ɛ AM t̪̚
dugem	d u AH ɡ ə AM m
dup	d ʊ AJ p
durhaka	d ʊ AJ r h AA a AD k a AD
durjana	d̪ ʊ AJ r d ʒ a AD n a AD
dus	d ʊ AJ s
dusta	d̪ ʊ AJ s t a AD
ebi	ɛ AM b i AF
eden	e AE d̪ ə AM n
edukasi	ɛ AM d u AH k a AD s i AF
efikasi	ɛ AM f i AF k a AD s i AF
eke	ɛ AM k ə AM
ekologi	e AE k o AG l o AG ɡ i AF
ekonomi	e AE k o AG n o AG m i AF
ekonomika	ɛ AM k o AG n o AG m i AF k a AD
eksamen	ɛ AM k s a AD m ə AM n
eksaminasi	ɛ AM k s a AD m i AF n a AD s i AF
eksekusi	ɛ AM k̚ s ə AM k u AH s i AF
eksekutif	ɛ AM k s ə AM k u AH t ɪ AL f
eksepsi	ɛ AM k s ɛ AM p̚ s i AF
eksis	ɛ AM k s ɪ AL s
eksit	ɛ AM ʔ s ɪ AL t
ekskavasi	ɛ AM k s k a AD v a AD s i AF
eksklusif	ɛ AM k s k l u AH s ɪ AL f
ekspedisi	ɛ AM x p ə AM d i AF s i AF
eksperimen	ɛ AM k s p ə AM r i AF m ɛ AM n
eksploit	ɛ AM x p l o AG ɪ AL t
ekspor	ɛ AM k s p ɔ AI r
ekstrak	ɛ AM k s t̪ r a AD k
ekstraksi	ɛ AM k s t̪ r a AD k s i AF
ekstraktif	ɛ AM k s t̪ r a AD k t ɪ AL f
ekstrem	ɛ AM k s t̪ r e AE m
elektorat	ɛ AM l ɛ AM k̚ t o AG r a AD t
elektronik	ɛ AM l ɛ AM k̚ t r o AG n ɪ AL k̚
elektronika	ɛ AM l ɛ AM k t r o AG n i AF k a AD
elektronis	ɛ AM l ɛ AM k̚ t r o AG n ɪ AL s
emat	ə AM m a AD t
ember	ɛ AM m b ɛ AM r
emisi	ɛ AM m i AF s i AF
emplasemen	ɛ AM m p l a AD s ə AM m ɛ AM n
enjin	ɛ AM n d ʒ ɪ AL n
ensiklopedia	e AE n s ɪ AL k l o AG p e AE d i AF a̯
entablatur	e AE n t a AD b l a AD t ʊ AJ r
enten	ə AM n t ɛ AM n
entente	ɛ AM n t ɛ AM n t ə AM
entomolog	e AE n t̪ o AG m o AG l ɔ AI ɡ
entomologi	e AE n t̪ o AG m o AG l o AG ɡ i AF
entomologis	e AE n t̪ o AG m o AG l o AG ɡ ɪ AL s
entre	ɛ AM n t r ɛ AM
epidemi	ɛ AM p i AF d̪ ɛ AM m i AF
epistel	ɛ AM p ɪ AL s t ə AM l
epistola	ɛ AM p ɪ AL s t o AG l a AD
eropa	ə AM r o AG p a AD
eror	e AE r ɔ AI r
esai	ɛ AM s a AD i̯ AB
eselon	ɛ AM s ə AM l ɔ AI n
esens	ɛ AM s ɛ AM n s
esensi	ɛ AM s ɛ AM n s i AF
esensial	ɛ AM s ɛ AM n s i AF a AD l
eskalasi	ɛ AM s k a AD l a AD s i AF
eskalator	ɛ AM s k a AD l a AD t ɔ AI r
eskas	ɛ AM s k a AD s
estival	ɛ AM s t̪ i AF v a AD l
etanol	e AE t̪ a AD n ɔ AI l
etiket	ɛ AM t i AF k ɛ AM t̚
evangeli	ɛ AM v a AD ŋ ɡ e AE l i AF
faal	f a AD a AD l
fabel	f a AD b ə AM l
fabrik	f a AD b r ɪ AL k
fail	f a AD ɪ AL l
fakih	f a AD k ɪ AL h AA
faksi	f a AD k̚ s i AF
faktur	f a AD k̚ t ʊ AJ r
fals	f a AD l ə̆ AK s
falsafah	f a AD l s a AD f a AD h AA
familisida	f a AD m i AF l i AF s i AF d a AD
famplet	f a AD m f l ɛ AM t̪̚
fanservis	f a AD n s ɛ AM r v ɪ AL s
farmakologi	f a AD r m a AD k o AG l o AG ɡ i AF
farmakologis	f a AD r m a AD k o AG l o AG ɡ ɪ AL s
farmasis	f a AD r m a AD s ɪ AL s
fas	f a AD s
fasad	f a AD s a AD t̪
fasade	f a AD s a AD d ə AM
fase	f a AD s ə AM
faset	f a AD s ɛ AM t
fasilitas	f a AD s i AF l i AF t̪ a AD s
fatal	f a AD t a AD l
federal	f ɛ AM d ə AM r a AD l
federasi	f ɛ AM d ə AM r a AD s i AF
fekunditas	f e AE k ʊ AJ n d̪ i AF t̪ a AD s
fesyen	f e AE ʃ ə AM n
fetor	f e AE t̪ ɔ AI r
figur	f i AF ɡ ʊ AJ r
figura	f i AF ɡ u AH r a AD
filibuster	f i AF l i AF b ʊ AJ s t ə AM r
film	f ɪ AL l m
filologi	f i AF l o AG l o AG ɡ i AF
filosofi	f i AF l o AG s o AG f i AF
filsafat	f ɪ AL l s a AD f a AD t̚
filsuf	f ɪ AL l s ʊ AJ f
filter	f ɪ AL l t ə AM r
filtrasi	f ɪ AL l t r a AD s i AF
firdaus	f ɪ AL r d̪ a AD ʊ AJ s
firma	f ɪ AL r m a AD
firman	f ɪ AL r m a AD n
fisik	f i AF s ɪ AL k
fisika	f i AF s i AF k a AD
fisiologi	f i AF s i AF o AG l o AG ɡ i AF
fisis	f i AF s ɪ AL s
fitur	f i AF t ʊ AJ r
flambe	f l a AD m b e AE
fon	f ɔ AI n
fondasi	f ɔ AI n d̪ a AD s i AF
fora	f o AG r a AD
forensik	f o AG r ɛ AM n s i AF k
forma	f ɔ AI r m a AD
formasi	f ɔ AI r m a AD s i AF
format	f ɔ AI r m a AD t̪̚
formatur	f ɔ AI r m a AD t̪ ʊ AJ r
forum	f o AG r ʊ AJ m
foto	f o AG t̪ o AG
fotograf	f o AG t̪ o AG ɡ r a AD f
fotografer	f o AG t̪ o AG ɡ r a AD f ə AM r
fotografi	f o AG t̪ o AG ɡ r a AD f i AF
fotografis	f o AG t̪ o AG ɡ r a AD f ɪ AL s
fraksi	f r a AD k s i AF
fraktur	f r a AD k t̪ ʊ AJ r
frasa	f r a AD s a AD
fulus	f u AH l ʊ AJ s
fundamen	f ʊ AJ n d̪ a AD m e AE n
fungsi	f ʊ AJ ŋ s i AF
furnitur	f ʊ AJ r n i AF t ʊ AJ r
fusi	f u AH s i AF
futon	f u AH t ɔ AI n
gaban	ɡ a AD b a AD n
gaji	ɡ a AD d ʒ i AF
gancang	ɡ a AD n t ʃ a AD ŋ
ganco	ɡ a AD n t ʃ o AG
gancu	ɡ a AD n t ʃ u AH
ganda	ɡ a AD n d̪ a AD
gandum	ɡ a AD n d ʊ AJ m
gangren	ɡ a AD ŋ r ɛ AM n
ganja	ɡ a AD n d ʒ a AD
ganjil	ɡ a AD n d ʒ ɪ AL l
garam	ɡ a AD r a AD m
garasi	ɡ a AD r a AD s i AF
garda	ɡ a AD r d a AD
gardan	ɡ a AD r d a AD n
gardu	ɡ a AD r d̪ u AH
garis	ɡ a AD r ɪ AL s
garisan	ɡ a AD r ɪ AL s a AD n
garnisun	ɡ a AD r n i AF s ʊ AJ n
garpu	ɡ a AD r p u AH
gas	ɡ a AD s
gasal	ɡ a AD s a AD l
gatra	ɡ a AD t r a AD
gawai	ɡ a AD w AC a AD i̯ AB
gede	ɡ ə AM d e AE
gehu	ɡ e AE h AA u AH
geiser	ɡ e AE i AF s ə AM r
gelana	ɡ ə AM l a AD n a AD
gelap	ɡ ə AM l a AD p
gelas	ɡ ə AM l a AD s
gembala	ɡ ə AM m b a AD l a AD
gembira	ɡ ə AM m b i AF r a AD
geminte	ɡ ə AM m i AF n t ə AM
genap	ɡ ə AM n a AD p
gendewa	ɡ ə AM n d̪ ɛ AM w AC a AD
genius	ɡ e AE n i AF ʊ AJ s
geofisika	ɡ e AE o AG f i AF s i AF k a AD
geografi	ɡ e AE o AG ɡ r a AD f i AF
geologi	ɡ e AE o AG l o AG ɡ i AF
geometri	ɡ e AE o AG m ɛ AM t r i AF
geram	ɡ ə AM r a AD m
gereja	ɡ ə AM r ɛ AM d ʒ a AD
gerendel	ɡ ə AM r ɛ AM n d ɛ AM l
gergaji	ɡ ə AM r ɡ a AD d ʒ i AF
gerigi	ɡ ə AM r i AF ɡ i AF
gerilya	ɡ ə AM r ɪ AL l j AB a AD
gerinda	ɡ ə AM r ɪ AL n d̪ a AD
geripir	ɡ ə AM r i AF p ɪ AL r
geta	ɡ ə AM t a AD
gi	ɡ i AF
gim	ɡ ɪ AL m
gincu	ɡ ɪ AL n t ʃ u AH
giok	ɡ i AF ɔ AI ʔ
girilaya	ɡ i AF r i AF l a AD j AB a AD
gizi	ɡ i AF z i AF
gliter	ɡ l i AF t̪ ə AM r
gocap	ɡ o AG t ʃ a AD p̚
goceng	ɡ o AG t ʃ ɛ AM ŋ
gocujang	ɡ o AG t ʃ u AH d ʒ a AD ŋ
gokil	ɡ o AG k ɪ AL l
goni	ɡ o AG n i AF
gonore	ɡ o AG n o AG r e AE
gorden	ɡ ɔ AI r d ɛ AM n
got	ɡ ɔ AI t
grad	ɡ r a AD t
gradasi	ɡ r a AD d a AD s i AF
gradien	ɡ r a AD d̪ i AF ɛ AM n
grafik	ɡ r a AD f i AF k̚
grafika	ɡ r a AD f i AF k a AD
grafis	ɡ r a AD f ɪ AL s
grasi	ɡ r a AD s i AF
gratis	ɡ r a AD t ɪ AL s
grendel	ɡ r ɛ AM n d ɛ AM l
guci	ɡ u AH t ʃ i AF
gul	ɡ ʊ AJ l
gulma	ɡ ʊ AJ l m a AD
hablur	h AA a AD p̚ l ʊ AJ r
haid	h AA a AD ɪ AL t
hak	h AA a AD ʔ
halang	h AA a AD l a AD ŋ
halangan	h AA a AD l a AD ŋ a AD n
haleluya	h AA a AD l e AE l u AH j AB a AD
halsduk	h AA a AD l s d ʊ AJ k̚
halte	h AA a AD l t ə AM
haminte	h AA a AD m i AF n t ə AM
hamper	h AA a AD m p ə AM r
hana	h AA a AD n a AD
hanami	h AA a AD n a AD m i AF
handai	h AA a AD n d̪ a AD i̯ AB
hanger	h AA a AD ŋ ə AM r
hanggar	h AA a AD ŋ ɡ a AD r
hartal	h AA a AD r t̪ a AD l
has	h AA a AD s
hawa	h AA a AD w AC a AD
hem	h AA ɛ AM m
hemoroid	h AA e AE m o AG r o AG i AF t̚
hendel	h AA ɛ AM n d ə AM l
hepar	h AA e AE p a AD r
hidrologi	h AA ɪ AL t̪̚ r o AG l o AG ɡ i AF
hijau	h AA i AF d ʒ a AD u̯ AC
hio	h AA i AF o̯ BC
hipotek	h AA i AF p o AG t ɛ AM k
histori	h AA ɪ AL s t̪ o AG r i AF
historis	h AA ɪ AL s t̪ o AG r ɪ AL s
hoaks	h AA o AG a AD k s
hoki	h AA o AG k i AF
hook	h AA ʊ AJ k̚
horizon	h AA o AG r i AF z ɔ AI n
hotel	h AA o AG t ɛ AM l
huakiau	h AA u AH a AD k i AF a AD u̯ AC
hubungan	h AA u AH b ʊ AJ ŋ a AD n
hujan	h AA u AH d ʒ a AD n
humaniora	h AA u AH m a AD n i AF o AG r a AD
hunkue	h AA ʊ AJ n k u AH e̯ BD
hyang	hʲ BB a AD ŋ
ibu	ɪ AL b u AH
ide	i AF d̪ e AE
ideal	ɪ AL d̪ e AE a AD l
identitas	i AF d̪ ɛ AM n t̪ i AF t a AD s
ifumi	ɪ AL f u AH m i AF
ijmal	ɪ AL d ʒ m a AD l
ikhlas	i AF x l a AD s
ikhtiar	ɪ AL x t i AF a AD r
ikhtisar	ɪ AL x t̪ i AF s a AD r
ikon	i AF k ɔ AI n
ilmiah	ɪ AL l m i AF a AD h AA
ilmu	ɪ AL l m u AH
imigrasi	i AF m ɪ AL ɡ r a AD s i AF
imitasi	ɪ AL m i AF t a AD s i AF
imla	ɪ AL m l a AD
implikasi	ɪ AL m p l i AF k a AD s i AF
impor	ɪ AL m p ɔ AI r
impresi	ɪ AL m p r ɛ AM s i AF
impresif	ɪ AL m p r ɛ AM s ɪ AL f
inci	ɪ AL n t ʃ i AF
india	ɪ AL n d̪ i AF a̯
indikasi	ɪ AL n d i AF k a AD s i AF
indraloka	ɪ AL n d r a AD l o AG k a AD
infak	ɪ AL n f a AD k
infanteri	ɪ AL n f a AD n t ə AM r i AF
infeksi	ɪ AL n f ɛ AM k s i AF
informatika	ɪ AL n f ɔ AI r m a AD t̪ i AF k a AD
inhalasi	ɪ AL n h AA a AD l a AD s i AF
inisiatif	ɪ AL n i AF s i AF a AD t ɪ AL f
injeksi	ɪ AL n d ʒ ɛ AM k s i AF
inkrah	ɪ AL n k r a AD h AA
inkues	ɪ AL n k u AH ɛ AM s
inlander	ɪ AL n l a AD n d̪ ə AM r
inokulasi	i AF n o AG k u AH l a AD s i AF
inovasi	ɪ AL n o AG v a AD s i AF
insan	ɪ AL n s a AD n
insek	ɪ AL n s ɛ AM k
insentif	ɪ AL n s ɛ AM n t ɪ AL f
insinyur	ɪ AL n s i AF ɲ ʊ AJ r
inspeksi	ɪ AL n s p ɛ AM k̚ s i AF
inspektur	ɪ AL n s p ɛ AM k̚ t ʊ AJ r
instalasi	ɪ AL n s t a AD l a AD s i AF
instan	ɪ AL n s t a AD n
instansi	ɪ AL n s t a AD n s i AF
institut	ɪ AL n s t i AF t ʊ AJ t
intan	ɪ AL n t a AD n
integrasi	ɪ AL n t ə AM ɡ r a AD s i AF
inteligensi	ɪ AL n t ə AM l i AF d ʒ ɛ AM n s i AF
inteligensia	ɪ AL n t ə AM l i AF d ʒ ɛ AM n s i AF a̯
intelijen	ɪ AL n t ə AM l i AF d ʒ ɛ AM n
interaksi	ɪ AL n t ə AM r a AD k̚ s i AF
internat	ɪ AL n t ə AM r n a AD t
internir	ɪ AL n t ə AM r n ɪ AL r
interpelasi	ɪ AL n t ə AM r p ɛ AM l a AD s i AF
interpretasi	ɪ AL n t̪ ə AM r p r ə AM t̪ a AD s i AF
interpretatif	ɪ AL n t̪ ə AM r p r ə AM t̪ a AD t̪ ɪ AL f
introdusir	ɪ AL n t r o AG d u AH s ɪ AL r
intuisi	ɪ AL n t u AH i AF s i AF
intuitif	ɪ AL n t u AH i AF t ɪ AL f
invalid	ɪ AL n v a AD l ɪ AL t
invasi	ɪ AL n v a AD s i AF
investigasi	ɪ AL n v ɛ AM s t i AF ɡ a AD s i AF
invois	ɪ AL n v o AG ɪ AL s
irak	i AF r a AD k̚
iran	i AF r a AD n
irigasi	ɪ AL r i AF ɡ a AD s i AF
isaril	ɪ AL s r a AD ɪ AL l
isolasi	i AF s o AG l a AD s i AF
israel	ɪ AL s r a AD e AE l
istal	ɪ AL s t a AD l
iuran	i AF ʊ AJ r a AD n
izin	i AF z ɪ AL n
jabatan	d ʒ a AD b a AD t a AD n
jago	d ʒ a AD ɡ o AG
jagra	d ʒ a AD ɡ r a AD
jajan	d ʒ a AD d ʒ a AD n
jaket	d ʒ a AD k ɛ AM t
jaksa	d ʒ a AD k̚ s a AD
jalang	d ʒ a AD l a AD ŋ
jalur	d ʒ a AD l ʊ AJ r
jam	d ʒ a AD m
jambu	d ʒ a AD m b u AH
janda	d ʒ a AD n d̪ a AD
jangkar	d ʒ a AD ŋ k a AD r
janji	d ʒ a AD n d ʒ i AF
jannah	d ʒ a AD n n a AD h AA
jari	ɟ ä ɾ ɪ AL
jaringan	d ʒ a AD r ɪ AL ŋ a AD n
jasa	d ʒ a AD s a AD
jatarupa	d ʒ a AD t a AD r u AH p a AD
jawatan	d ʒ a AD w AC a AD t a AD n
jaya	d ʒ a AD j AB a AD
jejak	d ʒ ə AM d ʒ a AD ʔ
jemaah	d ʒ ə AM m a AD a AD h AA
jemaat	d ʒ ə AM m a AD a AD t
jendela	d ʒ ə AM n d̪ ɛ AM l a AD
jenderal	d ʒ ə AM n d̪ ə AM r a AD l
jenuh	d ʒ ə AM n ʊ AJ h AA
jeriken	d ʒ ɛ AM r i AF k ɛ AM n
jibun	d ʒ i AF b ʊ AJ n
jimat	d ʒ i AF m a AD t
jinayah	d ʒ i AF n a AD j AB a AD h AA
jingga	d ʒ ɪ AL ŋ ɡ a AD
jip	d ʒ ɪ AL p
johan	j AB o AG h AA a AD n
jok	d ʒ ɔ AI ʔ
joki	d ʒ o AG k i AF
jubah	j AB u AH b a AD h AA
juhi	d ʒ u AH h AA i AF
junior	d ʒ u AH n i AF ɔ AI r
jurnal	d ʒ ʊ AJ r n a AD l
jus	d ʒ ʊ AJ s
kabel	k a AD b ə AM l
kacang	k a AD t ʃ a AD ŋ
kacau	k a AD c a AD u̯ AC
kacoa	k a AD t ʃ o AG a AD
kacoak	k a AD t ʃ o AG a AD ʔ
kader	k a AD d ə AM r
kadera	k a AD d̪ ɛ AM r a AD
kadet	k a AD d ɛ AM t
kado	k a AD d o AG
kafe	k a AD f e AE
kafir	k a AD f ɪ AL r
kahak	k a AD h AA a AD k
kail	k a AD ɪ AL l
kain	k a AD ɪ AL n
kakao	k a AD k a AD o̯ BC
kakawin	k a AD k a AD w AC ɪ AL n
kakerlak	k a AD k ə AM r l a AD k̚
kaladuta	k a AD l a AD d u AH t a AD
kalah	k a AD l a AD h AA
kalajengking	k a AD l a AD d ʒ ə AM ŋ k i AF ŋ
kaldu	k a AD l d̪ u AH
kalem	k a AD l ə AM m
kalender	k a AD l ɛ AM n d ə AM r
kaliber	k a AD l i AF b ə AM r
kalimantan	k a AD l i AF m a AD n t a AD n
kalimat	k a AD l i AF m a AD t̚
kalk	k a AD l ə̆ AK ʔ
kalkir	k a AD l k ɪ AL r
kalor	k a AD l ɔ AI r
kamar	k a AD m a AD r
kamboja	k a AD m b o AG d ʒ a AD
kamera	k a AD m ɛ AM r a AD
kamerad	k a AD m ə AM r a AD t̪̚
kamisa	k a AD m i AF s a AD
kamp	k a AD m p
kampanye	k a AD m p a AD ɲ ə AM
kampas	k a AD m p a AD s
kamping	k a AD m p ɪ AL ŋ
kampiun	k a AD m p i AF u AH n
kampus	k a AD m p ʊ AJ s
kamrad	k a AD m r a AD t̪̚
kamsen	k a AD m s ɛ AM n
kamsia	k a AD m s i AF a̯
kanal	k a AD n a AD l
kanan	k a AD n a AD n
kanca	k a AD n t ʃ a AD
kandang	k a AD n d̪ a AD ŋ
kangen	k a AD ŋ ə AM n
kangkung	k a AD ŋ k ʊ AJ ŋ
kangsa	k a AD ŋ s a AD
kanker	k a AD ŋ k ə AM r
kanon	k a AD n ɔ AI n
kans	k a AD n s
kansel	k a AD n s ə AM l
kanselir	k a AD n s ə AM l ɪ AL r
kanser	k a AD n s ə AM r
kanvas	k a AD n v a AD s
kaos	k a AD ɔ AI s
kapasitor	k a AD p a AD s i AF t ɔ AI r
kapitalis	k a AD p i AF t a AD l ɪ AL s
kapitulasi	k a AD p i AF t u AH l a AD s i AF
kapuk	k a AD p u AH ʔ
karang	k a AD r a AD ŋ
karantina	k a AD r a AD n t i AF n a AD
karat	k a AD r a AD t̪̚
karcis	k a AD r t ʃ ɪ AL s
kardus	k a AD r d ʊ AJ s
karena	k a AD r ə AM n a AD
karet	k a AD r ɛ AM t
karier	k a AD r i AF ɛ AM r
karisma	k a AD r ɪ AL s m a AD
karper	k a AD r p ə AM r
karti	k a AD r t̪ i AF
karton	k a AD r t ɔ AI n
kartotek	k a AD r t o AG t ɛ AM k
karung	k a AD r ʊ AJ ŋ
karyawan	k a AD r j AB a AD w AC a AD n
kas	k a AD s
kasa	k a AD s a AD
kasasi	k a AD s a AD s i AF
kasi	k a AD s i AF
kasir	k a AD s ɪ AL r
kasta	k a AD s t̪ a AD
kasti	k a AD s t i AF
kasus	k a AD s ʊ AJ s
kataka	k a AD t a AD k a AD
katakomba	k a AD t a AD k ɔ AI m b a AD
katalis	k a AD t a AD l ɪ AL s
katalisator	k a AD t a AD l i AF s a AD t ɔ AI r
katalog	k a AD t a AD l ɔ AI ɡ
katapel	k a AD t a AD p ɛ AM l
katarsis	k a AD t a AD r s ɪ AL s
katekis	k a AD t ə AM k ɪ AL s
katekumen	k a AD t ə AM k u AH m ə AM n
katering	k a AD t ə AM r ɪ AL ŋ
katolik	k a AD t o AG l ɪ AL k
katrij	k a AD t r ɪ AL d ʒ
katrol	k a AD t r ɔ AI l
katwal	k a AD t̚ w AC a AD l
kaus	k a AD ʊ AJ s
kaveling	k a AD v ə AM l ɪ AL ŋ
kawi	k a AD w AC i AF
kawin	k a AD w AC ɪ AL n
kaya	k a AD j AB a AD
kayak	k a AD j AB a AD ʔ
kayangan	k a AD j AB a AD ŋ a AD n
keamanan	k ə AM a AD m a AD n a AD n
kecemasan	k ə AM t ʃ ə AM m a AD s a AD n
kecoa	k ə AM t ʃ o AG a AD
kecoak	k ə AM t ʃ o AG a AD ʔ
kecuak	k ə AM t ʃ u AH a AD ʔ
kedai	k ə AM d a AD i̯ AB
kedelai	k ə AM d ə AM l a AD i̯ AB
kedewaan	k ə AM d ɛ AM w AC a AD a̯ n
keindraan	k ə AM ɪ AL n d r a AD a AD n
kejahatan	k ə AM d ʒ a AD h AA a AD t̪̚ a AD n
kejaksaan	k ə AM d ʒ a AD k̚ s a AD a AD n
keju	k e AE d ʒ u AH
keki	k ɛ AM k i AF
kelahi	k ə AM l a AD h AA i AF
kelam	k ə AM l a AD m
kelas	k ə AM l a AD s
kelasi	k ə AM l a AD s i AF
kelebut	k ə AM l ə AM b ʊ AJ t̚
keledai	k ə AM l ə AM d a AD i̯ AB
kelenteng	k ə AM l ɛ AM n t ɛ AM ŋ
kelir	k ə AM l ɪ AL r
kelos	k ə AM l ɔ AI s
keluyuk	k ə AM l u AH j AB ʊ AJ k
kemalangan	k ə AM m a AD l a AD ŋ a AD n
kembara	k ə AM m b a AD r a AD
kemboja	k ə AM m b o AG d ʒ a AD
kemeja	k ə AM m ɛ AM d ʒ a AD
kementerian	k ə AM m ə AM n t ə AM r i AF a AD n
kemiri	k ə AM m i AF r i AF
kemoceng	k ə AM m o AG t ʃ ɛ AM ŋ
kempa	k ə AM m p a AD
kempo	k ɛ AM m p o AG
kemudi	k ə AM m u AH d̪ i AF
kencang	k ə AM n t ʃ a AD ŋ
kenceng	k ɛ AM n t ʃ ɛ AM ŋ
kendali	k ə AM n d̪ a AD l i AF
kendara	k ə AM n d a AD r a AD
kenduri	k ə AM n d u AH r i AF
kenop	k ə AM n ɔ AI p
kensel	k ɛ AM n s ə AM l
kental	k ə AM n t a AD l
kentut	k ə AM n t ʊ AJ t
kepegawaian	k ə AM p ə AM ɡ a AD w AC a AD i̯ AB a AD n
kepo	k ɛ AM p o AG
kepsek	k ə AM p̚ s ə AM k̚
kerah	k ə AM r a AD h AA
keran	k ə AM r a AD n
kerangkeng	k ə AM r a AD ŋ k ɛ AM ŋ
kerani	k ə AM r a AD n i AF
kereta	k ə AM r ɛ AM t̪ a AD
kerja	k ə AM r d ʒ a AD
kerkop	k ə AM r k ɔ AI p
kermi	k ə AM r m i AF
keron	k ə AM r ɔ AI n
kerul	k ə AM r ʊ AJ l
kerun	k ə AM r ʊ AJ n
kes	k ɛ AM s
kesatria	k ə AM s a AD t r i AF a̯
kesatuan	k ə AM s a AD t̪ u AH a̯ n
keselamatan	k ə AM s ə AM l a AD m a AD t̪ a AD n
keskul	k ə AM s k ʊ AJ l
kesumba	k ə AM s ʊ AJ m b a AD
ketel	k ɛ AM t̪ ɛ AM l
ketenteraman	k ə AM t̪ ə AM n t̪ ə AM r a AD m a AD n
keti	k ə AM t̪ i AF
khalwat	x a AD l w AC a AD t̚
khanjar	x a AD n d ʒ a AD r
khas	x a AD s
khasi	x a AD s i AF
khayal	x a AD j AB a AD l
khianat	x i AF a AD n a AD t̪̚
khitan	x i AF t̪ a AD n
khoja	x o AG d ʒ a AD
khotbah	kʰ ɔ AI t̪̚ b a AD h AA
kia	k i AF a̯
kiani	k i AF a AD n i AF
kilat	k i AF l a AD t̪̚
kiln	k ɪ AL l ə̆ AK n
kimci	k ɪ AL m t ʃ i AF
kimia	k i AF m i AF a̯
kio	k i AF o̯ BC
kios	k i AF ɔ AI s
kiper	k i AF p ə AM r
kipsiau	k ɪ AL p s i AF a AD u̪
kir	k ɪ AL r
kisah	k i AF s a AD h AA
kismis	k ɪ AL s m ɪ AL s
kista	k ɪ AL s t a AD
klab	k l a AD p̚
klaim	k l a AD ɪ̯ AN m
klan	k l a AD n
klapertar	k l a AD p ə AM r t a AD r
klasik	k l a AD s ɪ AL k
klasis	k l a AD s ɪ AL s
klaster	k l a AD s t ə AM r
klausa	k l a AD u̯ AC s a AD
klerek	k l e AE r ə AM k
klien	k l i AF ə AM n
klik	k l ɪ AL k̚
klinik	k l i AF n ɪ AL k
klinisi	k l i AF n i AF s i AF
kliring	k l i AF r ɪ AL ŋ
klise	k l i AF s ə AM
klub	k l ʊ AJ p
kluster	k l ʊ AJ s t ə AM r
knop	k ə AM n ɔ AI p̚
koalisi	k o AG a AD l i AF s i AF
kober	k o AG b ə AM r
kode	k o AG d ə AM
kodi	k o AG d̪ i AF
kodifikasi	k o AG d i AF f i AF k a AD s i AF
koefisien	k o AG ɛ AM f i AF s i AF ɛ AM n
kohor	k o AG h AA ɔ AI r
koin	k o AG ɪ AL n
kok	k o AG ʔ
kol	k ɔ AI l
kolaborasi	k o AG l a AD b o AG r a AD s i AF
kolaps	k o AG l a AD p s
kolegium	k o AG l e AE ɡ i AF ʊ AJ m
koleksi	k o AG l ɛ AM k s i AF
kolekte	k o AG l ɛ AM k t ə AM
kolese	k o AG l e AE s ə AM
kolf	k ɔ AI l f
koloke	k o AG l o AG k e AE
kolokium	k o AG l o AG k i AF ʊ AJ m
kolom	k o AG l ɔ AI m
kolone	k o AG l o AG n ə AM
koloni	k o AG l o AG n i AF
kolportir	k ɔ AI l p ɔ AI r t ɪ AL r
koma	k o AG m a AD
koman	k o AG m a AD n
komanditer	k o AG m a AD n d i AF t ɛ AM r
komando	k o AG m a AD n d o AG
kombuca	k ɔ AI m b u AH t ʃ a AD
kombukha	k ɔ AI m b u AH x a AD
komen	k o AG m ɛ AM n
komendur	k o AG m ə AM n d ʊ AJ r
komentar	k o AG m ɛ AM n t̪ a AD r
komik	k o AG m ɪ AL k
komika	k o AG m i AF k a AD
komisar	k o AG m i AF s a AD r
komisaris	k o AG m i AF s a AD r ɪ AL s
komisioner	k o AG m i AF s i AF o AG n ɛ AM r
komitmen	k o AG m ɪ AL t m ə AM n
kompak	k ɔ AI m p a AD k
kompeni	k o AG m p ə AM n i AF
kompleks	k ɔ AI m p l ɛ AM k s
komponen	k ɔ AI m p o AG n ɛ AM n
komponis	k ɔ AI m p o AG n ɪ AL s
kompor	k ɔ AI m p ɔ AI r
komprehensif	k ɔ AI m p r e AE h AA ɛ AM n s ɪ AL f
komputer	k ɔ AI m p u AH t ə AM r
komunal	k o AG m u AH n a AD l
komune	k o AG m u AH n ə AM
komuni	k o AG m u AH n i AF
komunisme	k o AG m u AH n ɪ AL s m ə AM
komunistis	k o AG m u AH n ɪ AL s t̪ ɪ AL s
komunitas	k o AG m u AH n i AF t a AD s
kondensator	k ɔ AI n d ɛ AM n s a AD t ɔ AI r
kondisi	k ɔ AI n d i AF s i AF
konduite	k ɔ AI n d̪ u AH i AF t ə AM
konfeksi	k ɔ AI n f ɛ AM k̚ s i AF
kongko	k ɔ AI ŋ k o AG
kongkoan	k ɔ AI ŋ k o AG a AD n
kongregasi	k ɔ AI ŋ r e AE ɡ a AD s i AF
kongres	k ɔ AI ŋ r ɛ AM s
kongsi	k ɔ AI ŋ s i AF
konkret	k ɔ AI n k r ɛ AM t
konkuisnador	k ɔ AI n k u AH ɪ AL s n a AD d ɔ AI r
konsesi	k ɔ AI n s ɛ AM s i AF
konsil	k ɔ AI n s ɪ AL l
konsili	k ɔ AI n s i AF l i AF
konsinyasi	k ɔ AI n s i AF ɲ a AD s i AF
konsistori	k ɔ AI n s ɪ AL s t o AG r i AF
konstanta	k ɔ AI n s t a AD n t a AD
konstituante	k ɔ AI n s t̪ i AF t̪ u AH a AD n t̪ ə AM
konstituen	k ɔ AI n s t̪ i AF t̪ u AH ɛ AM n
konstitusi	k ɔ AI n s t i AF t u AH s i AF
konstitusional	k ɔ AI n s t i AF t u AH s i AF o AG n a AD l
konstruksi	k ɔ AI n s t r ʊ AJ k s i AF
konsumsi	k o AG n s u AH m s i AF
kontak	k o AG n t a AD k̚
kontaminasi	k ɔ AI n t̪ a AD m i AF n a AD s i AF
kontan	k ɔ AI n t a AD n
konter	k ɔ AI n t ə AM r
kontinen	k ɔ AI n t̪ i AF n ɛ AM n
kontrak	k ɔ AI n t r a AD k
kontribusi	k ɔ AI n t̪ r i AF b u AH s i AF
kontrol	k ɔ AI n t r ɔ AI l
kontrolir	k ɔ AI n t r o AG l ɪ AL r
konveksi	k ɔ AI n v ɛ AM k s i AF
konvensi	k ɔ AI n v ɛ AM n s i AF
konyan	k o AG ɲ a AD n
kopel	k o AG p ə AM l
kopling	k o AG p̚ l i AF ŋ
koran	k o AG r a AD n
korban	k ɔ AI r b a AD n
korea	k ɔ AI r e AE a̯
koreksi	k o AG r ɛ AM k s i AF
korma	k ɔ AI r m a AD
korona	k o AG r o AG n a AD
korporasi	k ɔ AI r p o AG r a AD s i AF
korsi	k ɔ AI r s i AF
korting	k ɔ AI r t ɪ AL ŋ
kos	k ɔ AI s
kosen	k o AG s ɛ AM n
koteng	k o AG t ɛ AM ŋ
koyok	k o AG j AB ɔ AI ʔ
kram	k r a AD m
krat	k r a AD t̪̚
kreasi	k r ɛ AM a AD s i AF
kreatif	k r ɛ AM a AD t ɪ AL f
kreativitas	k r ɛ AM a AD t i AF v i AF t a AD s
kredit	k r ɛ AM d ɪ AL t̪̚
kreditan	k r e AE d̪ i AF t̪ a AD n
kreditor	k r ɛ AM d i AF t̪ ɔ AI r
kreditur	k r ɛ AM d i AF t̪ ʊ AJ r
krem	k r ɛ AM m
kremasi	k r ɛ AM m a AD s i AF
kres	k r ɛ AM s
krim	k r ɪ AL m
kriminal	k r i AF m i AF n a AD l
kriminil	k r i AF m i AF n ɪ AL l
krisis	k r i AF s ɪ AL s
krisma	k r ɪ AL s m a AD
kristal	k r ɪ AL s t a AD l
kritik	k r i AF t̪ ɪ AL k
kritikus	k r i AF t̪ i AF k ʊ AJ s
kritis	k r i AF t̪ ɪ AL s
kritisi	k r i AF t̪ i AF s i AF
kriya	k r i AF j AB a AD
kroket	k r o AG k ɛ AM t̚
kromo	k r ɔ AI m ɔ AI
kronis	k r o AG n ɪ AL s
kronologi	k r o AG n o AG l o AG ɡ i AF
kronologis	k r o AG n o AG l o AG ɡ ɪ AL s
kru	k r u AH
kuaci	k u AH a̯ t ʃ i AF
kuali	k u AH a̯ l i AF
kualitas	k u AH a AD l i AF t a AD s
kuasa	k u AH a AD s a AD
kubah	k u AH b a AD h AA
kubis	k u AH b ɪ AL s
kubur	k u AH b ʊ AJ r
kuburan	k u AH b ʊ AJ r a AD n
kubus	k u AH b ʊ AJ s
kue	k u AH e̯ BD
kueri	k u AH ɛ AM r i AF
kuesioner	k u AH ɛ AM s i AF o AG n ɛ AM r
kuis	k u AH ɪ AL s
kuisioner	k u AH ɪ AL s i AF o AG n ɛ AM r
kulkas	k ʊ AJ l k a AD s
kulpa	k ʊ AJ l p a AD
kultur	k ʊ AJ l t ʊ AJ r
kuluyuk	k u AH l u AH j AB ʊ AJ k
kuman	k u AH m a AD n
kumba	k ʊ AJ m b a AD
kumbakara	k ʊ AJ m b a AD k a AD r a AD
kunci	k ʊ AJ n t ʃ i AF
kungfu	k ʊ AJ ŋ f u AH
kunyit	k u AH ɲ ɪ AL t̚
kuota	k u AH o AG t a AD
kuotum	k u AH o AG t ʊ AJ m
kuplet	k ʊ AJ p l ɛ AM t̪̚
kurban	k ʊ AJ r b a AD n
kuria	k u AH r i AF a̯
kurir	k u AH r ɪ AL r
kurkuma	k ʊ AJ r k u AH m a AD
kurma	k ʊ AJ r m a AD
kursi	k ʊ AJ r s i AF
kursus	k u AH r s u AH s
kurus	k u AH r ʊ AJ s
kurva	k ʊ AJ r v a AD
kusala	k u AH s a AD l a AD
kutu	k u AH t u AH
kwetiau	k w AC e AE t i AF a AD u AH
laba	l a AD b a AD
laboratorium	l a AD b o AG r a AD t o AG r i AF ʊ AJ m
lacur	l a AD t ʃ ʊ AJ r
laga	l a AD ɡ a AD
lagu	l a AD ɡ u AH
lakban	l a AD k̚ b a AD n
lakmus	l a AD k m ʊ AJ s
lamina	l a AD m i AF n a AD
lampion	l a AD m p i AF ɔ AI n
lampu	l a AD m p u AH
lanbau	l a AD n b a AD u̯ AC
lancang	l a AD n t ʃ a AD ŋ
lancar	l a AD n t ʃ a AD r
langgar	l a AD ŋ ɡ a AD r
langsam	l a AD ŋ s a AD m
langsir	l a AD ŋ s ɪ AL r
lanhir	l a AD n h AA ɪ AL r
lansir	l a AD n s ɪ AL r
lanskap	l a AD n s k a AD p̚
lapor	l a AD p ɔ AI r
laporan	l a AD p ɔ AI r a AD n
las	l a AD s
lata	l a AD t a AD
latah	l a AD t̪ a AD h AA
laut	l a AD ʊ AJ t̪̚
layar	l a AD j AB a AD r
leding	l ɛ AM d ɪ AL ŋ
legal	l ɛ AM ɡ a AD l
legasi	l ɛ AM ɡ a AD s i AF
legislasi	l ɛ AM ɡ ɪ AL s l a AD s i AF
legislatif	l ɛ AM ɡ ɪ AL s l a AD t ɪ AL f
legitimasi	l ɛ AM ɡ i AF t i AF m a AD s i AF
lektur	l ɛ AM k t ʊ AJ r
lem	l ɛ AM m
lemari	l ə AM m a AD r i AF
lembaga	l ə AM m b a AD ɡ a AD
lembu	l ə AM m b u AH
lemot	l ə AM m ɔ AI t̪̚
lenso	l e AE n s o AG
lentera	l ə AM n t ɛ AM r a AD
lepa	l ɛ AM p a AD
lerai	l ə AM r a AD i̯ AB
les	l ɛ AM s
lesi	l ə AM s i AF
leter	l ɛ AM t ə AM r
letnan	l ɛ AM t̪̚ n a AD n
level	l ɛ AM v ə AM l
lever	l ɛ AM v ə AM r
lezat	l ə AM z a AD t̪̚
liang	l i AF a̯ ŋ
liberal	l i AF b ə AM r a AD l
lid	l ɪ AL t
lift	l ɪ AL f
liga	l i AF ɡ a AD
lihai	l i AF h AA a AD i̯ AB
likuid	l i AF k u AH ɪ AL t̪̚
likuida	l i AF k u AH ɪ AL d̪ a AD
likuidasi	l i AF k u AH i AF d̪ a AD s i AF
likuidator	l i AF k u AH i AF d̪ a AD t̪ ɔ AI r
likuiditas	l i AF k u AH i AF d̪ i AF t̪ a AD s
limau	l i AF m a AD u̯ AC
limpa	l ɪ AL m p a AD
lin	l ɪ AL n
lindu	l i AF n d u AH
lingga	l ɪ AL ŋ ɡ a AD
lingkungan	l ɪ AL ŋ k ʊ AJ ŋ a AD n
lini	l i AF n i AF
liong	l i AF ɔ AI ŋ
lipas	l i AF p a AD s
lis	l ɪ AL s
lisensi	l i AF s ɛ AM n s i AF
listrik	l ɪ AL s t r ɪ AL k̚
literatur	l i AF t ə AM r a AD t ʊ AJ r
liturgi	l i AF t ʊ AJ r ɡ i AF
loak	l o AG a AD ʔ
logam	l o AG ɡ a AD m
logika	l o AG ɡ i AF k a AD
logistik	l o AG ɡ ɪ AL s t ɪ AL k
lokal	l o AG k a AD l
lokastiti	l o AG k a AD s t i AF t i AF
lokatraya	l o AG k a AD t r a AD j AB a AD
lonceng	l ɔ AI n t ʃ ɛ AM ŋ
lonte	l ɔ AI n t̪ e AE
lor	l ɔ AI r
los	l ɔ AI s
lot	l ɔ AI t
loteng	l o AG t ɛ AM ŋ
lotre	l ɔ AI t r e AE
madu	m a AD d̪ u AH
madukara	m a AD d̪ u AH k a AD r a AD
madya	m a AD d̪ j AB a AD
magasin	m a AD ɡ a AD s ɪ AL n
magi	m a AD ɡ i AF
magister	m a AD ɡ ɪ AL s t ə AM r
magistrat	m a AD ɡ ɪ AL s t̪ r a AD t̪̚
mahaduta	m a AD h AA a AD d u AH t a AD
mahaguru	m a AD h AA a AD ɡ u AH r u AH
mahal	m a AD h AA a AD l
mahar	m a AD h AA a AD r
mahasiswa	m a AD h AA a AD s ɪ AL s w AC a AD
mahkamah	m a AD h AA k a AD m a AD h AA
maho	m a AD h AA o AG
makam	m a AD k a AD m
makaron	m a AD k a AD r ɔ AI n
makarun	m a AD k a AD r ʊ AJ n
makelar	m a AD k ə AM l a AD r
maket	m a AD k ɛ AM t
malaikat	m a AD l a AD i AF k a AD t
malaise	m a AD l a AD i̯ AB s ə AM
malapetaka	m a AD l a AD p ə AM t̪ a AD k a AD
malaria	m a AD l a AD r i AF a̯
malaysia	m a AD l a AD j AB s i AF a̯
maligai	m a AD l i AF ɡ a AD i̯ AB
mandala	m a AD n d̪ a AD l a AD
mandalika	m a AD n d̪ a AD l i AF k a AD
mandarin	m a AD n d̪ a AD r ɪ AL n
mandor	m a AD n d ɔ AI r
maneken	m a AD n ə AM k ɛ AM n
mangsa	m a AD ŋ s a AD
manhwa	m a AD n h AA w AC a AD
mani	m a AD n i AF
manik	m a AD n ɪ AL k
manual	m a AD n u AH a AD l
manusia	m a AD n u AH s i AF a̯
mara	m a AD r a AD
marcapada	m a AD r t ʃ a AD p a AD d a AD
mare	m a AD r ə AM
markah	m a AD r k a AD h AA
mars	m a AD r s
marsose	m a AD r s o AG s e AE
martil	m a AD r t ɪ AL l
martir	m a AD r t ɪ AL r
masa	m a AD s a AD
masif	m a AD s ɪ AL f
masin	m a AD s ɪ AL n
masinis	m a AD s i AF n ɪ AL s
maskapai	m a AD s k a AD p a AD i̯ AB
maskara	m a AD s k a AD r a AD
massa	m a AD s s a AD
master	m a AD s t̪ ə AM r
masuk	m a AD s ʊ AJ k
matematika	m a AD t e AE m a AD t i AF k a AD
materi	m a AD t e AE r i AF
material	m a AD t e AE r i AF a AD l
materialistis	m a AD t̪ e AE r i AF a AD l ɪ AL s t̪ ɪ AL k̚
materiel	m a AD t e AE r i AF ə AM l
materiil	m a AD t e AE r i AF ɪ AL l
matra	m a AD t̚ r a AD
matros	m a AD t̚ r ɔ AI s
maut	m a AD u AH t
mayor	m a AD j AB ɔ AI r
mayoritas	m a AD j AB o AG r i AF t̪ a AD s
mebel	m ɛ AM b ə AM l
medali	m ə AM d a AD l i AF
media	m e AE d i AF a̯
median	m e AE d i AF a AD n
medikasi	m ɛ AM d̪ i AF k a AD s i AF
medis	m ɛ AM d̪ ɪ AL s
meditasi	m ɛ AM d̪ i AF t̪ a AD s i AF
medium	m e AE d i AF ʊ AJ m
mega	m ɛ AM ɡ a AD
meja	m ɛ AM d ʒ a AD
meka	m ɛ AM k a AD
melati	m ə AM l a AD t̪ i AF
membantu	m ə AM m b a AD n t̪ u AH
membongmeh	m ə AM ŋ b ɔ AI ŋ m e AE h AA
mendira	m ə AM n d̪ i AF r a AD
mengoposisi	m ə AM ŋ o AG p o AG s i AF s i AF
menir	m ə AM n ɪ AL r
menstruasi	m ɛ AM n s t r u AH a AD s i AF
mentega	m ə AM n t ɛ AM ɡ a AD
merana	m ə AM r a AD n a AD
mercu	m ə AM r t ʃ u AH
mercusuar	m ə AM r t ʃ u AH s u AH a AD r
merdeka	m ə AM r d̪ ɛ AM k a AD
merdu	m ə AM r d̪ u AH
merek	m ɛ AM r ə AM k̚
merino	m ə AM r i AF n o AG
meru	m e AE r u AH
mes	m ɛ AM s
meses	m ɛ AM s ə AM s
mesin	m ə AM s ɪ AL n
mesra	m ə AM s r a AD
mester	m ɛ AM s t ə AM r
metastase	m ɛ AM t a AD s t a AD s ə AM
metastasis	m ɛ AM t a AD s t a AD s i AF s
meter	m ɛ AM t ə AM r
meterai	m ə AM t̪ ə AM r a AD i AF
metrum	m ɛ AM t r ʊ AJ m
mi	m i AF
migas	m i AF ɡ a AD s
migrain	m i AF ɡ r a AD i AF n
milenial	m i AF l e AE n i AF a AD l
milenium	m i AF l e AE n i AF ʊ AJ m
milieu	m i AF l i AF ə AM u̯ AC
milisi	m i AF l i AF s i AF
militer	m i AF l i AF t ɛ AM r
mimbar	m ɪ AL m b a AD r
mimisan	m i AF m ɪ AL s a AD n
mina	m i AF n a AD
minor	m i AF n ɔ AI r
minyak	m i AF ɲ a AD k
misa	m i AF s a AD
misi	m i AF s i AF
misionaris	m i AF s i AF o AG n a AD r ɪ AL s
miskram	m ɪ AL s k r a AD m
mistar	m ɪ AL s t a AD r
misteri	m ɪ AL s t e AE r i AF
mitra	m ɪ AL t̚ r a AD
modal	m o AG d̪ a AD l
mode	m o AG d ə AM
model	m o AG d ɛ AM l
modern	m o AG d ɛ AM r ə̆ AK n
modernisme	m o AG d ɛ AM r ə̆ AK n ɪ AL s m ə AM
modiste	m o AG d ɪ AL s t ə AM
modul	m o AG d̪ ʊ AJ l
modus	m o AG d ʊ AJ s
mohon	m ɔ AI h AA ɔ AI n
mohor	m o AG h AA ɔ AI r
mokat	m o AG k a AD t̚
mokbang	m ɔ AI k b a AD ŋ
molekul	m o AG l ə AM k ʊ AJ l
monsinyur	m ɔ AI n s i AF ɲ ʊ AJ r
montir	m ɔ AI n t ɪ AL r
mopit	m o AG p ɪ AL t
mortar	m ɔ AI r t a AD r
mortem	m ɔ AI r t̪ ə AM m
mortir	m ɔ AI r t ɪ AL r
mosi	m o AG s i AF
mua	m u AH a̯
mubazir	m u AH b a AD z ɪ AL r
mudik	m u AH d ɪ AL k
mufakat	m u AH f a AD k a AD t
munci	m ʊ AJ n t ʃ i AF
muncikari	m ʊ AJ n t ʃ i AF k a AD r i AF
murid	m u AH r ɪ AL t̚
musala	m u AH s a AD l a AD
museum	m ʊ AJ s j AB ʊ AJ m
musik	m u AH s ɪ AL k̚
musikus	m u AH s i AF k ʊ AJ s
musim	m u AH s ɪ AL m
musisi	m u AH s i AF s i AF
mutiara	m u AH t̪ i AF a̯ r a AD
mutu	m u AH t̪ u AH
nabe	n a AD b e AE
nadi	n a AD d i AF
nafsu	n a AD f s u AH
naga	n a AD ɡ a AD
najis	n a AD d ʒ ɪ AL s
namaskara	n a AD m a AD s k a AD r a AD
nasib	n a AD s ɪ AL p̚
natal	n a AD t̪ a AD l
nayaka	n a AD j AB a AD k a AD
necis	n ɛ AM t ʃ ɪ AL s
negara	n ə AM ɡ a AD r a AD
negatif	n ɛ AM ɡ a AD t ɪ AL f
neraca	n ə AM r a AD t ʃ a AD
ners	n ə AM r s
net	n ɛ AM t̪
neto	n e AE t o AG
netral	n ɛ AM t r a AD l
niaga	n i AF a AD ɡ a AD
nilai	n i AF l a AD i̯ AB
ninja	n ɪ AL n d ʒ a AD
nirguna	n ɪ AL r ɡ u AH n a AD
nirleka	n ɪ AL r l ɛ AM k a AD
nirmala	n ɪ AL r m a AD l a AD
nisan	n i AF s a AD n
nisbi	n ɪ AL s b i AF
niscaya	n ɪ AL s t ʃ a AD j AB a AD
nista	n ɪ AL s t a AD
nomer	n o AG m ə AM r
nominal	n o AG m i AF n a AD l
nomor	n o AG m ɔ AI r
nonelektrik	n ɔ AI n ɛ AM l ɛ AM k t̪ r ɪ AL k
nonfisik	n ɔ AI n f i AF s ɪ AL k̚
nonfiskal	n ɔ AI n f ɪ AL s k a AD l
nonsens	n ɔ AI n s ɛ AM n s
nonsubsidi	n ɔ AI n s ʊ AJ p̚ s i AF d i AF
nontunai	n ɔ AI n t u AH n a AD i̯ AB
norma	n ɔ AI r m a AD
nota	n o AG t̪ a AD
notaris	n o AG t a AD r ɪ AL s
novel	n o AG v ɛ AM l
novum	n o AG v ʊ AJ m
nuklir	n ʊ AJ k l ɪ AL r
nutrisi	n u AH t r i AF s i AF
nyata	ɲ a AD t̪ a AD
nyawa	ɲ a AD w AC a AD
obat	o AG b a AD t
objek	ɔ AI p d ʒ ɛ AM k
obstruksi	ɔ AI p̚ s t r ʊ AJ k s i AF
oditur	ɔ AI d̪ i AF t̪ ʊ AJ r
odol	o AG d ɔ AI l
ofset	ɔ AI f s ɛ AM t̪̚
oikumene	o AG i̯ AB k u AH m e AE n e AE
oksigen	ɔ AI k s i AF ɡ ɛ AM n
oktroi	o AG k̚ t r o AG i̯ AB
okulasi	o AG k u AH l a AD s i AF
okupasi	o AG k u AH p a AD s i AF
olahraga	o AG l a AD h AA r a AD ɡ a AD
oli	o AG l i AF
om	o AG m
omslah	ɔ AI m s l a AD h AA
omzet	ɔ AI m z ɛ AM t
onderneming	ɔ AI n d ə AM r n e AE m ɪ AL ŋ
onslah	ɔ AI n s l a AD h AA
operasi	o AG p ə AM r a AD s i AF
oplah	ɔ AI p̚ l a AD h AA
opname	ɔ AI p n a AD m ə AM
oposisi	ɔ AI p o AG s i AF s i AF
opseter	ɔ AI p s ɛ AM t ə AM r
opsi	ɔ AI p̚ s i AF
opsir	ɔ AI p s ɪ AL r
orang	ɔ AI r ä ŋ
orde	ɔ AI r d ə AM
order	ɔ AI r d ə AM r
ordi	ɔ AI r d̪ i AF
ordo	ɔ AI r d o AG
ordonansi	ɔ AI r d o AG n a AD n s i AF
organ	ɔ AI r ɡ a AD n
organogram	ɔ AI r ɡ a AD n o AG ɡ r a AD m
orisinal	ɔ AI r i AF s i AF n a AD l
osuari	o AG s u AH a AD r i AF
otomat	ɔ AI t o AG m a AD t̪
otomatis	ɔ AI t o AG m a AD t̪ ɪ AL s
otomatisasi	ɔ AI t o AG m a AD t̪ i AF s a AD s i AF
otonomi	o AG t o AG n o AG m i AF
otoritas	ɔ AI t̪ o AG r i AF t̪ a AD s
otoriter	ɔ AI t o AG r i AF t̪ ɛ AM r
otoritet	ɔ AI t̪ o AG r i AF t̪ ɛ AM t̪̚
oven	o AG v ə AM n
pabrik	p a AD p̚ r ɪ AL k
pacar	p a AD t ʃ a AD r
pacaran	p a AD t ʃ a AD r a AD n
padmasana	p a AD t̚ m a AD s a AD n a AD
pagar	p a AD ɡ a AD r
pagina	p a AD ɡ i AF n a AD
pagoda	p a AD ɡ o AG d̪ a AD
pai	p a AD i̯ AB
pailit	p a AD i̯ AB l ɪ AL t
pajak	p a AD d ʒ a AD ʔ
pak	p a AD ʔ
paker	p a AD k ə AM r
paket	p a AD k ɛ AM t
pakpui	p a AD ʔ p u AH i̯ AB
paksa	p a AD k s a AD
pakta	p a AD k t̪ a AD
pakuncen	p a AD k ʊ AJ n t ʃ ɛ AM n
pal	p a AD l
palagan	p a AD l a AD ɡ a AD n
palka	p a AD l k a AD
palsu	p a AD l s u AH
pamer	p a AD m ɛ AM r
pamflet	p a AD m f l ɛ AM t̪̚
pamper	p a AD m p ə AM r
panau	p a AD n a AD u̯ AC
pancaroba	p a AD n t ʃ a AD r o AG b a AD
panci	p a AD ɲ t ʃ i AF
pandai	p a AD n d̪ a AD i̯ AB
pandu	p a AD n d u AH
panen	p a AD n ɛ AM n
panenan	p a AD n ɛ AM n a AD n
pangan	p a AD ŋ a AD n
panggung	p a AD ŋ ɡ ʊ AJ ŋ
panitera	p a AD n i AF t ə AM r a AD
panji	p a AD n d ʒ i AF
pantas	p a AD n t a AD s
panti	p a AD n t̪ i AF
pantofel	p a AD n t̪ o AG f ə AM l
papirus	p a AD p i AF r ʊ AJ s
parabel	p a AD r a AD b ə AM l
paradiso	p a AD r a AD d̪ i AF s o AG
paraf	p a AD r a AD f
paragraf	p a AD r a AD ɡ r a AD f
paralel	p a AD r a AD l ɛ AM l
parasit	p a AD r a AD s ɪ AL t
parau	p a AD r a AD u̯ AC
parfum	p a AD r f ʊ AJ m
pariwara	p a AD r i AF w AC a AD r a AD
parket	p a AD r k ɛ AM t
parkir	p a AD r k ɪ AL r
parsel	p a AD r s ə AM l
partai	p a AD r t a AD i̯ AB
partikel	p a AD r t i AF k ə AM l
partisipasi	p a AD r t i AF s i AF p a AD s i AF
paru	p a AD r u AH
pas	p a AD s
pascasarjana	p a AD s t ʃ a AD s a AD r d ʒ a AD n a AD
pasfoto	p a AD s f o AG t o AG
pasiva	p a AD s i AF v a AD
pasok	p a AD s ɔ AI k̚
paspor	p a AD s p ɔ AI r
pasta	p a AD s t a AD
pastel	p a AD s t ɛ AM l
pasukan	p a AD s ʊ AJ k̚ a AD n
paten	p a AD t ɛ AM n
pater	p a AD t ə AM r
pati	p a AD t i AF
patih	p a AD t ɪ AL h AA
patologi	p a AD t o AG l o AG ɡ i AF
patri	p a AD t̪ r i AF
patriark	p a AD t̚ r i AF a AD r k
patroli	p a AD t r o AG l i AF
patrun	p a AD t r ʊ AJ n
paviliun	p a AD v i AF l i AF ʊ AJ n
peci	p ɛ AM t ʃ i AF
pedati	p ə AM d a AD t i AF
pegawai	p ə AM ɡ a AD w AC a AD i̯ AB
peksi	p ə AM k s i AF
pel	p ɛ AM l
pelangkin	p ə AM l a AD ŋ k ɪ AL n
pelat	p ə AM l a AD t̪̚
pelayanan	p ə AM l a AD j AB a AD n a AD n
pelesir	p ə AM l ə AM s ɪ AL r
pelita	p ə AM l i AF t a AD
pelitur	p ə AM l i AF t̪ ʊ AJ r
pelor	p ɛ AM l ɔ AI r
pelpolisi	p ɛ AM l p o AG l i AF s i AF
peluru	p ə AM l u AH r u AH
pembantu	p ə AM m b a AD n t̪ u AH
pemberat	p ə AM m b ə AM r a AD t̪̚
pemilihan	p ə AM m i AF l ɪ AL h AA a AD n
pen	p ɛ AM n
pena	p ɛ AM n a AD
pendidikan	p ə AM n d i AF d ɪ AL k a AD n
pendopo	p ə AM n d o AG p o AG
pengacara	p ə AM ŋ a AD t ʃ a AD r a AD
pengadilan	p ə AM ŋ a AD d̪ ɪ AL l a AD n
pengajian	p ə AM ŋ a AD d ʒ i AF a AD n
pengangkutan	p ə AM ŋ a AD ŋ k ʊ AJ t̪ a AD n
pengarah	p ə AM ŋ a AD r a AD h AA
pengembangan	p ə AM ŋ ə AM m b a AD ŋ a AD n
pengemudi	p ə AM ŋ ə AM m u AH d i AF
pengetahuan	p ə AM ŋ ə AM t a AD u AH a AD n
penggaris	p ə AM ŋ ɡ a AD r ɪ AL s
penggawa	p ə AM ŋ ɡ a AD w AC a AD
pengkajian	p ə AM ŋ k a AD d ʒ i AF a AD n
pengujian	p ə AM ŋ u AH d ʒ i AF a AD n
penis	p ɛ AM n ɪ AL s
peniti	p ə AM n i AF t̪ i AF
penjahit	p ə AM n d ʒ a AD h AA ɪ AL t̚
penjara	p ə AM n d ʒ a AD r a AD
penolong	p ə AM n o AG l ɔ AI ŋ
pensil	p ɛ AM n s ɪ AL l
pensiun	p ɛ AM n s i AF ʊ AJ n
pentakosta	p ɛ AM n t̪ a AD k ɔ AI s t̪ a AD
pentil	p ɛ AM n t ɪ AL l
penyusun	p ə AM ɲ u AH s ʊ AJ n
pepaya	p ə AM p a AD j AB a AD
per	p ɛ AM r
perai	p ə AM r a AD i̯ AB
perancis	p ə AM r a AD n t ʃ ɪ AL s
perang	p e AE r a AD ŋ
perbal	p ə AM r b a AD l
perbawa	p ə AM r b a AD w AC a AD
perca	p ə AM r t ʃ a AD
perek	p ə AM r ɛ AM k̚
performa	p ə AM r f ɔ AI r m a AD
perhubungan	p ə AM r h AA u AH b ʊ AJ ŋ a AD n
peri	p ə AM r i AF
peribahasa	p ə AM r i AF b a AD h AA a AD s a AD
periksa	p ə AM r ɪ AL k s a AD
perilaku	p ə AM r i AF l a AD k u AH
pering	p ə AM r ɪ AL ŋ
periode	p e AE r i AF o AG d ə AM
periodik	p e AE r i AF o AG d ɪ AL k
perisai	p ə AM r i AF s a AD i̯ AB
perkasa	p r a AD k a AD s a AD
perkedel	p ə AM r k ə AM d ɛ AM l
perkosa	p ə AM r k o AG s a AD
perleng	p ə AM r l ɛ AM ŋ
perlip	p ə AM r l ɪ AL p
perlop	p ə AM r l o AG p
perlup	p ə AM r l ʊ AJ p
permak	p ə AM r m a AD ʔ
permen	p ə AM r m ɛ AM n
permisi	p ə AM r m i AF s i AF
peron	p ɛ AM r ɔ AI n
perpuluhan	p ə AM r p u AH l ʊ AJ h AA a AD n
pers	p ɛ AM r s
persekutuan	p ə AM r s ə AM k u AH t u AH a AD n
persepuluhan	p ə AM r s ə AM p u AH l ʊ AJ h AA a AD n
persero	p ə AM r s ɛ AM r o AG
perseroan	p ə AM r s ɛ AM r o AG a AD n
persil	p ɛ AM r s ɪ AL l
persis	p ə AM r s ɪ AL s
persona	p ə AM r s o AG n a AD
pertapa	p ə AM r t a AD p a AD
perum	p ə AM r ʊ AJ m
perusahaan	p ə AM r u AH s a AD h AA a AD a AD n
perwara	p ə AM r w AC a AD r a AD
perwira	p ə AM r w AC i AF r a AD
pes	p ɛ AM s
pesantian	p ə AM s a AD n t i AF a AD n
pesarean	p ə AM s a AD r ɛ AM a AD n
pesero	p ə AM s ɛ AM r o AG
pesta	p ɛ AM s t̪ a AD
pet	p ɛ AM t̪̚
petaka	p ə AM t̪ a AD k a AD
peti	p ə AM t̪ i AF
petir	p ə AM t̪ ɪ AL r
petroleum	p e AE t r o AG l e AE u AH m
piagam	p i AF a̯ ɡ a AD m
piala	p i AF a AD l a AD
piawai	p i AF a AD w AC a AD i̯ AB
pidato	p i AF d a AD t o AG
pigura	p i AF ɡ u AH r a AD
pilar	p i AF l a AD r
pileg	p i AF l ɛ AM ɡ
pin	p ɪ AL n
pindakas	p ɪ AL n d̪ a AD k a AD s
pipa	p i AF p a AD
pirang	p i AF r a AD ŋ
pisau	p i AF s a AD u̯ AC
pispot	p ɪ AL s p ɔ AI t
piung	p i AF ʊ AJ ŋ
pivot	p i AF v ɔ AI t̪̚
plakat	p l a AD k a AD t
plan	p l a AD n
planing	p l a AD n ɪ AL ŋ
plantase	p l a AD n t̪ a AD s ə AM
plasebo	p l a AD s e AE b o AG
plasenta	p l a AD s ɛ AM n t a AD
plastik	p l a AD s t̪ ɪ AL k̚
plastis	p l a AD s t̪ ɪ AL s
platform	p l a AD t f ɔ AI r m
plaza	p l a AD z a AD
plombir	p l ɔ AI m b ɪ AL r
plural	p l u AH r a AD l
pluralistik	p l u AH r a AD l ɪ AL s t ɪ AL k
pluralistis	p l u AH r a AD l ɪ AL s t ɪ AL s
pohon	p ɔ AI h AA ɔ AI n
poin	p o AG ɪ AL n
pokrol	p ɔ AI k r ɔ AI l
pol	p ɔ AI l
poldan	p ɔ AI l d a AD n
polder	p ɔ AI l d ə AM r
poli	p o AG l i AF
polisi	p o AG l i AF s i AF
politeknik	p o AG l i AF t ɛ AM k n ɪ AL k
politik	p ɔ AI l l i AF t ɪ AL k̚
politikus	p o AG l i AF t i AF k ʊ AJ s
polmah	p ɔ AI l m a AD h AA
pompa	p ɔ AI m p a AD
pondok	p o AG n d o AG ʔ
ponten	p ɔ AI n t ɛ AM n
pop	p ɔ AI p̚
popi	p o AG p i AF
populer	p o AG p u AH l ɛ AM r
porno	p ɔ AI r n o AG
pornografi	p ɔ AI r n o AG ɡ r a AD f i AF
porok	p o AG r ɔ AI k̚
porselen	p ɔ AI r s ə AM l ɛ AM n
porsi	p ɔ AI r s i AF
porta	p ɔ AI r t̪ a AD
portal	p ɔ AI r t a AD l
portir	p ɔ AI r t ɪ AL r
portugal	p ɔ AI r t u AH ɡ a AD l
portugis	p ɔ AI r t u AH ɡ ɪ AL s
pos	p ɔ AI s
posisi	p o AG s i AF s i AF
positif	p o AG s i AF t ɪ AL f
potehi	p o AG t ɛ AM h AA i AF
potensi	p o AG t ɛ AM n s i AF
potia	p o AG t i AF a̯
potlot	p o AG t̚ l o AG t̚
pradana	p r a AD d a AD n a AD
prah	p r a AD h AA
prahoto	p r a AD h AA o AG t o AG
praja	p r a AD d ʒ a AD
prakarsa	p r a AD k a AD r s a AD
prakerja	p r a AD k ə AM r d ʒ a AD
praktikan	p r a AD k t̪ i AF k a AD n
praktikum	p r a AD k t̪ i AF k ʊ AJ m
praktis	p r a AD k t ɪ AL s
pralaya	p r a AD l a AD j AB a AD
pramudi	p r a AD m u AH d̪ i AF
pramugari	p r a AD m u AH ɡ a AD r i AF
pramurukti	p r a AD m u AH r ʊ AJ k t̪ i AF
prancis	p r a AD n t ʃ ɪ AL s
prasasti	p r a AD s a AD s t i AF
prasmanan	p r a AD s m a AD n a AD n
pratama	p r a AD t a AD m a AD
predikat	p r e AE d i AF k a AD t
preman	p r ɛ AM m a AD n
premi	p r e AE m i AF
presbiterium	p r e AE s b i AF t e AE r i AF ʊ AJ m
presidensial	p r ɛ AM s i AF d ɛ AM n s i AF a AD l
presidentil	p r ɛ AM s i AF d ɛ AM n t ɪ AL l
presisi	p r e AE s i AF s i AF
prestasi	p r ɛ AM s t̪ a AD s i AF
prestise	p r ɛ AM s t̪ i AF s ə AM
prestisius	p r ɛ AM s t̪ i AF s i AF ʊ AJ s
prevalensi	p r e AE v a AD l ɛ AM n s i AF
priayi	p r i AF a AD j AB i AF
pribumi	p r i AF b u AH m i AF
primadona	p r i AF m a AD d̪ o AG n a AD
primas	p r i AF m a AD s
pris	p r ɪ AL s
privilese	p r i AF v i AF l ɛ AM s ə AM
pro	p r o AG
problem	p r o AG b l e AE m
prodeo	p r o AG d e AE o̯ BC
profesi	p r o AG f ɛ AM s i AF
profil	p r o AG f ɪ AL l
program	p r ɔ AI ɡ r a AD m
programa	p r ɔ AI ɡ r a AD m a AD
proletar	p r o AG l ə AM t a AD r
prop	p r ɔ AI p
propaganda	p r o AG p a AD ɡ a AD n d a AD
protokol	p r o AG t o AG k ɔ AI l
protokoler	p r o AG t o AG k o AG l ɛ AM r
provinsi	p r o AG v ɪ AL n s i AF
provokasi	p r o AG v o AG k a AD s i AF
puak	p u AH a AD k̚
pujangga	p u AH d ʒ a AD ŋ ɡ a AD
pul	p ʊ AJ l
pulpen	p ʊ AJ l p ɛ AM n
pulsa	p ʊ AJ l s a AD
puluh	p u AH l ʊ AJ h AA
punah	p u AH n a AD h AA
pupa	p u AH p a AD
purba	p ʊ AJ r b a AD
purnasarjana	p u AH r n a AD s a AD r d ʒ a AD n a AD
purwa	p ʊ AJ r w AC a AD
pusaka	p u AH s a AD k a AD
pusat	p u AH s a AD t̪̚
pusing	p u AH s ɪ AL ŋ
putri	p u AH t r i AF
putusan	p u AH t̪ ʊ AJ s a AD n
rabat	r a AD b a AD t̚
rabi	r a AD b i AF
racun	r a AD t ʃ ʊ AJ n
rad	r a AD t
radiasi	r a AD d i AF a AD s i AF
raharja	r a AD h AA a AD r d ʒ a AD
rahim	r a AD h AA ɪ AL m
rajawali	r a AD d ʒ a AD w AC a AD l i AF
raksa	r a AD k s a AD
rakyat	r a AD ʔ j AB a AD t
rama	r a AD m a AD
randa	r a AD n d̪ a AD
rangkaian	r a AD ŋ k a AD i̯ AB a AD n
rantai	r a AD n t a AD i̯ AB
rapel	r a AD p ɛ AM l
rapor	r a AD p ɔ AI r
rasi	r a AD s i AF
rasul	r a AD s ʊ AJ l
rat	r a AD t̪̚
ratna	r a AD t n a AD
raun	r a AD ʊ AJ n
rayon	r a AD j AB ɔ AI n
razia	r a AD z i AF a̯
reaksi	r e AE a AD k s i AF
real	r ɛ AM a AD l
realis	r ɛ AM a AD l ɪ AL s
realisasi	r ɛ AM a AD l i AF s a AD s i AF
realisme	r ɛ AM a AD l ɪ AL s m ə AM
realistik	r ɛ AM a AD l ɪ AL s t̪ ɪ AL k̚
realistis	r ɛ AM a AD l ɪ AL s t̪ ɪ AL s
realitas	r ɛ AM a̝ l i̽ BE t ɐ BA s
rebewes	r e AE b ə AM w AC e AE s
redaksi	r ə AM d̪ a AD k s i AF
redaktur	r ə AM d̪ a AD k t̪ ʊ AJ r
refleks	r ɛ AM f l ɛ AM k s
regi	r e AE ɡ i AF
register	r e AE ɡ ɪ AL s t̪ ə AM r
registrasi	r e AE ɡ ɪ AL s t̪ r a AD s i AF
regisur	r e AE ɡ i AF s ʊ AJ r
reglemen	r e AE ɡ l ə AM m e AE n
regulasi	r e AE ɡ u AH l a AD s i AF
reka	r ɛ AM k a AD
rekan	r ə AM k a AD n
reken	r ɛ AM k ə AM n
reklame	r ɛ AM k l a AD m ə AM
reklasering	r e AE k l a AD s ɛ AM r ɪ AL ŋ
rekoleksi	r e AE k o AG l ɛ AM k s i AF
rekreasi	r e AE k r ɛ AM a AD s i AF
rekreatif	r e AE k r ɛ AM a AD t ɪ AL f
rekrut	r e AE k r ʊ AJ t
rekuiem	r e AE k u AH i̯ AB e AE m
rel	r ɛ AM l
relaks	r ɛ AM l a AD k s
relasi	r e AE l a AD s i AF
relatif	r e AE l a AD t ɪ AL f
religi	r e AE l i AF ɡ i AF
remedi	r ɛ AM m ə AM d̪ i AF
remedial	r ɛ AM m ə AM d̪ i AF a AD l
remisi	r ɛ AM m i AF s i AF
rencana	r ə AM n t ʃ a AD n a AD
renda	r ɛ AM n d̪ a AD
rentenir	r ɛ AM n t ə AM n ɪ AL r
repertoar	r e AE p ə AM r t̪ o AG a AD r
repetisi	r e AE p ə AM t i AF s i AF
replik	r ɛ AM p l ɪ AL k
replika	r ɛ AM p l i AF k a AD
reportase	r e AE p ɔ AI r t a AD s ə AM
representasi	r e AE p r ə AM s ɛ AM n t̪ a AD s i AF
reptil	r ɛ AM p̚ t̪ ɪ AL l
republik	r e AE p u AH b l ɪ AL k
republikan	r e AE p ʊ AJ p l ɪ AL k a AD n
republiken	r e AE p ʊ AJ p l ɪ AL k e AE n
resensi	r ɛ AM s ɛ AM n s i AF
resepsi	r ə AM s ɛ AM p s i AF
reserse	r ə AM s ɛ AM r s ə AM
reserve	r ə AM s e AE r v ə AM
residen	r e AE s i AF d̪ ɛ AM n
residivis	r ɛ AM s i AF d i AF v ɪ AL s
resiko	r e AE s i AF k o AG
resimen	r e AE s i AF m ɛ AM n
resor	r e AE s ɔ AI r
respek	r ɛ AM s p ɛ AM k
respons	r ɛ AM s p ɔ AI n s
restan	r ɛ AM s t a AD n
restoran	r e AE s t o AG r a AD n
restorasi	r ɛ AM s t o AG r a AD s i AF
restriksi	r ɛ AM s t r ɪ AL k s i AF
resume	r e AE s u AH m e AE
retail	r e AE t a AD ɪ AL l
retret	r ɛ AM t̚ r ɛ AM t̚
retur	r e AE t ʊ AJ r
revisi	r e AE v i AF s i AF
reviu	r ɛ AM v i AF u̯ AC
rezim	r ɛ AM z ɪ AL m
riben	r i AF b ɛ AM n
riil	r i AF ɪ AL l
rileks	r i AF l ɛ AM k s
rim	r ɪ AL m
ring	r ɪ AL ŋ
riset	r i AF s ə AM t̚
ritel	r i AF t ɛ AM l
ritus	r i AF t ʊ AJ s
roda	r o AG d̪ a AD
rodi	r o AG d̪ i AF
roh	r ɔ AI h AA
rok	r ɔ AI k
rokok	r o AG k o AG ʔ
rol	r ɔ AI l
rolade	r o AG l a AD d̪ ə AM
ronda	r ɔ AI n d a AD
ronde	r ɔ AI n d̪ ə AM
rosario	r o AG s a AD r i AF o̯ BC
roti	r o AG t̪ i AF
royal	r o AG j AB a AD l
rua	r u AH a̯
rubah	r u AH b a AD h AA
rubrik	r u AH b r ɪ AL k
rugi	r u AH ɡ i AF
ruh	r ʊ AJ h AA
rumboter	r ʊ AJ m b o AG t ə AM r
rupa	r u AH p a AD
ruptur	r ʊ AJ p t ʊ AJ r
saba	s a AD b a AD
sablon	s a AD b l ɔ AI n
sadel	s a AD d ə AM l
sado	s a AD d̪ o AG
safir	s a AD f ɪ AL r
sahabat	s a AD h AA a AD b a AD t̪̚
sahaja	s a AD h AA a AD d ʒ a AD
saham	s a AD h AA a AD m
sains	s a AD ɪ AL n s
saintifik	s a AD ɪ AL n t i AF f ɪ AL k
sajadah	s a AD d ʒ a AD d̪ a AD h AA
sak	s a AD k
saka	s a AD k a AD
sakar	s a AD k a AD r
sakelek	s a AD k ə AM l ə AM ʔ
saki	s a AD k i AF
saklek	s a AD k l ə AM k
sakramen	s a AD k r a AD m ɛ AM n
sakramentalia	s a AD k r a AD m ɛ AM n t a AD l i AF a̯
sakrilegi	s a AD k r i AF l e AE ɡ i AF
sakristi	s a AD k r ɪ AL s t i AF
saksama	s a AD k s a AD m a AD
saku	s a AD k u AH
salat	s a AD l a AD t
saldo	s a AD l d o AG
salep	s a AD l ə AM p̚
salib	s a AD l ɪ AL p
salip	s a AD l ɪ AL p
salon	s a AD l ɔ AI n
salto	s a AD l t o AG
salut	s a AD l ʊ AJ t
samapta	s a AD m a AD p t a AD
samseng	s a AD m s ɛ AM ŋ
samsu	s a AD m s u AH
sandi	s a AD n d̪ i AF
sandiwara	s a AD n d̪ i AF w AC a AD r a AD
sanggama	s a AD ŋ ɡ a AD m a AD
sangkakala	s a AD ŋ k a AD k a AD l a AD
sanitasi	s a AD n i AF t̪ a AD s i AF
santa	s a AD n t a AD
santan	s a AD n t a AD n
santo	s a AD n t o AG
sapir	s a AD p ɪ AL r
sapo	s a AD p o AG
sara	s a AD r a AD
saraf	s a AD r a AD f
sarekat	s a AD r ɛ AM k a AD t̪̚
sari	s a AD r i AF
sarjana	s a AD r d ʒ a AD n a AD
sasis	s a AD s ɪ AL s
saudagar	s a AD u̯ AC d a AD ɡ a AD r
saus	s a AD ʊ AJ s
sayembara	s a AD j AB ə AM m b a AD r a AD
sedekah	s ə AM d̪ ə AM k a AD h AA
segera	s ə AM ɡ ə AM r a AD
seiyu	s e AE i AF j AB u AH
sejarah	s ə AM d ʒ a AD r a AD h AA
sekaut	s ə AM k a AD ʊ AJ t
sekeram	s ə AM k ɛ AM r a AD m
sekilwak	s ə AM k ɪ AL l w AC a AD k
sekip	s ə AM k ɪ AL p
sekolah	s ə AM k o AG l a AD h AA
sekon	s ə AM k ɔ AI n
sekop	s ə AM k ɔ AI p
sekretariat	s ɛ AM k r ə AM t̪ a AD r i AF a AD t̪̚
sekretaris	s ɛ AM k r ə AM t a AD r ɪ AL s
sekte	s e AE k t ə AM
sektor	s ɛ AM k t ɔ AI r
sekuler	s ɛ AM k u AH l ɛ AM r
sekulir	s ə AM k u AH l ɪ AL r
sekuritas	s ə AM k u AH r i AF t a AD s
sekutu	s ə AM k u AH t u AH
sel	s ɛ AM l
selai	s ə AM l a AD i̯ AB
selamat	s ə AM l a AD m a AD t̪̚
selamatan	s ə AM l a AD m a AD t̪ a AD n
selatan	s ə AM l a AD t̪ a AD n
seleksi	s ə AM l ɛ AM k s i AF
selot	s l ɔ AI t
selotip	s e AE l o AG t ɪ AL p
seluler	s ɛ AM l u AH l ɛ AM r
semadi	s ə AM m a AD d̪ i AF
semalam	s ə AM m a AD l a AD m
semara	s ə AM m a AD r a AD
sembahyang	s ə AM m b a AD h AA j AB a AD ŋ
semesta	s ə AM m ə AM s t a AD
sempadan	s ə AM m p a AD d̪ a AD n
sempak	s ɛ AM m p a AD k
sen	s ɛ AM n
sena	s e AE n a AD
senapan	s ə AM n a AD p a AD n
senapati	s e AE n a AD p a AD t i AF
senar	s ə AM n a AD r
senaya	s e AE n a AD j AB a AD
sendi	s ə AM n d̪ i AF
seng	s e AE ŋ
sengkel	s ɛ AM ŋ k ɛ AM l
sengketa	s ə AM ŋ k ɛ AM t a AD
seni	s ə AM n i AF
senja	s ə AM n d ʒ a AD
senpi	s ə AM n p i AF
sensor	s ɛ AM n s ɔ AI r
sensus	s ɛ AM n s ʊ AJ s
sentiong	s ə AM n t i AF ɔ AI ŋ
sentra	s ɛ AM n t̪ r a AD
senyawa	s ə AM ɲ a AD w AC a AD
sep	s ɛ AM p
seperitus	s ə AM p ə AM r ɪ AL t̪ ʊ AJ s
sepiritus	s ə AM p i AF r ɪ AL t̪ ʊ AJ s
sepuit	s ə AM p u AH i AF t
sepul	s ə AM p ʊ AJ l
sepuluh	s ə AM p u AH l ʊ AJ h AA
seput	s ə AM p ʊ AJ t
serangga	s ə AM r a AD ŋ ɡ a AD
serapah	s ə AM r a AD p a AD h AA
serasi	s ə AM r a AD s i AF
seraya	s ə AM r a AD j AB a AD
serba	s ə AM r b a AD
serbet	s ə AM r b ɛ AM t
serikat	s ə AM r i AF k a AD t̚
sero	s e AE r o AG
sersan	s ɛ AM r s a AD n
sertifikasi	s ɛ AM r t i AF f i AF k a AD s i AF
servis	s ɛ AM r v ɪ AL s
sesi	s ɛ AM s i AF
set	s ɛ AM t
setal	s ə AM t a AD l
setat	s ə AM t a AD t
setek	s ə AM t ɛ AM k
setel	s ə AM t ɛ AM l
setem	s ə AM t ɛ AM m
seter	s ə AM t ɛ AM r
seteru	s ə AM t ə AM r u AH
setia	s ə AM t i AF a̯
setip	s ə AM t ɪ AL p
setir	s ə AM t ɪ AL r
setom	s ə AM t ɔ AI m
setop	s ə AM t ɔ AI p̚
setor	s ə AM t̪ ɔ AI r
setrat	s ə AM t r a AD t
setrip	s ə AM t r ɪ AL p
setum	s ə AM t ʊ AJ m
setup	s ə AM t ʊ AJ p
sewa	s ɛ AM w AC a AD
sidang	s i AF d̪ a AD ŋ
sidi	s i AF d i AF
sif	s ɪ AL f
sifat	s i AF p a AD t
siklus	s ɪ AL k l ʊ AJ s
siksa	s ɪ AL k s a AD
sila	s i AF l a AD
simpel	s ɪ AL m p ə AM l
sinci	s ɪ AL n c i AF
sincia	s ɪ AL n t ʃ i AF a̯
sindikat	s ɪ AL n d̪ i AF k a AD t̪
sinema	s ɪ AL n e AE m a AD
sinetron	s ɪ AL n ɛ AM t̚ r ɔ AI n
singa	s i AF ŋ a AD
singkek	s ɪ AL ŋ k ɛ AM k
siniar	s i AF n i AF a AD r
sinode	s i AF n o AG d ə AM
sintetik	s ɪ AL n t ɛ AM t ɪ AL k
sintetis	s ɪ AL n t ɛ AM t ɪ AL s
sinus	s i AF n ʊ AJ s
sinyal	s i AF ɲ a AD l
sinyo	s i AF ɲ o AG
sioca	s i AF o̯ BC t ʃ a AD
siomai	s i AF o AG m a AD i̯ AB
sip	s ɪ AL p
sipahi	s i AF p a AD h AA i AF
sipir	s i AF p ɪ AL r
sirene	s i AF r e AE n ə AM
sirkit	s ɪ AL r k ɪ AL t̪̚
sirkol	s ɪ AL r k o AG l
sirkuit	s ɪ AL r k u AH ɪ AL t̪̚
sirkulasi	s ɪ AL r k u AH l a AD s i AF
sirkumsisi	s i AF r k ʊ AJ m s i AF s i AF
sirna	s ɪ AL r n a AD
sistem	s ɪ AL s t ə AM m
sistematik	s ɪ AL s t̪ e AE m a AD t ɪ AL k
sistematika	s ɪ AL s t̪ e AE m a AD t i AF k a AD
sistematis	s ɪ AL s t̪ e AE m a AD t ɪ AL s
sistim	s ɪ AL s t̪ i AF m
sitat	s i AF t a AD t
siwa	s i AF w AC a AD
skedul	s k ɛ AM d ʊ AJ l
skenario	s k e AE n a AD r i AF o̯ BC
sketsa	s k ɛ AM t̚ s a AD
skop	s k ɔ AI p
skrip	s k r ɪ AL p̚
skuad	s k u AH a AD t
slip	s l i AF p
smokel	s m o AG k ə AM l
soak	s o AG a AD ʔ
sobat	s o AG b a AD t̪̚
soe	s o AG e AE
sohun	s o AG h AA ʊ AJ n
soja	s o AG d ʒ a AD
soket	s o AG k ɛ AM t̪̚
sol	s ɔ AI l
solar	s o AG l a AD r
solder	s ɔ AI l d ɛ AM r
sombong	s ɔ AI m b ɔ AI ŋ
sorgum	s ɔ AI r ɡ ʊ AJ m
soroban	s o AG r o AG b a AD n
sosi	s o AG s i AF
sosial	s o AG s i AF a AD l
sosin	s o AG s ɪ AL n
sosis	s o AG s ɪ AL s
sositet	s o AG s i AF t ɛ AM t
soya	s o AG j AB a AD
spanyol	s p a AD ɲ ɔ AI l
sparing	s p a AD r ɪ AL ŋ
spasi	s p a AD s i AF
spekulan	s p ɛ AM k u AH l a AD n
spekulasi	s p ɛ AM k u AH l a AD s i AF
spekulatif	s p ɛ AM k u AH l a AD t ɪ AL f
spekulator	s p ɛ AM k u AH l a AD t ɔ AI r
spesialis	s p ɛ AM s i AF a AD l ɪ AL s
spirit	s p i AF r ɪ AL t̪̚
spiritus	s p i AF r ɪ AL t̪ ʊ AJ s
spoed	s p ʊ AJ t
spora	s p o AG r a AD
spot	s p ɔ AI t
sputum	s p u AH t ʊ AJ m
staf	s ə̆ AK t a AD p̚
stambom	s t a AD m b ɔ AI m
stambuk	s t a AD m b ʊ AJ k
standar	s t a AD n d̪ a AD r
stele	s t e AE l e AE
stempel	s t̪ ɛ AM m p ə AM l
steril	s t̪ ɛ AM r ɪ AL l
stipendium	s t i AF p ɛ AM n d i AF ʊ AJ m
stok	s t̪ ɔ AI k̚
stopkontak	s t ɔ AI p̚ k o AG n t a AD k̚
strata	s t r a AD t a AD
strategi	s t r a AD t ɛ AM ɡ i AF
strategis	s t r a AD t ɛ AM ɡ ɪ AL s
stratifikasi	s t̪ r a AD t̪ i AF f i AF k a AD s i AF
stratum	s t r a AD t ʊ AJ m
stres	s t r ɛ AM s
studen	s t u AH d ə AM n
suar	s u AH a̯ r
subsider	s ʊ AJ b s i AF d ɛ AM r
subsidi	s ʊ AJ p̚ s i AF d i AF
subversif	s ʊ AJ p v ɛ AM r s ɪ AL f
sugesti	s u AH ɡ ɛ AM s t i AF
suhu	s u AH h AA u AH
sukacita	s u AH k a AD t ʃ i AF t a AD
sukses	s ʊ AJ k s ɛ AM s
sun	s ʊ AJ n
sunah	s u AH n a AD h AA
sunat	s u AH n a AD t̪̚
sup	s ʊ AJ p̚
suralaya	s u AH r a AD l a AD j AB a AD
susila	s u AH s i AF l a AD
suspensi	s ʊ AJ s p ɛ AM n s i AF
sutradara	s ʊ AJ t r a AD d a AD r a AD
swapraja	s w AC a AD p r a AD d ʒ a AD
swike	s w AC i AF k e AE
swipoa	s w AC i AF p o AG a̯
syahid	ʃ a AD h AA ɪ AL t
syahwat	ʃ a AD h AA w AC a AD t
syarikat	ʃ a AD r i AF k a AD t̪̚
syiwa	ʃ i AF w AC a AD
syok	ʃ ɔ AI k
tabernakel	t a AD b ə AM r n a AD k ə AM l
tabir	t̪ a AD b ɪ AL r
taifun	t a AD i̯ AB f u AH n
tajir	t a AD d ʒ ɪ AL r
tajuk	t a AD d ʒ ʊ AJ k̚
takdir	t a AD k̚ d ɪ AL r
taktik	t a AD k t ɪ AL k
tala	t̪ a AD l a AD
talam	t̪ a AD l a AD m
tamagoyaki	t̪ a AD m a AD ɡ o AG j AB a AD k i AF
tamak	t a AD m a AD ʔ
taman	t a AD m a AD n
tamasya	t a AD m a AD ʃ a AD
tamu	t̪ a AD m u AH
tandu	t̪ a AD n d̪ u AH
tang	t a AD ŋ
tanggal	t a AD ŋ ɡ a AD l
tanglung	t a AD ŋ l ʊ AJ ŋ
tani	t̪ a AD n i AF
tankobon	t̪ a AD n k o AG b ɔ AI n
tantri	t a AD n t r i AF
taoci	t a AD o AG t ʃ i AF
taoco	t a AD o AG t ʃ o AG
taoge	t a AD o AG ɡ e AE
tapai	t̪ a AD p a AD i̯ AB
tapioka	t a AD p i AF o AG k a AD
tara	t a AD r a AD
tarik	t a AD r i AF ʔ
tarikh	t a AD r ɪ AL x
tasrih	t a AD s r ɪ AL h AA
tata	t̪ a AD t̪ a AD
tawas	t̪ a AD w AC a AD s
teater	t̪ ɛ AM a AD t̪ ə AM r
tebal	t ə AM b a AD l
tebu	t ə AM b u AH
tega	t ɛ AM ɡ a AD
tegal	t ə AM ɡ a AD l
tegel	t ɛ AM ɡ ə AM l
teguh	t̪ ə AM ɡ ʊ AJ h AA
teja	t ɛ AM d ʒ a AD
teken	t ɛ AM k ə AM n
teknik	t ɛ AM k n ɪ AL k
teknisi	t ɛ AM k n i AF s i AF
teknologi	t ɛ AM k n o AG l o AG ɡ i AF
teko	t e AE k o AG
tekoan	t e AE k o AG a AD n
teks	t ɛ AM k s
telat	t ə AM l a AD t
teman	t̪ ə AM m a AD n
tembaga	t ə AM m b a AD ɡ a AD
tempa	t ə AM m p a AD
tempayan	t̪ ə AM m p a AD j AB a AD n
temperatur	t ɛ AM m p ə AM r a AD t ʊ AJ r
templat	t̪ ɛ AM m p l a AD t̪̚
tenaga	t̪ ə AM n a AD ɡ a AD
tenar	t ə AM n a AD r
tenda	t̪ ɛ AM n d̪ a AD
tendensi	t ɛ AM n d ɛ AM n s i AF
tender	t ɛ AM n d ə AM r
tenor	t ɛ AM n ɔ AI r
tentamen	t ɛ AM n t a AD m ɛ AM n
tenteram	t̪ ə AM n t̪ ə AM r a AD m
teoretis	t̪ e AE o AG r e AE t̪ ɪ AL s
tera	t̪ ə AM r a AD
terapi	t ə AM r a AD p i AF
teras	t̪ ɛ AM r a AD s
terigu	t ə AM r i AF ɡ u AH
terka	t ə AM r k a AD
termae	t ɛ AM r m a AD e AE
termos	t ɛ AM r m ɔ AI s
teror	t̪ ɛ AM r ɔ AI r
teroris	t ɛ AM r o AG r ɪ AL s
tes	t̪ ɛ AM s
testamen	t ɛ AM s t a AD m ɛ AM n
tetapi	t ə AM t a AD p i AF
tetikus	t ə AM t i AF k ʊ AJ s
tetua	t ə AM t u AH a̯
tewas	t ɛ AM w AC a AD s
thailand	t a AD i̯ AB l a AD n
tiket	t i AF k ɛ AM t
tim	t ɪ AL m
tin	t ɪ AL n
ting	t ɪ AL ŋ
tingkat	t ɪ AL ŋ k a AD t
tingtur	t ɪ AL ŋ t ʊ AJ r
tiongkok	t i AF ɔ AI ŋ k ɔ AI k
tipe	t i AF p ə AM
tirai	t̪ i AF r a AD i̯ AB
tiras	t̪ i AF r a AD s
tisu	t i AF s u AH
titel	t̪ i AF t̪ ə AM l
tituler	t i AF t u AH l ɛ AM r
togel	t o AG ɡ ɛ AM l
tolan	t o AG l a AD n
tolong	t̪ o AG l ɔ AI ŋ
tombol	t ɔ AI m b ɔ AI l
toner	t̪ o AG n ə AM r
tongcai	t ɔ AI ŋ t ʃ a AD i̯ AB
tongsan	t ɔ AI ŋ s a AD n
tonil	t̪ o AG n ɪ AL l
topan	t o AG p a AD n
topeng	t o AG p ɛ AM ŋ
trailer	t r a AD i̯ AB l ɛ AM r
traktir	t r a AD k̚ t ɪ AL r
transien	t̪ r a AD n s i AF ɛ AM n
transit	t r a AD n s ɪ AL t
transpor	t̪ r a AD n s p ɔ AI r
transportasi	t̪ r a AD n s p ɔ AI r t̪ a AD s i AF
tras	t̪ ə̆ AK r a AD s
trayek	t r a AD j AB ɛ AM k
tribune	t r i AF b ʊ AJ n
troika	t̪ r o AG i̯ AB k a AD
troli	t̪ r o AG l i AF
trotoar	t̪ r o AG t̪ o AG a AD r
truk	t̪ r ʊ AJ k̚
tuala	t̪ u AH a AD l a AD
tuan	t u AH a AD n
tuduh	t u AH d ʊ AJ h AA
tulung	t̪ u AH l ʊ AJ ŋ
tuna	t u AH n a AD
tunadaksa	t u AH n a AD d a AD k s a AD
tunai	t u AH n a AD i̯ AB
tuts	t ʊ AJ t s
udara	ʊ AJ d̪ a AD r a AD
udik	u AH d ɪ AL k
uji	ʊ AJ d ʒ i AF
ujian	ʊ AJ d ʒ i AF a AD n
umpama	ʊ AJ m p a AD m a AD
undang	ʊ AJ n d̪ a AD ŋ
undi	ʊ AJ n d i AF
uni	ʊ AJ n i AF
unikorn	ʊ AJ n i AF k ɔ AI r ə̆ AK n
universitas	u AH n i AF v ə AM r s i AF t a AD s
universitet	u AH n i AF v ə AM r s i AF t ɛ AM t
untai	ʊ AJ n t̪ a AD i̯ AB
untuk	u AH n t u AH ʔ
upeti	u AH p ə AM t i AF
usia	ʊ AJ s i AF a̯
utang	u AH t̪ a AD ŋ
uterus	ʊ AJ t ɛ AM r ʊ AJ s
vak	v a AD ʔ
vakansi	v a AD k a AD n s i AF
vakbon	v a AD ʔ b ɔ AI n
vakum	v a AD k ʊ AJ m
valid	v a AD l ɪ AL t̪
vas	v a AD s
vena	v ɛ AM n a AD
verba	v ɛ AM r b a AD
verbal	v ə AM r b a AD l
vigili	v i AF ɡ i AF l i AF
vikariat	v i AF k a AD r i AF a AD t
vikaris	v i AF k a AD r ɪ AL s
virus	v i AF r ʊ AJ s
visitator	v i AF s i AF t a AD t ɔ AI r
visiun	v i AF s i AF ʊ AJ n
visual	v i AF s u AH a AD l
vokasi	v o AG k a AD s i AF
vonis	v o AG n ɪ AL s
wabah	w AC a AD b a AD h AA
wagon	w AC a AD ɡ ɔ AI n
waham	w AC a AD h AA a AD m
wajan	w AC a AD d ʒ a AD n
wara	w AC a AD r a AD
warga	w AC a AD r ɡ a AD
warta	w AC a AD r t̪ a AD
waslap	w AC a AD s l a AD p
wastra	w AC a AD s t r a AD
waterpas	w AC a AD t ə AM r p a AD s
wawasan	w AC a AD w AC a AD s a AD n
webtun	w AC ɛ AM p t ʊ AJ n
wedana	w AC ə AM d a AD n a AD
wesel	w AC ɛ AM s ə AM l
wet	w AC ɛ AM t
wibawa	w AC i AF b a AD w AC a AD
wijaya	w AC i AF d ʒ a AD j AB a AD
wimana	w AC i AF m a AD n a AD
wisata	w AC i AF s a AD t a AD
wisma	w AC ɪ AL s m a AD
wisuda	w AC i AF s u AH d a AD
wiwaha	w AC i AF w AC a AD h AA a AD
wiweka	w AC i AF w AC e AE k a AD
wiyata	w AC i AF j AB a AD t a AD
wolanda	w AC o AG l a AD n d a AD
wonton	w AC ɔ AI n t̪ ɔ AI n
yaksa	j AB a AD k s a AD
yayasan	j AB a AD j AB a AD s a AD n
yogia	j AB o AG ɡ i AF a̯
yunani	j AB u AH n a AD n i AF
yunior	j AB u AH n i AF ɔ AI r
yupa	j AB u AH p a AD
yurisdiksi	j AB u AH r ɪ AL s d̪ ɪ AL k s i AF
yuvenil	y AH u AH v ə AM n ɪ AL l
yuwana	j AB u AH w AC a AD n a AD
zendeling	z ɛ AM n d ə AM l ɪ AL ŋ
zending	z ɛ AM n d ɪ AL ŋ
zeni	z ə AM n i AF
zirah	z i AF r a AD h AA
ā	ə AM
ē	ə AM
