abad	a AK b AG a AK t̚
abdi	a AK b AG d AC i AK
abdis	a AK b AG d AC ɪ AK s AH
abi	a AK b AG i AK
abiseka	a AK b AG i AK s AH e AK k AC a AK
abonemen	a AK b AG o AM n AF ə AK m AE ɛ AK n AF
abras	a AK b AG r AN a AK s AH
absolusi	a AK b AG s AH o AM l AD u AM s AH i AK
abstain	a AK p̚ s AH t AC a AK i AK n AF
abu	a AK b AG u AM
aceh	a AK t AC ʃ AH e AK h AA
aci	a AK t AC ʃ AH i AK
acik	a AK t AC ʃ AH ɪ AK ʔ AJ
ada	a AK d AC a AK
adalah	a AK d AC a AK l AD a AK h AA
adaptif	a AK d AC a AK p AG t AC ɪ AK f BA
adat	a AK d AC a AK t AC
adempauze	a AK d AC ə AK m AE p AG a AK u̯ AI z AH ə AK
adikara	a AK d AC i AK k AC a AK r AN a AK
adil	a AK d AC i AK l AD
administrator	a AK t̚ m AE i AK n AF ɪ AK s AH t AC r AN a AK t AC ɔ AM r AN
administratur	a AK t̚ m AE i AK n AF ɪ AK s AH t AC r AN a AK t AC ʊ AM r AN
adoptif	a AK d AC ɔ AM p AG t AC ɪ AK f BA
adpis	a AK t̚ p AG ɪ AK s AH
advis	a AK t̚ v BA i AK s AH
afdeling	a AK f BA d AC e AK l AD i AK ŋ AF
agape	a AK ɡ AC a AK p AG e AK
agen	a AK ɡ AC ɛ AK n AF
agresi	a AK ɡ AC r AN ɛ AK s AH i AK
agustus	a AK ɡ AC ʊ AM s AH t AC ʊ AM s AH
ahli	a AK h AA l AD i AK
aib	aʲ AK i AK b AG
aikido	aʲ AK i AK k AC i AK d AC o AM
air	a AK ʔ AJ ɪ AK r AN
ajar	a AK d AC ʒ AH a AK r AN
akademi	a AK k AC a AK d AC e AK m AE i AK
akademis	a AK k AC a AK d AC e AK m AE i AK s AH
akan	a AK k AC a AK n AF
akang	a AK k AC a AK ŋ AF
akar	a AK k AC a AK r AN
akeo	a AK k AC e AK o AM
akil	a AK k AC ɪ AK l AD
aksa	a AK k̚ s AH a AK
aksara	a AK k AC s AH a AK r AN a AK
akselerasi	a AK k AC s AH e AK l AD ə AK r AN a AK s AH i AK
akta	a AK k̚ t AC a AK
akte	a AK k̚ t AC ə AK
aktif	a AK k̚ t AC ɪ AK p AG
aktifitas	a AK k̚ t AC i AK f BA i AK t AC a AK s AH
aktivasi	a AK k̚ t AC i AK v BA a AK s AH i AK
aktivis	a AK k̚ t AC i AK v BA ɪ AK s AH
aktivisme	a AK k̚ t AC i AK v BA ɪ AK s AH m AE ə AK
aktivitas	a AK k̚ t AC i AK v BA i AK t AC a AK s AH
aku	a AK k AC u AM
akur	a AK k AC u AM r AN
akut	a AK k AC u AM t AC
alas	a AK l AD a AK s AH
alat	a AK b AG o AM n AF ə AK m AE ɛ AK n AF
algojo	a AK l AD ɡ AC o AM d AC ʒ AH o AM
aliah	a AK l AD i AK a AK h AA
aliansi	a AK l AD i AK a AK n AF s AH i AK
aliase	a AK l AD i AK a AK s AH ə AK
alkali	a AK l AD k AC a AK l AD i AK
allah	a AK l AD l AD a AK h AA
aloi	a AK l AD o AM i̯ AB
alpa	a AK l AD p AG a AK
alpukat	a AK l AD p AG u AM k AC a AK t AC
altar	a AK l AD t AC a AK r AN
am	a AK m AE
amah	a AK m AE a AK h AA
aman	a AK m AE a AK n AF
amar	a AK m AE a AK r AN
ambasade	a AK m AE b AG a AK s AH a AK d AC ə AK
amerta	a AK m AE ə AK r AN t AC a AK
amin	a AK m AE ɪ AK n AF
ampul	a AK m AE p AG ʊ AM l AD
amra	a AK m AE r AN a AK
anak	a AK n AF a AK ʔ AJ
analisis	a AK n AF a AK l AD i AK s AH ɪ AK s AH
ancala	a AK n AF t AC ʃ AH a AK l AD a AK
ancaman	a AK n AF t AC ʃ AH a AK m AE a AK n AF
anda	a AK n AF d AC a AK
andaka	n AF a AK n AF d AC a AK k AC a AK
aneka	a AK n AF ɛ AK k AC a AK
anfal	a AK n AF f BA a AK l AD
angciu	a AK ŋ AF t AC ʃ AH i AK u AM
anggara	a AK ŋ AF ɡ AC a AK r AN a AK
anghun	a AK ŋ AF h AA u AM n AF
angka	a AK ŋ AF k AC a AK
angkak	a AK ŋ AF k AC a AK k AC
angkasa	a AK ŋ AF k AC a AK s AH a AK
angkasawan	a AK ŋ AF k AC a AK s AH a AK w AI a AK n AF
angkur	a AK ŋ AF k AC ʊ AM r AN
angkusa	a AK ŋ AF k AC u AM s AH a AK
anglo	a AK ŋ AF l AD o AM
anglung	a AK ŋ AF l AD u AM ŋ AF
angpao	a AK ŋ AF p AG a AK o AM
angpau	a AK ŋ AF p AG a AK u̯ AI
angsa	a AK ŋ AF s AH a AK
aniaya	a AK n AF i AK a AK j AB a AK
animasi	a AK n AF i AK m AE a AK s AH i AK
ansos	a AK n AF s AH o AM s AH
antarbangsa	a AK n AF t AC a AK r AN b AG a AK ŋ AF s AH a AK
antariksawan	a AK n AF t AC a AK r AN ɪ AK k AC s AH a AK w AI a AK n AF
antik	a AK n AF t AC i AK k AC
anumerta	a AK n AF u AM m AE ə AK r AN t AC a AK
apa	a AK p AG a AK
apak	a AK p AG a AK ʔ AJ
apakah	a AK p AG a AK k AC a AK h AA
apanase	a AK p AG a AK n AF a AK s AH ə AK
aparat	a AK p AG a AK r AN a AK t AC
apek	a AK p AG ɛ AK k AC
api	a AK p AG i AK
aplaus	a AK p AG l AD a AK u AM s AH
apologi	a AK p AG o AM l AD o AM ɡ AC i AK
apologia	a AK p AG o AM l AD o AM ɡ AC i AK a AK
apotek	a AK p AG o AM t AC e AK k AC
april	a AK p̚ r AN ɪ AK l AD
apsara	a AK p AG s AH a AK r AN a AK
arak	a AK r AN a AK k AC
arbei	a AK r AN b AG e AK i̯ AB
arit	a AK r AN i AK t AC
arkais	a AK r AN k AC a AK i AK s AH
arloji	a AK r AN l AD o AM d AC ʒ AH i AK
arsip	a AK r AN s AH i AK p AG
arta	a AK r AN t AC a AK
arti	a AK r AN t AC i AK
arya	a AK r AN j AB a AK
asbak	a AK s AH b AG a AK k AC
asesmen	a AK s AH ɛ AK s AH m AE ə AK n AF
askese	a AK s AH k AC e AK s AH ə AK
asma	a AK s AH m AE a AK
asmara	a AK s AH m AE a AK r AN a AK
aspal	a AK s AH p AG a AK l AD
asrama	a AK s AH r AN a AK m AE a AK
astana	a AK s AH t AC a AK n AF a AK
astronaut	a AK s AH t AC r AN o AM n AF ɔ AM t̚
asumsi	a AK s AH ʊ AM m AE s AH i AK
aswa	a AK s AH w AI a AK
asyik	a AK ʃ AH ɪ AK k AC
atau	a AK t AC a AK u̯ AI
atma	a AK t AC m AE a AK
auban	a AK u AM b AG a AK n AF
autokrasi	a AK u AM t AC o AM k AC r AN a AK s AH i AK
autokrat	a AK u AM t AC o AM k AC r AN a AK t̚
avatar	a AK v BA a AK t AC a AK r AN
avokad	a AK v BA o AM k AC a AK d AC
avtur	a AK v BA t AC ʊ AM r AN
awak	a AK w AI a AK ʔ AJ
awat	a AK w AI a AK t AC
ayah	a AK j AB a AK h AA
ayam	a AK j AB a AK m AE
ayo	a AK j AB o AM
babi	b AG a AK b AG i AK
baca	b AG a AK t AC ʃ AH a AK
bacang	b AG a AK t AC ʃ AH a AK ŋ AF
bagai	b AG a AK ɡ AC a AK i̯ AB
bagi	b AG a AK ɡ AC i AK
bagian	b AG a AK ɡ AC i AK a AK n AF
baginda	b AG a AK ɡ AC i AK n AF d AC a AK
bahana	b AG a AK h AA a AK n AF a AK
bahasa	b AG a AK h AA a AK s AH a AK
bahaya	b AG a AK h AA a AK j AB a AK
bahtera	b AG a AK h AA t AC ə AK r AN a AK
bahwa	b AG a AK h AA w AI a AK
baiduri	b AG a AK i̯ AB d AC u AM r AN i AK
baja	b AG a AK d AC ʒ AH a AK
bajingan	b AG a AK d AC ʒ AH i AK ŋ AF a AK n AF
bak	b AG ɑ AK k AC
bakcang	b AG a AK ʔ AJ t AC ʃ AH a AK ŋ AF
bakero	b AG a AK k AC e AK r AN o AM
baki	b AG a AK k AC i AK
bakiak	b AG a AK k AC i AK a AK k AC
bakmi	b AG a AK k AC m AE i AK
bakpao	b AG a AK ʔ AJ p AG a AK o AM
bakpau	b AG a AK k AC p AG a AK ʊ̯ AI
bakpia	b AG a AK ʔ AJ p AG i AK a̯
bakso	b AG a AK ʔ AJ s AH o AM
baktau	b AG a AK k AC t AC a AK ʊ̯ AI
bakti	b AG a AK k AC t AC i AK
bakwan	b AG a AK ʔ AJ w AI a AK n AF
bala	b AG a AK l AD a AK
balai	b AG a AK l AD a AK i̯ AB
bali	b AG a AK l AD i AK
balot	b AG a AK l AD ɔ AM t̚
banci	b AG a AK n AF t AC ʃ AH i AK
bandara	b AG a AK n AF d AC a AK r AN a AK
banding	b AG a AK n AF d AC i AK ŋ AF
bang	b AG a AK ŋ AF
bangku	b AG a AK ŋ AF k AC u AM
bangsa	b AG a AK ŋ AF s AH a AK
bangsat	b AG a AK ŋ AF s AH a AK t AC
bangsi	b AG a AK ŋ AF s AH i AK
banji	b AG a AK n AF d AC ʒ AH i AK
bank	b AG a AK ŋ AF
banyak	b AG a AK ɲ AF a AK k AC
banzai	b AG a AK n AF z AH a AK i̯ AB
bapa	b AG a AK p AG a AK
bapak	b AG a AK p AG a AK ʔ AJ
bapao	b AG a AK p AG a AK o AM
barang	b AG a AK r AN a AK ŋ AF
barikade	b AG a AK r AN i AK k AC a AK d AC ə AK
barongsai	b AG a AK r AN o AM ŋ AF s AH a AK i̯ AB
baronsai	b AG a AK r AN o AM n AF s AH a AK i̯ AB
baruna	b AG a AK r AN u AM n AF a AK
baskara	b AG a AK s AH k AC a AK r AN a AK
basket	b AG a AK s AH k AC ɛ AK t̚
basmi	b AG a AK s AH m AE i AK
batang	b AG a AK t AC a AK ŋ AF
batangan	b AG a AK t AC a AK ŋ AF a AK n AF
batara	b AG a AK t AC a AK r AN a AK
batau	b AG a AK t AC a AK ʊ̯ AI
batavia	b AG a AK t AC a AK v BA i AK a̯
batik	b AG a AK t AC ɪ AK k AC
bausastra	b AG a AK u AM s AH a AK s AH t AC r AN a AK
baya	b AG a AK j AB a AK
bayangkara	b AG a AK j AB a AK ŋ AF k AC a AK r AN a AK
bayu	b AG a AK j AB u AM
bazar	b AG a AK z AH a AK r AN
bea	b AG e AK a AK
beasiswa	b AG e AK a AK s AH ɪ AK s AH w AI a AK
begawan	b AG ə AK ɡ AC a AK w AI a AK n AF
beha	b AG e AK h AA a AK
bel	b AG ɛ AK l AD
bela	b AG ɛ AK l AD a AK
belajar	b AG ə AK l AD a AK d AC ʒ AH a AK r AN
belalai	b AG ə AK l AD a AK l AD a AK i̯ AB
belanda	b AG ə AK l AD a AK n AF d AC a AK
belanja	b AG ə AK l AD a AK n AF d AC ʒ AH a AK
belanjaan	b AG ə AK l AD a AK n AF d AC ʒ AH a AK ʔ AJ a AK n AF
belantara	b AG ə AK l AD a AK n AF t AC a AK r AN a AK
belasting	b AG ə AK l AD a AK s AH t AC i AK ŋ AF
beleid	b AG ə AK l AD ɛ AK ɪ AK t̚
belia	b AG ə AK l AD i AK a̯
beliau	b AG ə AK l AD i AK a AK u̯ AI
belom	b AG ə AK l AD ʌ AK m AE
belum	b AG ə AK l AD ʊ AM m AE
bencong	b AG ɛ AK n AF t AC ʃ AH o AM ŋ AF
benda	b AG ə AK n AF d AC a AK
bendahara	b AG ə AK n AF d AC a AK h AA a AK r AN a AK
bendel	b AG ə AK n AF d AC ə AK l AD
bendera	b AG ə AK n AF d AC ɛ AK r AN a AK
bengawan	b AG ə AK ŋ AF a AK w AI a AK n AF
bengkel	b AG ɛ AK ŋ AF k AC ɛ AK l AD
benih	b AG ə AK n AF ɪ AK h AA
benteng	b AG e AK n AF t AC e AK ŋ AF
benzol	b AG e AK n AF z AH o AM l AD
berada	b AG ə AK r AN a AK d AC a AK
berangkat	b AG ə AK r AN a AK ŋ AF k AC a AK t AC
berapa	b AG ə AK r AN a AK p AG a AK
berbahaya	b AG ə AK r AN b AG a AK h AA a AK j AB a AK
berbicara	b AG ə AK r AN b AG i AK t AC ʃ AH a AK r AN a AK
beri	b AG ə AK r AN i AK
berida	b AG ə AK r AN i AK d AC a AK
berjibaku	b AG ə AK r AN d AC ʒ AH i AK b AG a AK k AC u AM
berteori	b AG ə AK r AN t AC e AK o AM r AN i AK
beruang	b AG ə AK r AN u AM a̯ ŋ AF
besar	b AG ə AK s AH a AK r AN
besikal	b AG ə AK s AH i AK k AC a AK l AD
beskal	b AG ə AK s AH k AC a AK l AD
bestari	b AG ə AK s AH t AC a AK r AN i AK
betawi	b AG ə AK t AC a AK w AI i AK
beton	b AG ə AK t AC o AM n AF
bhayangkara	bʰ BC a AK j AB a AK ŋ AF k AC a AK r AN a AK
biara	b AG i AK a AK r AN a AK
biasa	b AG i AK a AK s AH a AK
biaya	b AG i AK a AK j AB a AK
bibel	b AG i AK b AG ə AK l AD
bicara	b AG i AK t AC ʃ AH a AK r AN a AK
bidadari	b AG i AK d AC a AK d AC a AK r AN i AK
bidak	b AG i AK d AC a AK k AC
bidan	b AG i AK d AC a AK n AF
bihun	b AG i AK h AA u AM n AF
bijak	b AG i AK d AC ʒ AH a AK k AC
bijaksana	b AG i AK d AC ʒ AH a AK k AC s AH a AK n AF a AK
biji	b AG i AK d AC ʒ AH i AK
biksu	b AG i AK k AC s AH u AM
biku	b AG i AK k AC u AM
bila	b AG i AK l AD a AK
binasa	b AG i AK n AF a AK s AH a AK
binatang	b AG i AK n AF a AK t AC a AK ŋ AF
bintara	b AG i AK n AF t AC a AK r AN a AK
bioskop	b AG i AK o AM s AH k AC o AM p AG
biro	b AG i AK r AN o AM
blangko	b AG ə̆ BB l AD a AK ŋ AF k AC o AM
blek	b AG l AD ɛ AK k AC
blumbak	b AG l AD ʊ AM m AE b AG a AK k̚
bodo	b AG o AM d AC o AM
bohong	b AG o AM h AA o AM n AF ɡ AC
boleh	b AG o AM l AD e AK h AA
bon	b AG ɔ AM n AF
bonsai	b AG o AM n AF s AH a AK i AK
bor	b AG o AM r AN
borang	b AG ɔ AM r AN a AK ŋ AF
bordil	b AG o AM r AN d AC ɪ AK l AD
brankar	b AG r AN a AK n AF k AC a AK r AN
bruder	b AG r AN u AM d AC ə AK r AN
buana	b AG u AM a̯ n AF a AK
budak	b AG u AM d AC a AK ʔ AJ
budaya	b AG u AM d AC a AK j AB a AK
budi	b AG u AM d AC i AK
budiman	b AG u AM d AC i AK m AE a AK n AF
bujangga	b AG u AM d AC ʒ AH a AK ŋ AF ɡ AC a AK
bukti	b AG u AM k AC t AC i AK
buku	b AG u AM k AC u AM
bulan	b AG u AM l AD a AK n AF
bumi	b AG u AM m AE i AK
bumiputra	b AG u AM m AE i AK p AG u AM t AC ə AK r AN a AK
buncis	b AG u AM n AF t AC ʃ AH ɪ AK s AH
bundel	b AG ʊ AM n AF d AC ə AK l AD
bunga	b AG u AM ŋ AF a AK
bunting	b AG ʊ AM n AF t AC ɪ AK ŋ AF
bunuh	b AG u AM n AF ʊ AM h AA
bupati	b AG u AM p AG a AK t AC i AK
bus	b AG u AM s AH
busa	b AG u AM s AH a AK
busana	b AG u AM s AH a AK n AF a AK
bushido	b AG u AM ʃ AH i AK d AC o AM
busyido	b AG u AM ʃ AH i AK d AC o AM
buta	b AG u AM t AC a AK
butala	b AG u AM t AC a AK l AD a AK
butuh	b AG u AM t AC u AM h AA
cabai	t AC ʃ AH a AK b AG e AK ʔ AJ
cadar	t AC ʃ AH a AK d AC a AK r AN
cahaya	t AC ʃ AH a AK h AA a AK j AB a AK
cairan	t AC ʃ AH a AK ɪ AK r AN a AK n AF
cakra	t AC ʃ AH a AK k AC ə AK r AN a AK
cakram	t AC ʃ AH a AK k AC r AN a AK m AE
cakrawala	t AC ʃ AH a AK k AC r AN a AK w AI a AK l AD a AK
cakrawati	t AC ʃ AH a AK k AC r AN a AK w AI a AK t AC i AK
calon	t AC ʃ AH a AK l AD o AM n AF
camat	t AC ʃ AH a AK m AE a AK t̚
candra	t AC ʃ AH a AK n AF d AC r AN a AK
canoyu	t AC ʃ AH a AK n AF o AM j AB u AM
cantik	t AC ʃ AH a AK n AF t AC i AK k AC
cara	t AC ʃ AH a AK r AN a AK
cari	t AC ʃ AH a AK r AN i AK
catur	t AC ʃ AH a AK t AC u AM r AN
cedera	t AC ʃ AH ə AK d AC ə AK r AN a AK
cela	t AC ʃ AH ə AK l AD a AK
celaka	t AC ʃ AH ə AK l AD a AK k AC a AK
celeng	c AC ɛ AK l AD ɛ AK ŋ AF
celengan	c AC ɛ AK l AD ɛ AK ŋ AF a AK n AF
cempaka	t AC ʃ AH ə AK m AE p AG a AK k AC a AK
cenangga	t AC ʃ AH ə AK n AF a AK ŋ AF ɡ AC a AK
cendala	t AC ʃ AH ə AK n AF d AC a AK l AD a AK
cendana	t AC ʃ AH ə AK n AF d AC a AK n AF a AK
cendekia	c AC ə AK n AF d AC ə AK k AC i AK a AK
cendera	t AC ʃ AH ə AK n AF d AC ə AK r AN a AK
cenderasa	t AC ʃ AH ə AK n AF d AC ə AK r AN a AK s AH a AK
cenderawasih	t AC ʃ AH ə AK n AF d AC ə AK r AN a AK w AI a AK s AH i AK h AA
cengkerama	t AC ʃ AH ə AK ŋ AF k AC ə AK r AN a AK m AE a AK
cengkerawak	t AC ʃ AH ə AK ŋ AF k AC ə AK r AN a AK w AI a AK k AC
cerana	t AC ʃ AH ə AK r AN a AK n AF a AK
cerca	t AC ʃ AH ə AK r AN t AC ʃ AH a AK
ceria	t AC ʃ AH ə AK r AN i AK a AK
cerita	t AC ʃ AH ə AK r AN i AK t AC a AK
cerutu	t AC ʃ AH ə AK r AN u AM t AC u AM
cetera	t AC ʃ AH ə AK t AC ə AK r AN a AK
cewek	t AC ʃ AH e AK w AI e AK ʔ AJ
china	t AC ʃ AH ɪ AK n AF a AK
cita	t AC ʃ AH i AK t AC a AK
citra	t AC ʃ AH i AK t AC r AN a AK
ciu	t AC ʃ AH i AK u AM
cokelat	t AC ʃ AH ɔ AM k AC ə AK l AD a AK t AC
coker	t AC ʃ AH o AM k AC ə AK r AN
coli	t AC ʃ AH o AM l AD i AK
colmek	t AC ʃ AH o AM l AD m AE ɛ AK k AC
cowok	t AC ʃ AH o AM w AI o AM ʔ AJ
cuaca	t AC ʃ AH u AM a AK t AC ʃ AH a AK
cuek	c AC u AM e AK ʔ AJ
cuka	t AC ʃ AH u AM k AC a AK
cula	t AC ʃ AH u AM l AD a AK
cultuurstelsel	k AC ʊ AM l AD t AC ʊ AM r AN s AH t AC ɛ AK l AD s AH ə AK l AD
cuma	t AC ʃ AH u AM m AE a AK
curiga	t AC ʃ AH u AM r AN i AK ɡ AC a AK
dadih	d AC a AK d AC i AK h AA
daerah	d AC a AK e AK r AN a AK h AA
dahaga	d AC a AK h AA a AK ɡ AC a AK
daidan	d AC a AK i AK d AC a AK n AF
daidanco	d AC a AK i AK d AC a AK n AF t AC ʃ AH o AM
daitia	d AC a AK i AK t AC i AK a AK
daksina	d AC a AK k AC s AH i AK n AF a AK
daku	d AC a AK k AC u AM
dalam	d AC a AK l AD a AK m AE
dan	d AC a AK n AF
dana	d AC a AK n AF a AK
danau	d AC a AK n AF a AK u̯ AI
dansa	d AC a AK n AF s AH a AK
danta	d AC a AK n AF t AC a AK
dari	d AC a AK r AN i AK
daring	d AC a AK r AN ɪ AK ŋ AF
darma	d AC a AK r AN m AE a AK
datang	d AC a AK t AC a AK ŋ AF
datu	d AC a AK t AC u AM
dawat	d AC a AK w AI a AK t AC
daya	d AC a AK j AB a AK
dekan	d AC ɛ AK k AC a AK n AF
dekat	d AC ə AK k AC a AK t AC
delesi	d AC e AK l AD e AK s AH i AK
dengan	d AC ə AK ŋ AF a AK n AF
dengar	d AC ə AK ŋ AF a AK r AN
derita	d AC ə AK r AN i AK t AC a AK
desember	d AC e AK s AH ɛ AK m AE b AG ə AK r AN
detail	d AC ə AK t AC a AK ɪ AK l AD
devosi	d AC e AK v BA o AM s AH i AK
dewa	d AC ɛ AK w AI a AK
dewan	d AC ɛ AK w AI a AK n AF
dia	d AC i AK a AK
diaken	d AC i AK a AK k AC ə AK n AF
diakon	d AC i AK a AK k AC o AM n AF
diam	d AC i AK a AK m AE
digali	d AC i AK ɡ AC a AK l AD i AK
digdaya	d AC i AK ɡ AC d AC a AK j AB a AK
dikau	d AC i AK k AC a AK u̯ AI
dimakan	d AC i AK m AE a AK k AC a AK n AF
dirgahayu	d AC i AK r AN ɡ AC a AK h AA a AK j AB u AM
disposisi	d AC i AK s AH p AG o AM s AH i AK s AH i AK
doa	d AC o AM a AK
dohyo	d AC ɔ AM xʲ AH ɔ AM
dojo	d AC o AM d AC ʒ AH o AM
dokter	d AC ɔ AM k AC t AC ə AK r AN
doktor	d AC ɔ AM k AC t AC ɔ AM r AN
dokumen	d AC o AM k AC u AM m AE ɛ AK n AF
dom	d AC o AM m AE
donasi	d AC o AM n AF a AK s AH i AK
dorna	d AC o AM r AN n AF a AK
dorong	d AC o AM r AN o AM ŋ AF
dosa	d AC o AM s AH a AK
dosen	d AC o AM s AH ɛ AK n AF
dosin	d AC o AM s AH i AK n AF
doyo	d AC o AM j AB o AM
duane	d AC u AM a AK n AF ə AK
duit	d AC u AM i AK t AC
duk	d AC ʊ AM k̚
duka	d AC u AM k AC a AK
duli	d AC u AM l AD i AK
dulu	d AC u AM l AD u AM
dunia	d AC u AM n AF i AK a AK
dupa	d AC u AM p AG a AK
duta	d AC u AM t AC a AK
edamame	e AK d AC a AK m AE a AK m AE e AK
efek	ɛ AK f BA ɛ AK k AC
efektif	ɛ AK f BA ɛ AK k̚ t AC ɪ AK f BA
eigendom	e AK i AK ɡ AC ə AK n AF d AC o AM m AE
eka	e AK k AC a AK
ekaristi	ɛ AK k AC a AK r AN i AK s AH t AC i AK
eklips	ɛ AK k AC l AD i AK p AG s AH
eksper	ɛ AK k AC s AH p AG ɛ AK r AN
elektrik	ɛ AK l AD ɛ AK k AC t AC r AN ɪ AK k AC
elektris	ɛ AK l AD ɛ AK k AC t AC r AN ɪ AK s AH
emoji	e AK m AE o AM d AC ʒ AH i AK
empat	ə AK m AE p AG a AK t AC
enggak	e AK ŋ AF ɡ AC a AK ʔ AJ
engkau	ə AK ŋ AF k AC a AK u̯ AI
ensiklik	e AK n AF s AH i AK k AC l AD i AK k AC
episkopal	ɛ AK p AG i AK s AH k AC o AM p AG a AK l AD
episkopat	ɛ AK p AG ɪ AK s AH k AC o AM p AG a AK t AC
erti	ə AK r AN t AC i AK
es	ɛ AK s AH
esa	ə AK s AH a AK
estafet	ɛ AK s AH t AC a AK f BA ɛ AK t AC
etik	ɛ AK t AC ɪ AK k AC
etika	ɛ AK t AC i AK k AC a AK
etis	ɛ AK t AC ɪ AK s AH
etude	e AK t AC u AM d AC ɛ AK
fakultas	f BA a AK k AC ʊ AM l AD t AC a AK s AH
farmasi	f BA a AK r AN m AE a AK s AH i AK
fatsun	f BA a AK t AC s AH u AM n AF
februari	f BA ɛ AK b AG r AN u AM a AK r AN i AK
fengsui	f BA e AK ŋ AF s AH u AM i AK
film	p AG e AK l AD ə AK m AE
firaun	f BA i AK r AN a AK u AM n AF
fiskal	f BA ɪ AK s AH k AC a AK l AD
folder	f BA ɔ AM l AD d AC ə AK r AN
formulir	f BA o AM r AN m AE u AM l AD ɪ AK r AN
frater	f BA r AN a AK t AC ə AK r AN
gada	ɡ AC a AK d AC a AK
gading	ɡ AC a AK d AC i AK ŋ AF
gaharu	ɡ AC a AK h AA a AK r AN u AM
gajah	ɡ AC a AK d AC ʒ AH a AK ʔ AJ
gakari	ɡ AC a AK k AC a AK r AN i AK
gala	ɡ AC a AK l AD a AK
gali	ɡ AC a AK l AD i AK
galuh	ɡ AC a AK l AD u AM h AA
gang	ɡ AC a AK ŋ AF
gap	ɡ AC a AK p AG
gapura	ɡ AC a AK p AG u AM r AN a AK
garansi	ɡ AC a AK r AN a AK n AF s AH i AK
garuda	ɡ AC a AK r AN u AM d AC a AK
gaya	ɡ AC a AK j AB a AK
gayung	ɡ AC a AK j AB u AM ŋ AF
gedong	ɡ AC ɛ AK d AC o AM ŋ AF
gedung	ɡ AC ə AK d AC ʊ AM ŋ AF
gelita	ɡ AC ə AK l AD i AK t AC a AK
gempa	ɡ AC ə AK m AE p AG a AK
gempita	ɡ AC ə AK m AE p AG i AK t AC a AK
generik	ɡ AC e AK n AF e AK r AN i AK k AC
geng	ɡ AC ɛ AK ŋ AF
genta	ɡ AC ə AK n AF t AC a AK
gerha	ɡ AC ə AK r AN h AA a AK
gerhana	ɡ AC ə AK r AN h AA a AK n AF a AK
ggl	ɡ AC e AK ɡ AC e AK ɛ AK l AD
gigi	ɡ AC i AK ɡ AC i AK
giri	ɡ AC i AK r AN i AK
gita	ɡ AC i AK t AC a AK
go	ɡ AC o AM
goban	ɡ AC o AM b AG a AK n AF
gongyo	ɣ AH ɔ AM n AF ɣʲ AH ɔ AM
graha	ɡ AC r AN a AK h AA a AK
grahita	ɡ AC r AN a AK h AA i AK t AC a AK
greha	ɡ AC r AN ə AK h AA a AK
gua	ɡ AC u AM a AK
gubernur	ɡ AC u AM b AG ə AK r AN n AF ʊ AM r AN
gudang	ɡ AC u AM d AC a AK ŋ AF
gula	ɡ AC u AM l AD a AK
gulana	ɡ AC u AM l AD a AK n AF a AK
guna	ɡ AC u AM n AF a AK
gundik	ɡ AC u AM n AF d AC i AK ʔ AJ
gunseibu	ɡ AC u AM n AF s AH e AK i AK b AG u AM
gunseikan	ɡ AC u AM n AF s AH e AK i AK k AC a AK n AF
gurita	ɡ AC u AM r AN i AK t AC a AK
guru	ɡ AC u AM r AN u AM
habel	h AA a AK b AG e AK l AD
habil	h AA a AK b AG ɪ AK l AD
hadiah	h AA a AK d AC i AK j AB a AK h AA
hadir	h AA a AK d AC ɪ AK r AN
hadis	h AA a AK d AC ɪ AK s AH
hai	h AA a AK ɪ AK
haiku	h AA a AK i AK k AC u AM
hak	h AA a AK k AC
hal	h AA a AK l AD
hampir	h AA a AK m AE p AG i AK r AN
handelar	h AA a AK n AF d AC ə AK l AD a AK r AN
handschoen	h AA a AK n AF t̚ s AH k AC u AM n AF
handuk	h AA a AK n AF d AC ʊ AM k̚
hanya	h AA a AK ɲ AF a AK
hanzi	h AA a AK n AF z AH i AK
harap	h AA a AK r AN a AK p AG
harga	h AA a AK r AN ɡ AC a AK
harta	h AA a AK r AN t AC a AK
harus	h AA a AK r AN ʊ AM s AH
hasta	h AA a AK s AH t AC a AK
hati	h AA a AK t AC i AK
hatta	h AA a AK t AC t AC a AK
hedon	h AA e AK d AC o AM n AF
hedonisme	h AA e AK d AC o AM n AF i AK s AH m AE ə AK
heiho	h AA e AK i AK h AA o AM
heng	h AA ɛ AK ŋ AF
hentai	h AA ɛ AK n AF t AC a AK i̯ AB
hewan	h AA e AK w AI a AK n AF
hidrogen	h AA i AK d AC r AN o AM ɡ AC ɛ AK n AF
hidup	h AA i AK d AC u AM p AG
hierarki	h AA i AK e AK r AN a AK r AN k AC i AK
hilang	h AA i AK l AD a AK ŋ AF
hina	h AA i AK n AF a AK
homo	h AA o AM m AE o AM
hongbao	h AA o AM ŋ AF b AG a AK o AM
hongsui	h AA o AM ŋ AF s AH u AM i AK
honji	h AA o AM n AF d AC ʒ AH i AK
hop	h AA o AM p AG
hopagen	h AA o AM p AG a AK ɡ AC ɛ AK n AF
hopbiro	h AA o AM p AG b AG i AK r AN o AM
hosti	h AA o AM s AH t AC i AK
hukum	h AA u AM k AC ʊ AM m AE
hukuman	h AA u AM k AC u AM m AE a AK n AF
huruf	h AA u AM r AN ʊ AM f BA
hutan	h AA u AM t AC a AK n AF
ia	i AK a AK
ialah	i AK a AK l AD a AK h AA
iba	i AK b AG a AK
ibrani	i AK b AG r AN a AK n AF i AK
ijazah	i AK d AC ʒ AH a AK z AH a AK h AA
ikan	i AK k AC a AK n AF
ikebana	i AK k AC e AK b AG a AK n AF a AK
ikhlas	i AK x AH l AD a AK s AH
iklim	i AK k AC l AD ɪ AK m AE
ikonik	i AK k AC o AM n AF ɪ AK k AC
ikonis	i AK k AC o AM n AF ɪ AK s AH
imam	i AK m AE a AK m AE
imamah	i AK m AE a AK m AE a AK h AA
imamat	i AK m AE a AK m AE a AK t AC
iman	i AK m AE a AK n AF
imlek	i AK m AE l AD ɛ AK k AC
imprimatur	i AK m AE p AG r AN i AK m AE a AK t AC u AM r AN
indekos	i AK n AF d AC ə AK k AC ɔ AM s AH
indonesia	i AK n AF d AC o AM n AF ɛ AK s AH i AK a AK
indra	i AK n AF d AC ə AK r AN a AK
industri	ɪ AK n AF d AC ʊ AM s AH t AC r AN i AK
informasi	i AK n AF f BA ɔ AM r AN m AE a AK s AH i AK
informatif	ɪ AK n AF f BA ɔ AM r AN m AE a AK t AC ɪ AK f BA
ingin	i AK ŋ AF i AK n AF
injil	ɪ AK n AF d AC ʒ AH ɪ AK l AD
inset	i AK n AF s AH ɛ AK t AC
intensi	i AK n AF t AC ɛ AK n AF s AH i AK
internasional	i AK n AF t AC ə AK r AN n AF a AK s AH i AK o AM n AF a AK l AD
internuntius	i AK n AF t AC ə AK r AN n AF u AM n AF t AC i AK u AM s AH
intonasi	ɪ AK n AF t AC o AM n AF a AK s AH i AK
ipa	i AK p AG a AK
irama	i AK r AN a AK m AE a AK
isa	i AK s AH a AK
isap	i AK s AH a AK p AG
istana	i AK s AH t AC a AK n AF a AK
istimewa	ɪ AK s AH t AC i AK m AE ɛ AK w AI a AK
istri	i AK s AH t AC r AN i AK
jadi	d AC ʒ AH a AK d AC i AK
jadwal	d AC ʒ AH a AK t̚ w AI a AK l AD
jaga	d AC ʒ AH a AK ɡ AC a AK
jagat	j AB a AK ɡ AC a AK t AC
jakarta	d AC ʒ AH a AK k AC a AK r AN t AC a AK
jakun	d AC ʒ AH a AK k AC ʊ AM n AF
jala	d AC ʒ AH a AK l AD a AK
jalan	d AC ʒ AH a AK l AD a AK n AF
jamur	d AC ʒ AH a AK m AE ʊ AM r AN
janapada	d AC ʒ AH a AK n AF a AK p AG a AK d AC a AK
jangan	d AC ʒ AH a AK ŋ AF a AK n AF
jantung	d AC ʒ AH a AK n AF t AC ʊ AM ŋ AF
januari	d AC ʒ AH a AK n AF u AM a AK r AN i AK
jari	d AC ʒ AH a AK r AN i AK
jarum	d AC ʒ AH a AK r AN ʊ AM m AE
jati	d AC ʒ AH a AK t AC i AK
jawa	d AC ʒ AH a AK w AI a AK
jawab	d AC ʒ AH a AK w AI a AK p̚
jawaban	d AC ʒ AH a AK w AI a AK p AG a AK n AF
jelata	d AC ʒ AH ə AK l AD a AK t AC a AK
jelita	d AC ʒ AH ə AK l AD i AK t AC a AK
jelma	d AC ʒ AH ə AK l AD m AE a AK
jenasah	d AC ʒ AH ə AK n AF a AK s AH a AK h AA
jenazah	d AC ʒ AH ə AK n AF a AK z AH a AK h AA
jentera	d AC ʒ AH ə AK n AF t AC ə AK r AN a AK
jepang	d AC ʒ AH ə AK p AG a AK ŋ AF
jepun	d AC ʒ AH ə AK p AG ʊ AM n AF
jerman	d AC ʒ AH e AK r AN m AE a AK n AF
jijik	d AC ʒ AH i AK d AC ʒ AH ɪ AK ʔ AJ
jiwa	d AC ʒ AH i AK w AI a AK
judo	d AC ʒ AH u AM d AC o AM
judogi	d AC ʒ AH u AM d AC o AM ɡ AC i AK
judoka	d AC ʒ AH u AM d AC o AM k AC a AK
jujitsu	d AC ʒ AH u AM d AC ʒ AH ɪ AK t AC s AH u AM
jujutsu	d AC ʒ AH u AM d AC ʒ AH ʊ AM t AC s AH u AM
juli	d AC ʒ AH u AM l AD i AK
juni	d AC ʒ AH u AM n AF i AK
juta	d AC ʒ AH u AM t AC a AK
kabar	k AC a AK b AG a AK r AN
kabinet	k AC a AK b AG i AK n AF ɛ AK t AC
kabisat	k AC a AK b AG i AK s AH a AK t̚
kabuki	k AC a AK b AG u AM k AC i AK
kabupaten	k AC a AK b AG u AM p AG a AK t AC e AK n AF
kaca	k AC a AK t AC ʃ AH a AK
kacamata	k AC a AK t AC ʃ AH a AK m AE a AK t AC a AK
kacung	k AC a AK t AC ʃ AH ʊ AM ŋ AF
kadaster	k AC a AK d AC a AK s AH t AC ə AK r AN
kadaver	k AC a AK d AC a AK v BA ə AK r AN
kaf	k AC a AK f BA
kailan	k AC a AK i AK l AD a AK n AF
kaisar	k AC a AK i AK s AH a AK r AN
kaji	k AC a AK d AC ʒ AH i AK
kakus	k AC a AK k AC ʊ AM s AH
kali	k AC a AK l AD i AK
kalian	k AC a AK l AD i AK a AK n AF
kama	k AC a AK m AE a AK
kami	k AC a AK m AE i AK
kamikaze	k AC a AK m AE i AK k AC a AK z AH e AK
kamis	k AC a AK m AE ɪ AK s AH
kampai	k AC a AK m AE p AG a AK i̯ AB
kamu	k AC a AK m AE u AM
kamuflase	k AC a AK m AE u AM f BA l AD a AK s AH ə AK
kandidat	k AC a AK n AF d AC i AK d AC a AK t̚
kanji	k AC a AK n AF d AC ʒ AH i AK
kanonis	k AC a AK n AF o AM n AF ɪ AK s AH
kanta	k AC a AK n AF t AC a AK
kantor	k AC a AK n AF t AC o AM r AN
kapal	k AC a AK p AG a AK l AD
kapalan	k AC a AK p AG a AK l AD a AK n AF
kapan	k AC a AK p AG a AK n AF
kapas	k AC a AK p AG a AK s AH
kapitan	k AC a AK p AG i AK t AC a AK n AF
kapten	k AC a AK p̚ t AC ɛ AK n AF
karakuri	k AC a AK r AN a AK k AC u AM r AN i AK
karaoke	k AC a AK r AN a AK o AM k AC e AK
karate	k AC a AK r AN a AK t AC e AK
karategi	k AC a AK r AN a AK t AC e AK ɡ AC i AK
karateka	k AC a AK r AN a AK t AC e AK k AC a AK
kardinal	k AC a AK r AN d AC i AK n AF a AK l AD
karkas	k AC a AK r AN k AC a AK s AH
karma	k AC a AK r AN m AE a AK
karsa	k AC a AK r AN s AH a AK
kartel	k AC a AK r AN t AC ɛ AK l AD
kartika	k AC a AK r AN t AC i AK k AC a AK
kartu	k AC a AK r AN t AC u AM
karunia	k AC a AK r AN u AM n AF i AK a̯
karya	k AC a AK r AN j AB a AK
kastel	k AC a AK s AH t AC ɛ AK l AD
kastil	k AC a AK s AH t AC ɪ AK l AD
kata	k AC a AK t AC a AK
katedral	k AC a AK t AC ə AK d AC r AN a AK l AD
katun	k AC a AK t AC u AM n AF
kau	k AC a AK u̯ AI
kawan	k AC a AK w AI a AK n AF
kawasan	k AC a AK w AI a AK s AH a AK n AF
kebakaran	k AC ə AK b AG a AK k AC a AK r AN a AK n AF
kebun	k AC ə AK b AG ʊ AM n AF
kecamatan	k AC ə AK t AC ʃ AH a AK m AE a AK t AC a AK n AF
kecap	k AC ɛ AK t AC ʃ AH a AK p AG
kecil	k AC ə AK t AC ʃ AH i AK l AD
kedaluwarsa	k AC ə AK d AC a AK l AD u AM w AI a AK r AN s AH a AK
kedatangan	k AC ə AK d AC a AK t AC a AK ŋ AF a AK n AF
kedokteran	k AC ə AK d AC o AM k AC t AC ə AK r AN a AK n AF
kedutaan	k AC ə AK d AC u AM t AC a AK a AK n AF
keempat	k AC ə AK ə AK m AE p AG a AK t AC
kehausan	k AC ə AK h AA a AK ʊ AM s AH a AK n AF
kehujanan	k AC ə AK h AA u AM d AC ʒ AH a AK n AF a AK n AF
keibodan	k AC e AK i AK b AG o AM d AC a AK n AF
keik	k AC ɛ AK i AK k AC
keker	k AC ɛ AK k AC ɛ AK r AN
kelab	k AC ə AK l AD a AK p AG
kelapa	k AC ə AK l AD a AK p AG a AK
kelar	k AC ə AK l AD a AK r AN
kelinci	k AC ə AK l AD ɪ AK n AF t AC ʃ AH i AK
keluarga	k AC ə AK l AD u AM a AK r AN ɡ AC a AK
kembang	k AC ə AK m AE b AG a AK ŋ AF
kempetai	k AC e AK m AE p AG e AK t AC a AK i̯ AB
ken	k AC ɛ AK n AF
kenapa	k AC ə AK n AF a AK p AG a AK
kencana	k AC ə AK n AF t AC ʃ AH a AK n AF a AK
kendaraan	k AC ə AK n AF d AC a AK r AN a AK ʔ AJ a AK n AF
kendi	k AC ə AK n AF d AC i AK
kendo	k AC ɛ AK n AF d AC o AM
kenek	k AC ə AK n AF ɛ AK k AC
kening	k AC ə AK n AF ɪ AK ŋ AF
kepala	k AC ə AK p AG a AK l AD a AK
keparat	k AC ə AK p AG a AK r AN a AK t AC
kerajaan	k AC ə AK r AN a AK d AC ʒ AH a AK a AK n AF
keranda	k AC ə AK r AN a AK n AF d AC a AK
keraton	k AC ə AK r AN a AK t AC ɔ AM n AF
kerbau	k AC ə AK r AN b AG a AK u̯ AI
kerosin	k AC e AK r AN o AM s AH ɪ AK n AF
kertas	k AC ə AK r AN t AC a AK s AH
ketinggalan	k AC ə AK t AC i AK ŋ AF ɡ AC a AK l AD a AK n AF
keturunan	k AC ə AK t AC u AM r AN ʊ AM n AF a AK n AF
keuskupan	k AC ə AK u AM s AH k AC u AM p AG a AK n AF
khalifah	x AH a AK l AD i AK f BA a AK ʔ AJ
khatam	x AH a AK t AC a AK m AE
khawatir	x AH a AK w AI a AK t AC i AK r AN
khilafah	x AH i AK l AD a AK f BA a AK ʔ AJ
kiai	k AC i AK a AK i̯ AB
kidal	k AC i AK d AC a AK l AD
kilang	k AC i AK l AD a AK ŋ AF
kimono	k AC i AK m AE o AM n AF o AM
kira	k AC i AK r AN a AK
kirana	k AC i AK r AN a AK n AF a AK
kita	k AC i AK t AC a AK
kitab	k AC i AK t AC a AK p̚
klasikal	k AC l AD a AK s AH ɪ AK k AC a AK l AD
klaver	k AC l AD a AK v BA ə AK r AN
klem	k AC l AD ɛ AK m AE
klep	k AC l AD ɛ AK p AG
klinikal	k AC l AD i AK n AF i AK k AC a AK l AD
klinis	k AC l AD i AK n AF i AK s AH
klop	k AC l AD ɔ AM p̚
kolaborator	k AC ɔ AM l AD a AK b AG ɔ AM r AN a AK t AC ɔ AM r AN
kolam	k AC o AM l AD a AK m AE
kolega	k AC o AM l AD e AK ɡ AC a AK
kolik	k AC o AM l AD ɪ AK k AC
komandan	k AC o AM m AE a AK n AF d AC a AK n AF
komet	k AC o AM m AE ɛ AK t̚
komisi	k AC o AM m AE i AK s AH i AK
komite	k AC o AM m AE i AK t AC e AK
komplot	k AC o AM m AE p AG l AD o AM t AC
komunikasi	k AC o AM m AE u AM n AF i AK k AC a AK s AH i AK
komunis	k AC o AM m AE u AM n AF ɪ AK s AH
koneksi	k AC o AM n AF ɛ AK k AC s AH i AK
konfeti	k AC o AM n AF f BA e AK t AC i AK
koordinasi	k AC o AM ɔ AM r AN d AC i AK n AF a AK s AH i AK
kop	k AC o AM p AG
koper	k AC o AM p AG ə AK r AN
koperasi	k AC o AM p AG ə AK r AN a AK s AH i AK
kopi	k AC o AM p AG i AK
kopitiam	k AC o AM p AG i AK t AC i AK a AK m AE
kor	k AC ɔ AM r AN
koroner	k AC o AM r AN o AM n AF ɛ AK r AN
korupsi	k AC o AM r AN u AM p AG s AH i AK
kosakata	k AC o AM s AH a AK k AC a AK t AC a AK
kosmonaut	k AC ɔ AM s AH m AE o AM n AF a AK u̯ AI t̚
kota	k AC o AM t AC a AK
kredo	k AC r AN e AK d AC o AM
krida	k AC r AN i AK d AC a AK
kring	k AC r AN ɪ AK ŋ AF
kristen	k AC r AN ɪ AK s AH t AC ə AK n AF
kruk	k AC r AN ʊ AM k AC
krusial	k AC r AN u AM s AH i AK a AK l AD
ku	k AC u AM
kuartal	k AC u AM a AK r AN t AC a AK l AD
kucing	k AC u AM t AC ʃ AH ɪ AK ŋ AF
kuda	k AC u AM d AC a AK
kuil	k AC u AM ɪ AK l AD
kuilu	k AC u AM i AK l AD u AM
kuintal	k AC w AI i AK n AF t AC a AK l AD
kuitansi	k AC u AM i̯ AB t AC a AK n AF s AH i AK
kuliah	k AC u AM l AD i AK a AK h AA
kumico	k AC u AM m AE i AK t AC ʃ AH o AM
kuna	k AC u AM n AF a AK
kuno	k AC u AM n AF o AM
kurang	k AC u AM r AN a AK ŋ AF
kusta	k AC ʊ AM s AH t AC a AK
kusuma	k AC u AM s AH u AM m AE a AK
kutang	k AC u AM t AC a AK ŋ AF
lada	l AD a AK d AC a AK
lagi	l AD a AK ɡ AC i AK
laher	l AD a AK h AA ə AK r AN
laki	l AD a AK k AC i AK
laksa	l AD a AK k AC s AH a AK
laksamana	l AD a AK k AC s AH a AK m AE a AK n AF a AK
laksana	l AD a AK k AC s AH a AK n AF a AK
laksmi	l AD a AK k AC s AH m AE i AK
lalat	l AD a AK l AD a AK t̚
laler	l AD a AK l AD ə AK r AN
lama	l AD a AK m AE a AK
lanca	l AD a AK n AF t AC ʃ AH a AK
lancia	l AD a AK n AF t AC ʃ AH i AK a̯
langau	l AD a AK ŋ AF a AK u̯ AI
langca	l AD a AK ŋ AF t AC ʃ AH a AK
langcia	l AD a AK ŋ AF t AC ʃ AH i AK a̯
langit	l AD a AK ŋ AF i AK t AC
langka	l AD a AK ŋ AF k AC a AK
lantai	l AD a AK n AF t AC a AK i̯ AB
lapang	l AD a AK p AG a AK ŋ AF
lapangan	l AD a AK p AG a AK ŋ AF a AK n AF
laskar	l AD a AK s AH k AC a AK r AN
lawan	l AD a AK w AI a AK n AF
lazuardi	l AD a AK z AH u AM a AK r AN d AC i AK
leger	l AD ɛ AK ɡ AC ə AK r AN
lekong	l AD e AK k AC o AM ŋ AF
lektor	l AD ɛ AK k AC t AC o AM r AN
lelang	l AD ɛ AK l AD a AK ŋ AF
lemah	l AD ə AK m AE a AK h AA
lembar	l AD ə AK m AE b AG a AK r AN
lemper	l AD ə AK m AE p AG ə AK r AN
lengan	l AD ə AK ŋ AF a AK n AF
lengket	l AD ɛ AK ŋ AF k AC ɛ AK t̚
lensa	l AD ɛ AK n AF s AH a AK
lepra	l AD ɛ AK p AG r AN a AK
libur	l AD i AK b AG u AM r AN
lipur	l AD i AK p AG ʊ AM r AN
lisan	l AD i AK s AH a AK n AF
literasi	l AD i AK t AC ə AK r AN a AK s AH i AK
lobak	l AD o AM b AG a AK k AC
loji	l AD o AM d AC ʒ AH i AK
loka	l AD o AM k AC a AK
lokalisasi	l AD o AM k AC a AK l AD i AK s AH a AK s AH i AK
lokalisir	l AD o AM k AC a AK l AD i AK s AH ɪ AK r AN
loket	a AK b AG o AM n AF ə AK m AE ɛ AK n AF
loper	l AD o AM p AG ə AK r AN
losin	l AD o AM s AH i AK n AF
losmen	l AD o AM s AH m AE ɛ AK n AF
lues	l AD u AM e AK s AH
luncur	l AD ʊ AM n AF t AC ʃ AH ʊ AM r AN
lupa	l AD u AM p AG a AK
lurus	l AD u AM r AN u AM s AH
lusin	l AD u AM s AH i AK n AF
madrasah	m AE a AK d AC r AN a AK s AH a AK h AA
mahakuasa	m AE a AK h AA a AK k AC u AM a AK s AH a AK
main	m AE a AK i AK n AF
majelis	m AE a AK d AC ʒ AH ə AK l AD ɪ AK s AH
makan	m AE a AK k AC a AK n AF
makanan	m AE a AK k AC a AK n AF a AK n AF
maklumat	m AE a AK k̚ l AD u AM m AE a AK t̚
mala	m AE a AK l AD a AK
malam	m AE a AK l AD a AK m AE
malingsial	m AE ä l AD ɪ AK ŋ AF s AH i AK a AK l AD
mampu	m AE a AK m AE p AG u AM
mana	m AE a AK n AF a AK
mancanegara	m AE a AK n AF t AC ʃ AH a AK n AF ə AK ɡ AC a AK r AN a AK
manga	m AE a AK n AF ɡ AC a AK
mangaka	m AE a AK n AF ɡ AC a AK k AC a AK
mantel	m AE a AK n AF t AC ə AK l AD
mantra	m AE a AK n AF t AC r AN a AK
mantri	m AE a AK n AF t AC ə AK r AN i AK
map	m AE a AK p̚
maret	m AE a AK r AN ə AK t̚
marga	m AE a AK r AN ɡ AC a AK
mari	m AE a AK r AN i AK
markas	m AE a AK r AN k AC a AK s AH
masih	m AE a AK s AH i AK h AA
masker	m AE a AK s AH k AC ə AK r AN
matahari	m AE a AK t AC a AK h AA a AK r AN i AK
maya	m AE a AK j AB a AK
mayat	m AE a AK j AB a AK t̚
mayit	m AE a AK j AB i AK t̚
mazbah	m AE a AK z AH b AG a AK h AA
mecin	m AE ɛ AK t AC ʃ AH i AK n AF
medan	m AE ɛ AK d AC a AK n AF
mei	m AE e AK i̯ AB
melekaskan	m AE ə AK l AD ə AK k AC a AK s AH k AC a AK n AF
meletus	m AE ə AK l AD ə AK t AC u AM s AH
meloka	m AE ə AK l AD o AM k AC a AK
memaafkan	m AE ə AK m AE a AK a AK f BA k AC a AK n AF
memakan	m AE ə AK m AE a AK k AC a AK n AF
memasang	m AE ə AK m AE a AK s AH a AK ŋ AF
membaca	m AE ə AK m AE b AG a AK t AC ʃ AH a AK
membakar	m AE ə AK m AE b AG a AK k AC a AK r AN
membangun	m AE ə AK m AE b AG a AK ŋ AF ʊ AM n AF
membantah	m AE ə AK m AE b AG a AK n AF t AC a AK h AA
membeli	m AE ə AK m AE b AG e AK l AD i AK
memberantakkan	m AE ə AK m AE b AG ə AK r AN a AK n AF t AC a AK k AC k AC a AK n AF
membunuh	m AE ə AK m AE b AG u AM n AF ʊ AM h AA
meme	m AE e AK m AE e AK
memerban	m AE ə AK m AE ə AK r AN b AG a AK n AF
memetieskan	m AE ə AK m AE ə AK t AC i AK ɛ AK s AH k AC a AK n AF
memilih	m AE ə AK m AE i AK l AD i AK h AA
memindai	m AE ə AK m AE i AK n AF d AC a AK i̯ AB
memodernkan	m AE ə AK m AE o AM d AC ɛ AK r AN n AF k AC a AK n AF
memperketat	m AE ə AK m AE p AG ə AK r AN k AC ə AK t AC a AK t AC
memukul	m AE ə AK m AE u AM k AC ʊ AM l AD
memunculkan	m AE ə AK m AE u AM n AF t AC ʃ AH ʊ AM l AD k AC a AK n AF
memutakhirkan	m AE ə AK m AE u AM t AC a AK x AH i AK r AN k AC a AK n AF
menabelkan	m AE ə AK n AF a AK b AG ə AK l AD k AC a AK n AF
menambah	m AE ə AK n AF a AK m AE b AG a AK h AA
menampilkan	m AE ə AK n AF a AK m AE p AG i AK l AD k AC a AK n AF
menang	m AE ə AK n AF a AK ŋ AF
menara	m AE ə AK n AF a AK r AN a AK
menatapi	m AE ə AK n AF a AK t AC a AK p AG i AK
menayangkan	m AE ə AK n AF a AK j AB a AK ŋ AF k AC a AK n AF
mencacat	m AE ə AK n AF t AC ʃ AH a AK t AC ʃ AH a AK t AC
mencekoki	m AE ə AK ɲ AF t AC ʃ AH ə AK k AC o AM ʔ AJ i AK
mencekokkan	m AE ə AK n AF t AC ʃ AH ə AK k AC o AM ʔ AJ k AC a AK n AF
mencela	m AE ə AK ŋ AF t AC ʃ AH ə AK l AD a AK
mencium	m AE ə AK ɲ AF t AC ʃ AH i AK u AM m AE
mendengar	m AE ə AK n AF d AC ə AK ŋ AF a AK r AN
mendiamkan	m AE ə AK n AF d AC i AK a AK m AE k AC a AK n AF
mendoa	m AE ə AK n AF d AC o AM a AK
mendobrak	m AE ə AK n AF d AC o AM b AG r AN a AK k AC
mendung	m AE ə AK n AF d AC u AM ŋ AF
menelaah	m AE ə AK n AF ə AK l AD a AK a AK h AA
mengabadi	m AE ə AK ŋ AF a AK b AG a AK d AC i AK
mengaben	m AE ə AK ŋ AF a AK b AG ɛ AK n AF
menganiaya	m AE ə AK ŋ AF a AK n AF i AK a AK j AB a AK
menganiayai	m AE ə AK ŋ AF a AK n AF i AK a AK j AB a AK i AK
mengapa	m AE ə AK ŋ AF a AK p AG a AK
mengenai	m AE ə AK ɲ AF ə AK n AF a AK i AK
mengencingi	m AE ə AK ŋ AF e AK n AF c AC i AK ŋ AF i AK
mengendalikan	m AE ə AK ŋ AF ə AK n AF d AC a AK l AD i AK k AC a AK n AF
mengetatkan	m AE ə AK ŋ AF ə AK t AC a AK t̚ k AC a AK n AF
menggali	m AE ə AK ŋ AF ɡ AC a AK l AD i AK
menggarisbawahi	m AE ə AK ŋ AF ɡ AC a AK r AN i AK s AH b AG a AK w AI a AK h AA i AK
menggarisi	m AE ə AK ŋ AF ɡ AC a AK r AN i AK s AH i AK
menggempita	m AE ə AK ŋ AF ɡ AC ə AK m AE p AG i AK t AC a AK
menghadiri	m AE ə AK ŋ AF h AA a AK d AC i AK r AN i AK
menghadirkan	m AE ə AK ŋ AF h AA a AK d AC i AK r AN k AC a AK n AF
menghasilkan	m AE ə AK ŋ AF h AA a AK s AH i AK l AD k AC a AK n AF
menghukum	m AE ə AK ŋ AF h AA u AM k AC ʊ AM m AE
mengiler	m AE ə AK ŋ AF i AK l AD ə AK r AN
mengimbuh	m AE ə AK ŋ AF i AK m AE b AG u AM h AA
mengoplos	m AE ə AK ŋ AF o AM p AG l AD o AM s AH
mengubah	m AE ə AK ŋ AF u AM b AG a AK h AA
mengumpamakan	m AE ə AK ŋ AF u AM m AE p AG a AK m AE a AK k AC a AK n AF
menikah	m AE ə AK n AF i AK k AC a AK h AA
menilai	m AE ə AK n AF i AK l AD a AK i AK
meninggali	m AE ə AK n AF i AK ŋ AF ɡ AC a AK l AD i AK
menit	m AE ə AK n AF ɪ AK t AC
menjijikkan	m AE ə AK n AF d AC ʒ AH i AK d AC ʒ AH ɪ AK ʔ AJ k AC a AK n AF
menorah	m AE e AK n AF o AM r AN a AK h AA
menuntut	m AE ə AK n AF u AM n AF t AC ʊ AM t AC
menyerahkan	m AE ə AK ɲ AF ə AK r AN a AK h AA k AC a AK n AF
menyiarkan	m AE ə AK ɲ AF i AK a AK r AN k AC a AK n AF
menyimpan	m AE ə AK ɲ AF i AK m AE p AG a AK n AF
menyita	m AE ə AK ɲ AF i AK t AC a AK
menyunting	m AE ə AK ɲ AF u AM n AF t AC i AK ŋ AF
menyusun	m AE ə AK ɲ AF u AM s AH ʊ AM n AF
meong	m AE ɛ AK o AM ŋ AF
meraih	m AE ə AK r AN a AK i AK h AA
meraja	m AE ə AK r AN a AK d AC ʒ AH a AK
merebus	m AE ə AK r AN ə AK b AG ʊ AM s AH
mereka	m AE ə AK r AN e AK k AC a AK
merica	m AE ə AK r AN i AK t AC ʃ AH a AK
merupakan	m AE ə AK r AN u AM p AG a AK k AC a AK n AF
merusak	m AE ə AK r AN u AM s AH a AK ʔ AJ
mesir	m AE ə AK s AH i AK r AN
meta	a AK b AG o AM n AF ə AK m AE ɛ AK n AF
micin	m AE i AK t AC ʃ AH i AK n AF
minaret	m AE i AK n AF a AK r AN ɛ AK t AC
minder	m AE ɪ AK n AF d AC ə AK r AN
mirin	m AE i AK r AN i AK n AF
mobil	m AE o AM b AG i AK l AD
moci	m AE o AM t AC ʃ AH i AK
moksa	m AE o AM k AC s AH a AK
monarki	m AE o AM n AF a AK r AN k AC i AK
mu	m AE u AM
muda	m AE u AM d AC a AK
mudra	m AE u AM d AC r AN a AK
muka	m AE u AM k AC a AK
mula	m AE u AM l AD a AK
mur	m AE u AM r AN
mutasi	m AE u AM t AC a AK s AH i AK
n	ɛ AK n AF
nagari	n AF a AK ɡ AC a AK r AN i AK
nah	n AF a AK h AA
nakhoda	n AF a AK x AH o AM d AC a AK
nanas	n AF a AK n AF a AK s AH
nanti	n AF a AK n AF t AC i AK
nasrani	n AF a AK s AH r AN a AK n AF i AK
natal	n AF a AK t AC a AK l AD
naufal	n AF a AK u AM f BA a AK l AD
negeri	n AF ə AK ɡ AC ə AK r AN i AK
negoisasi	n AF ɛ AK ɡ AC o AM s AH i AK a AK s AH i AK
nestapa	n AF ə AK s AH t AC a AK p AG a AK
netra	n AF ə AK t AC r AN a AK
nila	n AF i AK l AD a AK
nira	n AF i AK r AN a AK
nirwana	n AF i AK r AN w AI a AK n AF a AK
nopek	n AF o AM p AG ɛ AK ʔ AJ
nori	n AF o AM r AN i AK
not	n AF ɔ AM t AC
november	n AF o AM v BA ɛ AK m AE b AG ə AK r AN
nyanyi	ɲ AF a AK ɲ AF i AK
nyendok	ɲ AF ə AK n AF d AC o AM ʔ AJ
nyiur	ɲ AF i AK ʊ AM r AN
nyonya	ɲ AF o AM ɲ AF a AK
obesitas	o AM b AG ɛ AK s AH i AK t AC a AK s AH
obi	o AM b AG i AK
oke	ɔ AM k AC e AK
oktober	ɔ AM k̚ t AC o AM b AG ə AK r AN
onagata	o AM n AF a AK ɡ AC a AK t AC a AK
onderdil	o AM n AF d AC ə AK r AN d AC i AK l AD
ongkos	o AM ŋ AF k AC o AM s AH
onigiri	o AM n AF i AK ɡ AC i AK r AN i AK
onsen	o AM n AF s AH ɛ AK n AF
oplos	o AM p̚ l AD o AM s AH
oplosan	o AM p AG l AD o AM s AH a AK n AF
orang	o AM r AN a AK ŋ AF
origami	o AM r AN i AK ɡ AC a AK m AE i AK
oto	o AM t AC o AM
otomobil	o AM t AC o AM m AE o AM b AG i AK l AD
padi	p AG a AK d AC i AK
padri	p AG a AK d AC r AN i AK
paduka	p AG a AK d AC u AM k AC a AK
pagu	p AG a AK ɡ AC u AM
pahala	p AG a AK h AA a AK l AD a AK
paham	p AG a AK h AA a AK m AE
pahlawan	p AG a AK h AA l AD a AK w AI a AK n AF
pala	p AG a AK l AD a AK
palu	p AG a AK l AD u AM
panas	p AG a AK n AF a AK s AH
pandemi	p AG a AK n AF d AC e AK m AE i AK
pandemik	p AG a AK n AF d AC e AK m AE ɪ AK k AC
panekuk	p AG a AK n AF ə AK k AC u AM k AC
pangkat	p AG a AK ŋ AF k AC a AK t AC
pangsit	p AG a AK ŋ AF s AH i AK t AC
panko	p AG a AK n AF k AC o AM
pap	p AG a AK p AG
papa	p AG a AK p AG a AK
pariwisata	p AG a AK r AN i AK w AI i AK s AH a AK t AC a AK
parlemen	p AG a AK r AN l AD ə AK m AE ɛ AK n AF
parlementer	p AG a AK r AN l AD ə AK m AE ɛ AK n AF t AC ɛ AK r AN
paroki	p AG a AK r AN o AM k AC i AK
partikelir	p AG a AK r AN t AC i AK k AC ə AK l AD ɪ AK r AN
pasar	p AG a AK s AH a AK r AN
pasien	p AG a AK s AH i AK ɛ AK n AF
paskah	p AG a AK s AH k AC a AK h AA
pasraman	p AG a AK s AH r AN a AK m AE a AK n AF
pastor	p AG a AK s AH t AC o AM r AN
pataka	p AG a AK t AC a AK k AC a AK
pejabat	p AG ə AK d AC ʒ AH a AK b AG a AK t AC
pek	p AG ɛ AK k AC
pekan	p AG ə AK k AC a AK n AF
pekerjaan	p AG ə AK k AC ə AK r AN d AC ʒ AH a AK ʔ AJ a AK n AF
pelacur	p AG ə AK l AD a AK t AC ʃ AH ʊ AM r AN
pelajar	p AG ə AK l AD a AK d AC ʒ AH a AK r AN
pelan	p AG ə AK l AD a AK n AF
peler	p AG ə AK l AD e AK r AN
pelopor	p AG ə AK l AD o AM p AG ɔ AM r AN
pemain	p AG ə AK m AE a AK i AK n AF
pembohong	p AG ə AK m AE b AG o AM h AA o AM n AF ɡ AC
pembunuh	p AG ə AK m AE b AG u AM n AF ʊ AM h AA
pemerintah	p AG ə AK m AE ə AK r AN i AK n AF t AC a AK h AA
pemerintahan	p AG ə AK m AE ə AK r AN i AK n AF t AC a AK h AA a AK n AF
penakut	p AG ə AK n AF a AK k AC u AM t AC
pencemaran	p AG ə AK n AF t AC ʃ AH ə AK m AE a AK r AN a AK n AF
penderita	p AG ə AK n AF d AC ə AK r AN i AK t AC a AK
pendeta	p AG ə AK n AF d AC ɛ AK t AC a AK
pendukung	p AG ə AK n AF d AC u AM k AC ʊ AM ŋ AF
pengairan	p AG ə AK ŋ AF a AK ʔ AJ ɪ AK r AN a AK n AF
penganiaya	p AG ə AK ŋ AF a AK n AF i AK a AK j AB a AK
penganiayaan	p AG ə AK ŋ AF a AK n AF i AK a AK j AB a AK a AK n AF
penggalian	p AG ə AK ŋ AF ɡ AC a AK l AD i AK a AK n AF
penggiling	p AG ə AK ŋ AF ɡ AC ɪ AK l AD ɪ AK ŋ AF
pengguna	p AG ə AK ŋ AF ɡ AC u AM n AF a AK
pengoplos	p AG ɘ AK ŋ AF o AM p AG l AD o AM s AH
penjagaan	p AG ə AK n AF d AC ʒ AH a AK ɡ AC a AK ʔ AJ a AK n AF
penuntut	p AG ə AK n AF u AM n AF t AC ʊ AM t AC
penyamaran	p AG ə AK ɲ AF a AK m AE a AK r AN a AK n AF
perambah	p AG ə AK r AN a AK m AE b AG a AK h AA
perang	p AG ə AK r AN a AK ŋ AF
perawat	p AG ə AK r AN a AK w AI a AK t AC
perban	p AG ə AK r AN b AG a AK n AF
percuma	p AG ə AK r AN t AC ʃ AH u AM m AE a AK
perdana	p AG ə AK r AN d AC a AK n AF a AK
perdata	p AG ə AK r AN d AC a AK t AC a AK
perdom	p AG ə AK r AN d AC ɔ AM m AE
pergi	p AG ə AK r AN ɡ AC i AK
perkara	p AG ə AK r AN k AC a AK r AN a AK
permainan	p AG ə AK r AN m AE a AK i AK n AF a AK n AF
permukaan	p AG ə AK r AN m AE u AM k AC a AK ʔ AJ a AK n AF
perpeloncoan	p AG ə AK r AN p AG ə AK l AD o AM n AF t AC ʃ AH o AM a AK n AF
persada	p AG ə AK r AN s AH a AK d AC a AK
persembahan	p AG ə AK r AN s AH ə AK m AE b AG a AK h AA a AK n AF
persen	p AG ə AK r AN s AH ə AK n AF
persneling	p AG ə AK r AN s AH ə AK n AF e AK l AD i AK ŋ AF
pertama	p AG ə AK r AN t AC a AK m AE a AK
pertiwi	p AG ə AK r AN t AC i AK w AI i AK
perut	p AG ə AK r AN ʊ AM t̚
pesumo	p AG ə AK s AH u AM m AE o AM
peta	p AG ə AK t AC a AK
pidana	p AG i AK d AC a AK n AF a AK
piket	p AG i AK k AC ɛ AK t̚
pikir	p AG i AK k AC ɪ AK r AN
pintu	p AG i AK n AF t AC u AM
pion	p AG i AK o AM n AF
pionir	p AG i AK o AM n AF ɪ AK r AN
pipi	p AG i AK p AG i AK
pisang	p AG i AK s AH a AK ŋ AF
pita	p AG i AK t AC a AK
plafon	p AG ə̆ BB l AD a AK f BA ɔ AM n AF
plak	p AG l AD a AK k AC
polis	p AG o AM l AD ɪ AK s AH
ponsel	p AG o AM n AF s AH ɛ AK l AD
potret	p AG o AM t AC r AN e AK t AC
pr	p AG ɛ AK ɛ AK r AN
prabu	p AG r AN a AK b AG u AM
prahara	p AG r AN a AK h AA a AK r AN a AK
prakerta	p AG r AN a AK k AC ə AK r AN t AC a AK
praktek	p AG r AN a AK k̚ t AC ɛ AK k̚
praktik	p AG r AN a AK k̚ t AC ɪ AK k̚
prasada	p AG r AN a AK s AH a AK d AC a AK
prei	p AG r AN e AK i AK
pria	p AG ə AK r AN i AK a̯
pribadi	p AG r AN i AK b AG a AK d AC i AK
produk	p AG r AN o AM d AC ʊ AM k AC
profesor	p AG r AN o AM f BA ɛ AK s AH ɔ AM r AN
proses	p AG r AN o AM s AH ɛ AK s AH
proyek	p AG r AN o AM j AB ɛ AK k AC
psikiater	p AG s AH i AK k AC i AK a AK t AC ə AK r AN
psikolog	p AG s AH i AK k AC o AM l AD o AM ɡ AC
puja	p AG u AM d AC ʒ AH a AK
puji	p AG u AM d AC ʒ AH i AK
punia	p AG u AM n AF i AK a̯
pura	p AG u AM r AN a AK
puri	p AG u AM r AN i AK
puspa	p AG ʊ AM s AH p AG a AK
q	k AC i AK
qanun	q AC a AK n AF u AM n AF
raga	r AN a AK ɡ AC a AK
ramal	r AN a AK m AE a AK l AD
ranjang	r AN a AK ɲ AF d AC ʒ AH a AK ŋ AF
ransel	r AN a AK n AF s AH ə AK l AD
rapi	r AN a AK p AG i AK h AA
rasa	r AN a AK s AH a AK
rasuah	r AN a AK s AH u AM a AK h AA
ratu	r AN a AK t AC u AM
rawat	r AN a AK w AI a AK t AC
realitas	r AN e AK a AK l AD i AK t AC a AK s AH
reanimasi	r AN e AK a AK n AF i AK m AE a AK s AH i AK
rekayasa	r AN e AK k AC a AK j AB a AK s AH a AK
rekening	r AN ɛ AK k AC ə AK n AF i AK ŋ AF
reksa	r AN ə AK k AC s AH a AK
rektor	r AN ɛ AK k AC t AC o AM r AN
rem	r AN ɛ AK m AE
rengo	r AN e AK n AF ɡ AC o AM
renten	r AN ɛ AK n AF t AC ə AK n AF
resep	r AN ə AK s AH ɛ AK p AG
resi	r AN ə AK s AH i AK
resmi	r AN ə AK s AH m AE i AK
resusitasi	r AN e AK s AH u AM s AH i AK t AC a AK s AH i AK
retensi	r AN ə AK t AC ɛ AK n AF s AH i AK
rezeki	r AN ə AK z AH ə AK k AC i AK
riba	r AN i AK b AG a AK
risiko	r AN i AK s AH i AK k AC o AM
riskan	r AN i AK s AH k AC a AK n AF
ritme	r AN i AK t AC m AE ə AK
rokade	r AN o AM k AC a AK d AC ə AK
roman	r AN o AM m AE a AK n AF
romusa	r AN o AM m AE u AM s AH a AK
romusha	r AN o AM m AE u AM ʃ AH a AK
romusya	r AN o AM m AE u AM ʃ AH a AK
rusak	r AN u AM s AH a AK ʔ AJ
saat	s AH a AK ʔ AJ a AK t AC
sabi	s AH a AK b AG i AK
sabit	s AH a AK b AG i AK t AC
sabo	s AH a AK b AG o AM
sabun	s AH a AK b AG u AM n AF
sabung	s AH a AK b AG ʊ AM ŋ AF
sadar	s AH a AK d AC a AK r AN
sadu	s AH a AK d AC u AM
sahaya	s AH a AK h AA a AK j AB a AK
saja	s AH a AK d AC ʒ AH a AK
saka	s AH a AK k AC a AK
sake	s AH a AK k AC e AK
sakelar	s AH a AK k AC ə AK l AD a AK r AN
sakit	s AH a AK k AC i AK t AC
sakti	s AH a AK k AC t AC i AK
sal	s AH a AK l AD
sala	s AH a AK l AD a AK
salah	s AH a AK l AD a AK h AA
sama	s AH a AK m AE a AK
sambung	s AH a AK m AE b AG ʊ AM ŋ AF
samcan	s AH a AK m AE t AC ʃ AH a AK n AF
samsek	s AH a AK m AE s AH ə AK k AC
samurai	s AH a AK m AE u AM r AN a AK i AK
sancan	s AH a AK ɲ AF t AC ʃ AH a AK n AF
sangat	s AH a AK ŋ AF a AK t AC
sangga	s AH a AK ŋ AF ɡ AC a AK
sangka	s AH a AK ŋ AF k AC a AK
sangsi	s AH a AK ŋ AF s AH i AK
sanksi	s AH a AK ŋ AF s AH i AK
sarana	s AH a AK r AN a AK n AF a AK
sasana	s AH a AK s AH a AK n AF a AK
satori	s AH a AK t AC o AM r AN i AK
satu	s AH a AK t AC u AM
satuan	s AH a AK t AC u AM a AK n AF
satwa	s AH a AK t̚ w AI a AK
saudara	s AH a AK u̯ AI d AC a AK r AN a AK
saudari	s AH a AK u̯ AI d AC a AK r AN i AK
saya	s AH a AK j AB a AK
sedap	s AH ə AK d AC a AK p̚
segel	s AH ɛ AK ɡ AC ə AK l AD
sehat	s AH ɛ AK h AA a AK t̚
sein	s AH e AK ɪ̯ AB n AF
seinendan	s AH e AK i AK n AF e AK n AF d AC a AK n AF
sekak	s AH ə AK k AC a AK k AC
sekali	s AH ə AK k AC a AK l AD i AK
seko	s AH ɛ AK k AC o AM
sekong	s AH e AK k AC o AM ŋ AF
sekring	s AH e AK k AC r AN ɪ AK ŋ AF
sekrup	s AH ə AK k AC r AN u AM p AG
seksi	s AH ɛ AK k AC s AH i AK
sekunder	s AH ə AK k AC ʊ AM n AF d AC ɛ AK r AN
selada	s AH a AK l AD a AK d AC a AK
selalu	s AH ə AK l AD a AK l AD u AM
semangka	s AH ə AK m AE a AK ŋ AF k AC a AK
sembuh	s AH e AK m AE b AG u AM h AA
semen	s AH ɛ AK m AE ɛ AK n AF
seminar	s AH ə AK m AE i AK n AF a AK r AN
seminari	s AH ɛ AK m AE i AK n AF a AK r AN i AK
semir	s AH ə AK m AE i AK r AN
sempoa	s AH ə AK m AE p AG o AM a AK
sempurna	s AH ə AK m AE p AG u AM r AN n AF a AK
semua	s AH ə AK m AE u AM a AK
sendratari	s AH ə AK n AF d AC r AN a AK t AC a AK r AN i AK
sengsai	s AH ɛ AK ŋ AF s AH a AK i AK
sengsara	s AH ə AK ŋ AF s AH a AK r AN a AK
senin	s AH ə AK n AF ɪ AK n AF
sensei	s AH e AK n AF s AH e AK i AK
senter	s AH ɛ AK n AF t AC ə AK r AN
sentosa	s AH ə AK n AF t AC o AM s AH a AK
sentral	s AH ɛ AK n AF t AC r AN a AK l AD
seorang	s AH ə AK o AM r AN a AK ŋ AF
sepatu	s AH ə AK p AG a AK t AC u AM
sepeda	s AH ə AK p AG ɛ AK d AC a AK
seprai	s AH ə AK p AG r AN a AK i AK
seprei	s AH ə AK p AG r AN e AK i AK
september	s AH ɛ AK p̚ t AC ɛ AK m AE b AG ə AK r AN
sepur	s AH ə AK p AG u AM r AN
serdadu	s AH ə AK r AN d AC a AK d AC u AM
seremoni	s AH e AK r AN e AK m AE o AM n AF i AK
seri	s AH ə AK r AN i AK
sertifikat	s AH e AK r AN t AC i AK p AG i AK k AC a AK t AC
setolop	s AH ə AK t AC ɔ AM l AD ɔ AM p AG
setra	s AH ɛ AK t AC r AN a AK
setrap	s AH ə AK t AC r AN a AK p AG
setrum	s AH ə AK t AC r AN ʊ AM m AE
setuju	s AH ə AK t AC u AM d AC ʒ AH u AM
shinto	ʃ AH i AK n AF t AC o AM
shogun	ʃ AH o AM ɡ AC u AM n AF
sialan	s AH i AK a AK l AD a AK n AF
sijil	s AH i AK d AC ʒ AH ɪ AK l AD
silam	s AH i AK l AD a AK m AE
singapura	s AH i AK ŋ AF a AK p AG u AM r AN a AK
singgasana	s AH i AK ŋ AF ɡ AC a AK s AH a AK n AF a AK
singse	s AH i AK ŋ AF s AH ə AK
sini	s AH i AK n AF i AK
sinse	s AH i AK n AF s AH e AK
sipil	s AH i AK p AG ɪ AK l AD
sirkuler	s AH ɪ AK r AN k AC u AM l AD ɛ AK r AN
skala	s AH ə̆ BB k AC a AK l AD a AK
skalar	s AH k AC a AK l AD a AK r AN
skema	s AH ə AK k AC e AK m AE a AK
skim	s AH ə AK k AC ɪ AK m AE
slang	s AH ə AK l AD a AK ŋ AF
soang	s AH o AM a̯ ŋ AF
soba	s AH o AM b AG a AK
sopir	s AH o AM p AG ɪ AK r AN
spanduk	s AH ə AK p AG a AK n AF d AC ʊ AM k̚
spaning	s AH p AG a AK n AF i AK ŋ AF
sporadis	s AH p AG o AM r AN a AK d AC ɪ AK s AH
sprei	s AH ə AK p AG r AN e AK i AK
sri	s AH ə AK r AN i AK
staf	s AH t AC a AK f BA
stasi	s AH t AC a AK s AH i AK
stasiun	s AH ə̆ BB t AC a AK s AH i AK u AM n AF
steker	a AK b AG o AM n AF ə AK m AE ɛ AK n AF
step	s AH ə AK t AC ɛ AK p AG
stoples	s AH ə AK t AC ɔ AM p AG l AD ɛ AK s AH
stroberi	s AH t AC r AN o AM b AG ɛ AK r AN i AK
struktur	s AH t AC r AN ʊ AM k AC t AC ʊ AM r AN
suami	s AH u AM a̯ m AE i AK
suara	s AH u AM a AK r AN a AK
subuco	s AH u AM b AG u AM t AC ʃ AH o AM
suci	s AH u AM t AC ʃ AH i AK
sudoku	s AH u AM d AC o AM k AC u AM
suf	s AH ʊ AM f BA
suiseki	s AH u AM i AK s AH e AK k AC i AK
suka	s AH u AM k AC a AK
sumber	s AH ʊ AM m AE b AG ə AK r AN
sumo	s AH u AM m AE o AM
sungai	s AH u AM ŋ AF a AK i̯ AB
surabaya	s AH u AM r AN a AK b AG a AK j AB a AK
surakarta	s AH u AM r AN a AK k AC a AK r AN t AC a AK
surga	s AH u AM r AN ɡ AC a AK
survei	s AH ʊ AM r AN v BA e AK i̯ AB
surya	s AH u AM r AN j AB a AK
suster	s AH u AM s AH t AC ə AK r AN
susyi	s AH u AM ʃ AH i AK
sutra	s AH u AM t AC r AN a AK
swafoto	s AH w AI a AK f BA o AM t AC o AM
swasembada	s AH w AI a AK s AH ə AK m AE b AG a AK d AC a AK
swasta	s AH w AI a AK s AH t AC a AK
swatantra	s AH ʋ AI a AK t AC a AK n AF t AC r AN a AK
syah	ʃ AH a AK h AA
syahadat	ʃ AH a AK h AA a AK d AC a AK t̚
syahbandar	ʃ AH a AK h AA b AG a AK n AF d AC a AK r AN
syogun	ʃ AH ɔ AM ɡ AC u AM n AF
syuriken	ʃ AH u AM r AN i AK k AC ɛ AK n AF
tabel	t AC a AK b AG ɛ AK l AD
tabelaris	t AC a AK b AG ə AK l AD a AK r AN ɪ AK s AH
tabib	t AC a AK b AG ɪ AK p̚
tahu	t AC a AK ʊ AM
tahun	t AC a AK h AA ʊ AM n AF
taiso	t AC a AK i AK s AH o AM
takal	t AC a AK k AC a AK l AD
takeyari	t AC a AK k AC e AK y AM a AK r AN i AK
takhta	t AC a AK x AH t AC a AK
takoyaki	t AC a AK k AC o AM j AB a AK k AC i AK
takraw	t AC a AK k̚ r AN a AK w AI
taksi	t AC a AK k̚ s AH i AK
takut	t AC a AK k AC u AM t AC
tampil	t AC a AK m AE p AG i AK l AD
tanah	t AC a AK n AF a AK h AA
tangan	t AC a AK ŋ AF a AK n AF
tangki	t AC a AK ŋ AF k AC i AK
tank	t AC ɛ AK ŋ AF k AC
tante	t AC a AK n AF t AC ə AK
tanya	t AC a AK ɲ AF a AK
tapa	t AC a AK p AG a AK
tar	t AC a AK r AN
taring	t AC a AK r AN ɪ AK ŋ AF
taruna	t AC a AK r AN u AM n AF a AK
tas	t AC a AK s AH
tatap	t AC a AK t AC a AK p̚
tau	t AC a AK ʊ AM
tebusan	t AC ə AK b AG u AM s AH a AK n AF
teh	t AC ɛ AK h AA
tekidanto	t AC ɛ AK k AC i AK d AC a AK n AF t AC o AM
tekor	t AC ə AK k AC o AM r AN
telaah	t AC ə AK l AD a AK a AK h AA
telaga	t AC ə AK l AD a AK ɡ AC a AK
telepon	t AC ɛ AK l AD ɛ AK p AG ɔ AM n AF
televisi	t AC e AK l AD e AK v BA i AK s AH i AK
tembak	t AC e AK m AE b AG a AK k AC
tempat	t AC ə AK m AE p AG a AK t AC
tempo	t AC e AK m AE p AG o AM
tempura	t AC ə AK m AE p AG u AM r AN a AK
temu	t AC ə AK m AE u AM
tensi	t AC ɛ AK n AF s AH i AK
tentang	t AC ə AK n AF t AC a AK ŋ AF
tentara	t AC ə AK n AF t AC a AK r AN a AK
teori	t AC e AK o AM r AN i AK
tepat	t AC ə AK p AG a AK t AC
ter	t AC ɛ AK r AN
teraniaya	t AC ə AK r AN a AK n AF i AK a AK j AB a AK
terbang	t AC ə AK r AN b AG a AK ŋ AF
terbesar	t AC ə AK r AN b AG ə AK s AH a AK r AN
terein	t AC ə AK r AN e AK ɪ AK n AF
teriyaki	t AC ɛ AK r AN i AK j AB a AK k AC i AK
terjemah	t AC ɛ AK r AN d AC ʒ AH ɛ AK m AE a AK h AA
terkenal	t AC ə AK r AN k AC ə AK n AF a AK l AD
terlalu	t AC ə AK r AN l AD a AK l AD u AM
terwelu	t AC ə AK r AN w AI ɛ AK l AD u AM
tidur	t AC i AK d AC u AM r AN
tiga	t AC i AK ɡ AC a AK
timbal	t AC i AK m AE b AG a AK l AD
timbel	t AC i AK m AE b AG ə AK l AD
timur	t AC i AK m AE ʊ AM r AN
tindakan	t AC ɪ AK n AF d AC a AK k AC a AK n AF
tinggal	t AC i AK ŋ AF ɡ AC a AK l AD
tinggi	t AC i AK ŋ AF ɡ AC i AK
tinta	t AC i AK n AF t AC a AK
tipu	t AC i AK p AG u AM
tirani	t AC i AK r AN a AK n AF i AK
tirta	t AC i AK r AN t AC a AK
tobang	t AC o AM b AG a AK ŋ AF
tobiko	t AC o AM b AG i AK k AC o AM
tofu	t AC o AM f BA u AM
toh	t AC o AM h AA
toilet	t AC o AM i̯ AB l AD ɛ AK t̚
toko	t AC o AM k AC o AM
tol	t AC o AM l AD
toto	t AC o AM t AC o AM
tren	t AC r AN ɛ AK n AF
tromol	t AC r AN o AM m AE o AM l AD
tsuru	ʃ AH u AM r AN u AM
tua	t AC u AM a AK
tuas	t AC u AM a AK s AH
tugas	t AC u AM ɡ AC a AK s AH
tuhan	t AC u AM h AA a AK n AF
tukang	t AC u AM k AC a AK ŋ AF
tumbuhan	t AC u AM m AE b AG u AM h AA a AK n AF
tuntut	t AC u AM n AF t AC ʊ AM t AC
tustel	t AC u AM s AH t AC ɛ AK l AD
udon	u AM d AC o AM n AF
umami	u AM m AE a AK m AE i AK
umur	u AM m AE ʊ AM r AN
unggul	u AM ŋ AF ɡ AC ʊ AM l AD
unta	ʊ AM n AF t AC a AK
untung	u AM n AF t AC ʊ AM ŋ AF
upacara	u AM p AG a AK t AC ʃ AH a AK r AN a AK
upawasa	u AM p AG a AK w AI a AK s AH a AK
upaya	u AM p AG a AK j AB a AK
usada	u AM s AH a AK d AC a AK
usang	u AM s AH a AK ŋ AF
uskup	u AM s AH k AC ʊ AM p AG
utama	ʊ AM t AC a AK m AE a AK
utan	u AM t AC a AK n AF
utara	u AM t AC a AK r AN a AK
vetsin	v BA ɛ AK t AC ʃ AH i AK n AF
visite	v BA i AK s AH i AK t AC ə AK
vokal	v BA o AM k AC a AK l AD
w	w AI ɛ AK
waduh	w AI a AK d AC ʊ AM h AA
wafat	w AI a AK f BA a AK t̚
wagyu	w AI a AK ɡʲ AC u AM
wahana	w AI a AK h AA a AK n AF a AK
wajah	w AI a AK d AC ʒ AH a AK h AA
wajib	w AI a AK d AC ʒ AH ɪ AK p AG
waktu	w AI a AK k AC t AC u AM
wali	w AI a AK l AD i AK
wana	w AI a AK n AF a AK
wanara	w AI a AK n AF a AK r AN a AK
wangsa	w AI a AK ŋ AF s AH a AK
wanita	w AI a AK n AF i AK t AC a AK
wanprestasi	w AI a AK n AF p AG r AN e AK s AH t AC a AK s AH i AK
warsa	w AI a AK r AN s AH a AK
waruna	w AI a AK r AN u AM n AF a AK
wasabi	w AI a AK s AH a AK b AG i AK
wasbak	w AI a AK s AH b AG a AK k̚
wastafel	w AI a AK s AH t AC a AK f BA ə AK l AD
wayang	w AI a AK j AB a AK ŋ AF
wazari	w AI a AK z AH a AK r AN i AK
weker	w AI ɛ AK k AC ə AK r AN
wibu	w AI i AK b AG u AM
wicara	w AI i AK t AC ʃ AH a AK r AN a AK
widyaiswara	w AI i AK t AC j AB a AK i AK s AH ʋ AI a AK r AN a AK
wihara	w AI i AK h AA a AK r AN a AK
wilapa	w AI i AK l AD a AK p AG a AK
wilayah	w AI i AK l AD aː AL y AM ɑː AL
wira	w AI i AK r AN a AK
wol	w AI ɔ AM l AD
wortel	w AI o AM r AN t AC ə AK l AD
wreda	w AI r AN ə AK d AC a AK
x	ɛ AK k AC s AH
yakitori	j AB a AK k AC i AK t AC o AM r AN i AK
yen	j AB ɛ AK n AF
yogyakarta	j AB o AM ɡ AC j AB a AK k AC a AK r AN t AC a AK
yudisium	j AB u AM d AC i AK s AH i AK ʊ AM m AE
yuyitsu	j AB u AM j AB i AK t AC s AH u AM
zen	z AH ɛ AK n AF
