abad	a AD b a AD t̚
abdi	a AD b d i AD
abdis	a AD b d ɪ AD s
abi	a AD b i AD
abiseka	a AD b i AD s e AD k a AD
abonemen	a AD b o AF n ə AD m ɛ AD n
abras	a AD b r a AD s
absolusi	a AD b s o AF l u AF s i AD
abstain	a AD p̚ s t a AD i AD n
abu	a AD b u AF
aceh	a AD t ʃ e AD h AA
aci	a AD t ʃ i AD
acik	a AD t ʃ ɪ AD ʔ
ada	a AD d a AD
adalah	a AD d a AD l a AD h AA
adaptif	a AD d a AD p t ɪ AD f
adat	a AD d a AD t
adempauze	a AD d ə AD m p a AD u̯ AI z ə AD
adikara	a AD d i AD k a AD r a AD
adil	a AD d i AD l
administrator	a AD t̚ m i AD n ɪ AD s t r a AD t ɔ AF r
administratur	a AD t̚ m i AD n ɪ AD s t r a AD t ʊ AF r
adoptif	a AD d ɔ AF p t ɪ AD f
adpis	a AD t̚ p ɪ AD s
advis	a AD t̚ v i AD s
afdeling	a AD f d e AD l i AD ŋ
agape	a AD ɡ a AD p e AD
agen	a AD ɡ ɛ AD n
agresi	a AD ɡ r ɛ AD s i AD
agustus	a AD ɡ ʊ AF s t ʊ AF s
ahli	a AD h AA l i AD
aib	aʲ AD i AD b
aikido	aʲ AD i AD k i AD d o AF
air	a AD ʔ ɪ AD r
ajar	a AD d ʒ a AD r
akademi	a AD k a AD d e AD m i AD
akademis	a AD k a AD d e AD m i AD s
akan	a AD k a AD n
akang	a AD k a AD ŋ
akar	a AD k a AD r
akeo	a AD k e AD o AF
akil	a AD k ɪ AD l
aksa	a AD k̚ s a AD
aksara	a AD k s a AD r a AD
akselerasi	a AD k s e AD l ə AD r a AD s i AD
akta	a AD k̚ t a AD
akte	a AD k̚ t ə AD
aktif	a AD k̚ t ɪ AD p
aktifitas	a AD k̚ t i AD f i AD t a AD s
aktivasi	a AD k̚ t i AD v a AD s i AD
aktivis	a AD k̚ t i AD v ɪ AD s
aktivisme	a AD k̚ t i AD v ɪ AD s m ə AD
aktivitas	a AD k̚ t i AD v i AD t a AD s
aku	a AD k u AF
akur	a AD k u AF r
akut	a AD k u AF t
alas	a AD l a AD s
alat	a AD b o AF n ə AD m ɛ AD n
algojo	a AD l ɡ o AF d ʒ o AF
aliah	a AD l i AD a AD h AA
aliansi	a AD l i AD a AD n s i AD
aliase	a AD l i AD a AD s ə AD
alkali	a AD l k a AD l i AD
allah	a AD l l a AD h AA
aloi	a AD l o AF i̯ AH
alpa	a AD l p a AD
alpukat	a AD l p u AF k a AD t
altar	a AD l t a AD r
am	a AD m
amah	a AD m a AD h AA
aman	a AD m a AD n
amar	a AD m a AD r
ambasade	a AD m b a AD s a AD d ə AD
amerta	a AD m ə AD r t a AD
amin	a AD m ɪ AD n
ampul	a AD m p ʊ AF l
amra	a AD m r a AD
anak	a AD n a AD ʔ
analisis	a AD n a AD l i AD s ɪ AD s
ancala	a AD n t ʃ a AD l a AD
ancaman	a AD n t ʃ a AD m a AD n
anda	a AD n d a AD
andaka	n a AD n d a AD k a AD
aneka	a AD n ɛ AD k a AD
anfal	a AD n f a AD l
angciu	a AD ŋ t ʃ i AD u AF
anggara	a AD ŋ ɡ a AD r a AD
anghun	a AD ŋ h AA u AF n
angka	a AD ŋ k a AD
angkak	a AD ŋ k a AD k
angkasa	a AD ŋ k a AD s a AD
angkasawan	a AD ŋ k a AD s a AD w AC a AD n
angkur	a AD ŋ k ʊ AF r
angkusa	a AD ŋ k u AF s a AD
anglo	a AD ŋ l o AF
anglung	a AD ŋ l u AF ŋ
angpao	a AD ŋ p a AD o AF
angpau	a AD ŋ p a AD u̯ AI
angsa	a AD ŋ s a AD
aniaya	a AD n i AD a AD j AB a AD
animasi	a AD n i AD m a AD s i AD
ansos	a AD n s o AF s
antarbangsa	a AD n t a AD r b a AD ŋ s a AD
antariksawan	a AD n t a AD r ɪ AD k s a AD w AC a AD n
antik	a AD n t i AD k
anumerta	a AD n u AF m ə AD r t a AD
apa	a AD p a AD
apak	a AD p a AD ʔ
apakah	a AD p a AD k a AD h AA
apanase	a AD p a AD n a AD s ə AD
aparat	a AD p a AD r a AD t
apek	a AD p ɛ AD k
api	a AD p i AD
aplaus	a AD p l a AD u AF s
apologi	a AD p o AF l o AF ɡ i AD
apologia	a AD p o AF l o AF ɡ i AD a AD
apotek	a AD p o AF t e AD k
april	a AD p̚ r ɪ AD l
apsara	a AD p s a AD r a AD
arak	a AD r a AD k
arbei	a AD r b e AD i̯ AH
arit	a AD r i AD t
arkais	a AD r k a AD i AD s
arloji	a AD r l o AF d ʒ i AD
arsip	a AD r s i AD p
arta	a AD r t a AD
arti	a AD r t i AD
arya	a AD r j AB a AD
asbak	a AD s b a AD k
asesmen	a AD s ɛ AD s m ə AD n
askese	a AD s k e AD s ə AD
asma	a AD s m a AD
asmara	a AD s m a AD r a AD
aspal	a AD s p a AD l
asrama	a AD s r a AD m a AD
astana	a AD s t a AD n a AD
astronaut	a AD s t r o AF n ɔ AF t̚
asumsi	a AD s ʊ AF m s i AD
aswa	a AD s w AC a AD
asyik	a AD ʃ ɪ AD k
atau	a AD t a AD u̯ AI
atma	a AD t m a AD
auban	a AD u AF b a AD n
autokrasi	a AD u AF t o AF k r a AD s i AD
autokrat	a AD u AF t o AF k r a AD t̚
avatar	a AD v a AD t a AD r
avokad	a AD v o AF k a AD d
avtur	a AD v t ʊ AF r
awak	a AD w AC a AD ʔ
awat	a AD w AC a AD t
ayah	a AD j AB a AD h AA
ayam	a AD j AB a AD m
ayo	a AD j AB o AF
babi	b a AD b i AD
baca	b a AD t ʃ a AD
bacang	b a AD t ʃ a AD ŋ
bagai	b a AD ɡ a AD i̯ AH
bagi	b a AD ɡ i AD
bagian	b a AD ɡ i AD a AD n
baginda	b a AD ɡ i AD n d a AD
bahana	b a AD h AA a AD n a AD
bahasa	b a AD h AA a AD s a AD
bahaya	b a AD h AA a AD j AB a AD
bahtera	b a AD h AA t ə AD r a AD
bahwa	b a AD h AA w AC a AD
baiduri	b a AD i̯ AH d u AF r i AD
baja	b a AD d ʒ a AD
bajingan	b a AD d ʒ i AD ŋ a AD n
bak	b ɑ AD k
bakcang	b a AD ʔ t ʃ a AD ŋ
bakero	b a AD k e AD r o AF
baki	b a AD k i AD
bakiak	b a AD k i AD a AD k
bakmi	b a AD k m i AD
bakpao	b a AD ʔ p a AD o AF
bakpau	b a AD k p a AD ʊ̯ AI
bakpia	b a AD ʔ p i AD a̯
bakso	b a AD ʔ s o AF
baktau	b a AD k t a AD ʊ̯ AI
bakti	b a AD k t i AD
bakwan	b a AD ʔ w AC a AD n
bala	b a AD l a AD
balai	b a AD l a AD i̯ AH
bali	b a AD l i AD
balot	b a AD l ɔ AF t̚
banci	b a AD n t ʃ i AD
bandara	b a AD n d a AD r a AD
banding	b a AD n d i AD ŋ
bang	b a AD ŋ
bangku	b a AD ŋ k u AF
bangsa	b a AD ŋ s a AD
bangsat	b a AD ŋ s a AD t
bangsi	b a AD ŋ s i AD
banji	b a AD n d ʒ i AD
bank	b a AD ŋ
banyak	b a AD ɲ a AD k
banzai	b a AD n z a AD i̯ AH
bapa	b a AD p a AD
bapak	b a AD p a AD ʔ
bapao	b a AD p a AD o AF
barang	b a AD r a AD ŋ
barikade	b a AD r i AD k a AD d ə AD
barongsai	b a AD r o AF ŋ s a AD i̯ AH
baronsai	b a AD r o AF n s a AD i̯ AH
baruna	b a AD r u AF n a AD
baskara	b a AD s k a AD r a AD
basket	b a AD s k ɛ AD t̚
basmi	b a AD s m i AD
batang	b a AD t a AD ŋ
batangan	b a AD t a AD ŋ a AD n
batara	b a AD t a AD r a AD
batau	b a AD t a AD ʊ̯ AI
batavia	b a AD t a AD v i AD a̯
batik	b a AD t ɪ AD k
bausastra	b a AD u AF s a AD s t r a AD
baya	b a AD j AB a AD
bayangkara	b a AD j AB a AD ŋ k a AD r a AD
bayu	b a AD j AB u AF
bazar	b a AD z a AD r
bea	b e AD a AD
beasiswa	b e AD a AD s ɪ AD s w AC a AD
begawan	b ə AD ɡ a AD w AC a AD n
beha	b e AD h AA a AD
bel	b ɛ AD l
bela	b ɛ AD l a AD
belajar	b ə AD l a AD d ʒ a AD r
belalai	b ə AD l a AD l a AD i̯ AH
belanda	b ə AD l a AD n d a AD
belanja	b ə AD l a AD n d ʒ a AD
belanjaan	b ə AD l a AD n d ʒ a AD ʔ a AD n
belantara	b ə AD l a AD n t a AD r a AD
belasting	b ə AD l a AD s t i AD ŋ
beleid	b ə AD l ɛ AD ɪ AD t̚
belia	b ə AD l i AD a̯
beliau	b ə AD l i AD a AD u̯ AI
belom	b ə AD l ʌ AD m
belum	b ə AD l ʊ AF m
bencong	b ɛ AD n t ʃ o AF ŋ
benda	b ə AD n d a AD
bendahara	b ə AD n d a AD h AA a AD r a AD
bendel	b ə AD n d ə AD l
bendera	b ə AD n d ɛ AD r a AD
bengawan	b ə AD ŋ a AD w AC a AD n
bengkel	b ɛ AD ŋ k ɛ AD l
benih	b ə AD n ɪ AD h AA
benteng	b e AD n t e AD ŋ
benzol	b e AD n z o AF l
berada	b ə AD r a AD d a AD
berangkat	b ə AD r a AD ŋ k a AD t
berapa	b ə AD r a AD p a AD
berbahaya	b ə AD r b a AD h AA a AD j AB a AD
berbicara	b ə AD r b i AD t ʃ a AD r a AD
beri	b ə AD r i AD
berida	b ə AD r i AD d a AD
berjibaku	b ə AD r d ʒ i AD b a AD k u AF
berteori	b ə AD r t e AD o AF r i AD
beruang	b ə AD r u AF a̯ ŋ
besar	b ə AD s a AD r
besikal	b ə AD s i AD k a AD l
beskal	b ə AD s k a AD l
bestari	b ə AD s t a AD r i AD
betawi	b ə AD t a AD w AC i AD
beton	b ə AD t o AF n
bhayangkara	bʰ a AD j AB a AD ŋ k a AD r a AD
biara	b i AD a AD r a AD
biasa	b i AD a AD s a AD
biaya	b i AD a AD j AB a AD
bibel	b i AD b ə AD l
bicara	b i AD t ʃ a AD r a AD
bidadari	b i AD d a AD d a AD r i AD
bidak	b i AD d a AD k
bidan	b i AD d a AD n
bihun	b i AD h AA u AF n
bijak	b i AD d ʒ a AD k
bijaksana	b i AD d ʒ a AD k s a AD n a AD
biji	b i AD d ʒ i AD
biksu	b i AD k s u AF
biku	b i AD k u AF
bila	b i AD l a AD
binasa	b i AD n a AD s a AD
binatang	b i AD n a AD t a AD ŋ
bintara	b i AD n t a AD r a AD
bioskop	b i AD o AF s k o AF p
biro	b i AD r o AF
blangko	b ə̆ AG l a AD ŋ k o AF
blek	b l ɛ AD k
blumbak	b l ʊ AF m b a AD k̚
bodo	b o AF d o AF
bohong	b o AF h AA o AF n ɡ
boleh	b o AF l e AD h AA
bon	b ɔ AF n
bonsai	b o AF n s a AD i AD
bor	b o AF r
borang	b ɔ AF r a AD ŋ
bordil	b o AF r d ɪ AD l
brankar	b r a AD n k a AD r
bruder	b r u AF d ə AD r
buana	b u AF a̯ n a AD
budak	b u AF d a AD ʔ
budaya	b u AF d a AD j AB a AD
budi	b u AF d i AD
budiman	b u AF d i AD m a AD n
bujangga	b u AF d ʒ a AD ŋ ɡ a AD
bukti	b u AF k t i AD
buku	b u AF k u AF
bulan	b u AF l a AD n
bumi	b u AF m i AD
bumiputra	b u AF m i AD p u AF t ə AD r a AD
buncis	b u AF n t ʃ ɪ AD s
bundel	b ʊ AF n d ə AD l
bunga	b u AF ŋ a AD
bunting	b ʊ AF n t ɪ AD ŋ
bunuh	b u AF n ʊ AF h AA
bupati	b u AF p a AD t i AD
bus	b u AF s
busa	b u AF s a AD
busana	b u AF s a AD n a AD
bushido	b u AF ʃ i AD d o AF
busyido	b u AF ʃ i AD d o AF
buta	b u AF t a AD
butala	b u AF t a AD l a AD
butuh	b u AF t u AF h AA
cabai	t ʃ a AD b e AD ʔ
cadar	t ʃ a AD d a AD r
cahaya	t ʃ a AD h AA a AD j AB a AD
cairan	t ʃ a AD ɪ AD r a AD n
cakra	t ʃ a AD k ə AD r a AD
cakram	t ʃ a AD k r a AD m
cakrawala	t ʃ a AD k r a AD w AC a AD l a AD
cakrawati	t ʃ a AD k r a AD w AC a AD t i AD
calon	t ʃ a AD l o AF n
camat	t ʃ a AD m a AD t̚
candra	t ʃ a AD n d r a AD
canoyu	t ʃ a AD n o AF j AB u AF
cantik	t ʃ a AD n t i AD k
cara	t ʃ a AD r a AD
cari	t ʃ a AD r i AD
catur	t ʃ a AD t u AF r
cedera	t ʃ ə AD d ə AD r a AD
cela	t ʃ ə AD l a AD
celaka	t ʃ ə AD l a AD k a AD
celeng	c ɛ AD l ɛ AD ŋ
celengan	c ɛ AD l ɛ AD ŋ a AD n
cempaka	t ʃ ə AD m p a AD k a AD
cenangga	t ʃ ə AD n a AD ŋ ɡ a AD
cendala	t ʃ ə AD n d a AD l a AD
cendana	t ʃ ə AD n d a AD n a AD
cendekia	c ə AD n d ə AD k i AD a AD
cendera	t ʃ ə AD n d ə AD r a AD
cenderasa	t ʃ ə AD n d ə AD r a AD s a AD
cenderawasih	t ʃ ə AD n d ə AD r a AD w AC a AD s i AD h AA
cengkerama	t ʃ ə AD ŋ k ə AD r a AD m a AD
cengkerawak	t ʃ ə AD ŋ k ə AD r a AD w AC a AD k
cerana	t ʃ ə AD r a AD n a AD
cerca	t ʃ ə AD r t ʃ a AD
ceria	t ʃ ə AD r i AD a AD
cerita	t ʃ ə AD r i AD t a AD
cerutu	t ʃ ə AD r u AF t u AF
cetera	t ʃ ə AD t ə AD r a AD
cewek	t ʃ e AD w AC e AD ʔ
china	t ʃ ɪ AD n a AD
cita	t ʃ i AD t a AD
citra	t ʃ i AD t r a AD
ciu	t ʃ i AD u AF
cokelat	t ʃ ɔ AF k ə AD l a AD t
coker	t ʃ o AF k ə AD r
coli	t ʃ o AF l i AD
colmek	t ʃ o AF l m ɛ AD k
cowok	t ʃ o AF w AC o AF ʔ
cuaca	t ʃ u AF a AD t ʃ a AD
cuek	c u AF e AD ʔ
cuka	t ʃ u AF k a AD
cula	t ʃ u AF l a AD
cultuurstelsel	k ʊ AF l t ʊ AF r s t ɛ AD l s ə AD l
cuma	t ʃ u AF m a AD
curiga	t ʃ u AF r i AD ɡ a AD
dadih	d a AD d i AD h AA
daerah	d a AD e AD r a AD h AA
dahaga	d a AD h AA a AD ɡ a AD
daidan	d a AD i AD d a AD n
daidanco	d a AD i AD d a AD n t ʃ o AF
daitia	d a AD i AD t i AD a AD
daksina	d a AD k s i AD n a AD
daku	d a AD k u AF
dalam	d a AD l a AD m
dan	d a AD n
dana	d a AD n a AD
danau	d a AD n a AD u̯ AI
dansa	d a AD n s a AD
danta	d a AD n t a AD
dari	d a AD r i AD
daring	d a AD r ɪ AD ŋ
darma	d a AD r m a AD
datang	d a AD t a AD ŋ
datu	d a AD t u AF
dawat	d a AD w AC a AD t
daya	d a AD j AB a AD
dekan	d ɛ AD k a AD n
dekat	d ə AD k a AD t
delesi	d e AD l e AD s i AD
dengan	d ə AD ŋ a AD n
dengar	d ə AD ŋ a AD r
derita	d ə AD r i AD t a AD
desember	d e AD s ɛ AD m b ə AD r
detail	d ə AD t a AD ɪ AD l
devosi	d e AD v o AF s i AD
dewa	d ɛ AD w AC a AD
dewan	d ɛ AD w AC a AD n
dia	d i AD a AD
diaken	d i AD a AD k ə AD n
diakon	d i AD a AD k o AF n
diam	d i AD a AD m
digali	d i AD ɡ a AD l i AD
digdaya	d i AD ɡ d a AD j AB a AD
dikau	d i AD k a AD u̯ AI
dimakan	d i AD m a AD k a AD n
dirgahayu	d i AD r ɡ a AD h AA a AD j AB u AF
disposisi	d i AD s p o AF s i AD s i AD
doa	d o AF a AD
dohyo	d ɔ AF xʲ ɔ AF
dojo	d o AF d ʒ o AF
dokter	d ɔ AF k t ə AD r
doktor	d ɔ AF k t ɔ AF r
dokumen	d o AF k u AF m ɛ AD n
dom	d o AF m
donasi	d o AF n a AD s i AD
dorna	d o AF r n a AD
dorong	d o AF r o AF ŋ
dosa	d o AF s a AD
dosen	d o AF s ɛ AD n
dosin	d o AF s i AD n
doyo	d o AF j AB o AF
duane	d u AF a AD n ə AD
duit	d u AF i AD t
duk	d ʊ AF k̚
duka	d u AF k a AD
duli	d u AF l i AD
dulu	d u AF l u AF
dunia	d u AF n i AD a AD
dupa	d u AF p a AD
duta	d u AF t a AD
edamame	e AD d a AD m a AD m e AD
efek	ɛ AD f ɛ AD k
efektif	ɛ AD f ɛ AD k̚ t ɪ AD f
eigendom	e AD i AD ɡ ə AD n d o AF m
eka	e AD k a AD
ekaristi	ɛ AD k a AD r i AD s t i AD
eklips	ɛ AD k l i AD p s
eksper	ɛ AD k s p ɛ AD r
elektrik	ɛ AD l ɛ AD k t r ɪ AD k
elektris	ɛ AD l ɛ AD k t r ɪ AD s
emoji	e AD m o AF d ʒ i AD
empat	ə AD m p a AD t
enggak	e AD ŋ ɡ a AD ʔ
engkau	ə AD ŋ k a AD u̯ AI
ensiklik	e AD n s i AD k l i AD k
episkopal	ɛ AD p i AD s k o AF p a AD l
episkopat	ɛ AD p ɪ AD s k o AF p a AD t
erti	ə AD r t i AD
es	ɛ AD s
esa	ə AD s a AD
estafet	ɛ AD s t a AD f ɛ AD t
etik	ɛ AD t ɪ AD k
etika	ɛ AD t i AD k a AD
etis	ɛ AD t ɪ AD s
etude	e AD t u AF d ɛ AD
fakultas	f a AD k ʊ AF l t a AD s
farmasi	f a AD r m a AD s i AD
fatsun	f a AD t s u AF n
februari	f ɛ AD b r u AF a AD r i AD
fengsui	f e AD ŋ s u AF i AD
film	p e AD l ə AD m
firaun	f i AD r a AD u AF n
fiskal	f ɪ AD s k a AD l
folder	f ɔ AF l d ə AD r
formulir	f o AF r m u AF l ɪ AD r
frater	f r a AD t ə AD r
gada	ɡ a AD d a AD
gading	ɡ a AD d i AD ŋ
gaharu	ɡ a AD h AA a AD r u AF
gajah	ɡ a AD d ʒ a AD ʔ
gakari	ɡ a AD k a AD r i AD
gala	ɡ a AD l a AD
gali	ɡ a AD l i AD
galuh	ɡ a AD l u AF h AA
gang	ɡ a AD ŋ
gap	ɡ a AD p
gapura	ɡ a AD p u AF r a AD
garansi	ɡ a AD r a AD n s i AD
garuda	ɡ a AD r u AF d a AD
gaya	ɡ a AD j AB a AD
gayung	ɡ a AD j AB u AF ŋ
gedong	ɡ ɛ AD d o AF ŋ
gedung	ɡ ə AD d ʊ AF ŋ
gelita	ɡ ə AD l i AD t a AD
gempa	ɡ ə AD m p a AD
gempita	ɡ ə AD m p i AD t a AD
generik	ɡ e AD n e AD r i AD k
geng	ɡ ɛ AD ŋ
genta	ɡ ə AD n t a AD
gerha	ɡ ə AD r h AA a AD
gerhana	ɡ ə AD r h AA a AD n a AD
ggl	ɡ e AD ɡ e AD ɛ AD l
gigi	ɡ i AD ɡ i AD
giri	ɡ i AD r i AD
gita	ɡ i AD t a AD
go	ɡ o AF
goban	ɡ o AF b a AD n
gongyo	ɣ ɔ AF n ɣʲ ɔ AF
graha	ɡ r a AD h AA a AD
grahita	ɡ r a AD h AA i AD t a AD
greha	ɡ r ə AD h AA a AD
gua	ɡ u AF a AD
gubernur	ɡ u AF b ə AD r n ʊ AF r
gudang	ɡ u AF d a AD ŋ
gula	ɡ u AF l a AD
gulana	ɡ u AF l a AD n a AD
guna	ɡ u AF n a AD
gundik	ɡ u AF n d i AD ʔ
gunseibu	ɡ u AF n s e AD i AD b u AF
gunseikan	ɡ u AF n s e AD i AD k a AD n
gurita	ɡ u AF r i AD t a AD
guru	ɡ u AF r u AF
habel	h AA a AD b e AD l
habil	h AA a AD b ɪ AD l
hadiah	h AA a AD d i AD j AB a AD h AA
hadir	h AA a AD d ɪ AD r
hadis	h AA a AD d ɪ AD s
hai	h AA a AD ɪ AD
haiku	h AA a AD i AD k u AF
hak	h AA a AD k
hal	h AA a AD l
hampir	h AA a AD m p i AD r
handelar	h AA a AD n d ə AD l a AD r
handschoen	h AA a AD n t̚ s k u AF n
handuk	h AA a AD n d ʊ AF k̚
hanya	h AA a AD ɲ a AD
hanzi	h AA a AD n z i AD
harap	h AA a AD r a AD p
harga	h AA a AD r ɡ a AD
harta	h AA a AD r t a AD
harus	h AA a AD r ʊ AF s
hasta	h AA a AD s t a AD
hati	h AA a AD t i AD
hatta	h AA a AD t t a AD
hedon	h AA e AD d o AF n
hedonisme	h AA e AD d o AF n i AD s m ə AD
heiho	h AA e AD i AD h AA o AF
heng	h AA ɛ AD ŋ
hentai	h AA ɛ AD n t a AD i̯ AH
hewan	h AA e AD w AC a AD n
hidrogen	h AA i AD d r o AF ɡ ɛ AD n
hidup	h AA i AD d u AF p
hierarki	h AA i AD e AD r a AD r k i AD
hilang	h AA i AD l a AD ŋ
hina	h AA i AD n a AD
homo	h AA o AF m o AF
hongbao	h AA o AF ŋ b a AD o AF
hongsui	h AA o AF ŋ s u AF i AD
honji	h AA o AF n d ʒ i AD
hop	h AA o AF p
hopagen	h AA o AF p a AD ɡ ɛ AD n
hopbiro	h AA o AF p b i AD r o AF
hosti	h AA o AF s t i AD
hukum	h AA u AF k ʊ AF m
hukuman	h AA u AF k u AF m a AD n
huruf	h AA u AF r ʊ AF f
hutan	h AA u AF t a AD n
ia	i AD a AD
ialah	i AD a AD l a AD h AA
iba	i AD b a AD
ibrani	i AD b r a AD n i AD
ijazah	i AD d ʒ a AD z a AD h AA
ikan	i AD k a AD n
ikebana	i AD k e AD b a AD n a AD
ikhlas	i AD x l a AD s
iklim	i AD k l ɪ AD m
ikonik	i AD k o AF n ɪ AD k
ikonis	i AD k o AF n ɪ AD s
imam	i AD m a AD m
imamah	i AD m a AD m a AD h AA
imamat	i AD m a AD m a AD t
iman	i AD m a AD n
imlek	i AD m l ɛ AD k
imprimatur	i AD m p r i AD m a AD t u AF r
indekos	i AD n d ə AD k ɔ AF s
indonesia	i AD n d o AF n ɛ AD s i AD a AD
indra	i AD n d ə AD r a AD
industri	ɪ AD n d ʊ AF s t r i AD
informasi	i AD n f ɔ AF r m a AD s i AD
informatif	ɪ AD n f ɔ AF r m a AD t ɪ AD f
ingin	i AD ŋ i AD n
injil	ɪ AD n d ʒ ɪ AD l
inset	i AD n s ɛ AD t
intensi	i AD n t ɛ AD n s i AD
internasional	i AD n t ə AD r n a AD s i AD o AF n a AD l
internuntius	i AD n t ə AD r n u AF n t i AD u AF s
intonasi	ɪ AD n t o AF n a AD s i AD
ipa	i AD p a AD
irama	i AD r a AD m a AD
isa	i AD s a AD
isap	i AD s a AD p
istana	i AD s t a AD n a AD
istimewa	ɪ AD s t i AD m ɛ AD w AC a AD
istri	i AD s t r i AD
jadi	d ʒ a AD d i AD
jadwal	d ʒ a AD t̚ w AC a AD l
jaga	d ʒ a AD ɡ a AD
jagat	j AB a AD ɡ a AD t
jakarta	d ʒ a AD k a AD r t a AD
jakun	d ʒ a AD k ʊ AF n
jala	d ʒ a AD l a AD
jalan	d ʒ a AD l a AD n
jamur	d ʒ a AD m ʊ AF r
janapada	d ʒ a AD n a AD p a AD d a AD
jangan	d ʒ a AD ŋ a AD n
jantung	d ʒ a AD n t ʊ AF ŋ
januari	d ʒ a AD n u AF a AD r i AD
jari	d ʒ a AD r i AD
jarum	d ʒ a AD r ʊ AF m
jati	d ʒ a AD t i AD
jawa	d ʒ a AD w AC a AD
jawab	d ʒ a AD w AC a AD p̚
jawaban	d ʒ a AD w AC a AD p a AD n
jelata	d ʒ ə AD l a AD t a AD
jelita	d ʒ ə AD l i AD t a AD
jelma	d ʒ ə AD l m a AD
jenasah	d ʒ ə AD n a AD s a AD h AA
jenazah	d ʒ ə AD n a AD z a AD h AA
jentera	d ʒ ə AD n t ə AD r a AD
jepang	d ʒ ə AD p a AD ŋ
jepun	d ʒ ə AD p ʊ AF n
jerman	d ʒ e AD r m a AD n
jijik	d ʒ i AD d ʒ ɪ AD ʔ
jiwa	d ʒ i AD w AC a AD
judo	d ʒ u AF d o AF
judogi	d ʒ u AF d o AF ɡ i AD
judoka	d ʒ u AF d o AF k a AD
jujitsu	d ʒ u AF d ʒ ɪ AD t s u AF
jujutsu	d ʒ u AF d ʒ ʊ AF t s u AF
juli	d ʒ u AF l i AD
juni	d ʒ u AF n i AD
juta	d ʒ u AF t a AD
kabar	k a AD b a AD r
kabinet	k a AD b i AD n ɛ AD t
kabisat	k a AD b i AD s a AD t̚
kabuki	k a AD b u AF k i AD
kabupaten	k a AD b u AF p a AD t e AD n
kaca	k a AD t ʃ a AD
kacamata	k a AD t ʃ a AD m a AD t a AD
kacung	k a AD t ʃ ʊ AF ŋ
kadaster	k a AD d a AD s t ə AD r
kadaver	k a AD d a AD v ə AD r
kaf	k a AD f
kailan	k a AD i AD l a AD n
kaisar	k a AD i AD s a AD r
kaji	k a AD d ʒ i AD
kakus	k a AD k ʊ AF s
kali	k a AD l i AD
kalian	k a AD l i AD a AD n
kama	k a AD m a AD
kami	k a AD m i AD
kamikaze	k a AD m i AD k a AD z e AD
kamis	k a AD m ɪ AD s
kampai	k a AD m p a AD i̯ AH
kamu	k a AD m u AF
kamuflase	k a AD m u AF f l a AD s ə AD
kandidat	k a AD n d i AD d a AD t̚
kanji	k a AD n d ʒ i AD
kanonis	k a AD n o AF n ɪ AD s
kanta	k a AD n t a AD
kantor	k a AD n t o AF r
kapal	k a AD p a AD l
kapalan	k a AD p a AD l a AD n
kapan	k a AD p a AD n
kapas	k a AD p a AD s
kapitan	k a AD p i AD t a AD n
kapten	k a AD p̚ t ɛ AD n
karakuri	k a AD r a AD k u AF r i AD
karaoke	k a AD r a AD o AF k e AD
karate	k a AD r a AD t e AD
karategi	k a AD r a AD t e AD ɡ i AD
karateka	k a AD r a AD t e AD k a AD
kardinal	k a AD r d i AD n a AD l
karkas	k a AD r k a AD s
karma	k a AD r m a AD
karsa	k a AD r s a AD
kartel	k a AD r t ɛ AD l
kartika	k a AD r t i AD k a AD
kartu	k a AD r t u AF
karunia	k a AD r u AF n i AD a̯
karya	k a AD r j AB a AD
kastel	k a AD s t ɛ AD l
kastil	k a AD s t ɪ AD l
kata	k a AD t a AD
katedral	k a AD t ə AD d r a AD l
katun	k a AD t u AF n
kau	k a AD u̯ AI
kawan	k a AD w AC a AD n
kawasan	k a AD w AC a AD s a AD n
kebakaran	k ə AD b a AD k a AD r a AD n
kebun	k ə AD b ʊ AF n
kecamatan	k ə AD t ʃ a AD m a AD t a AD n
kecap	k ɛ AD t ʃ a AD p
kecil	k ə AD t ʃ i AD l
kedaluwarsa	k ə AD d a AD l u AF w AC a AD r s a AD
kedatangan	k ə AD d a AD t a AD ŋ a AD n
kedokteran	k ə AD d o AF k t ə AD r a AD n
kedutaan	k ə AD d u AF t a AD a AD n
keempat	k ə AD ə AD m p a AD t
kehausan	k ə AD h AA a AD ʊ AF s a AD n
kehujanan	k ə AD h AA u AF d ʒ a AD n a AD n
keibodan	k e AD i AD b o AF d a AD n
keik	k ɛ AD i AD k
keker	k ɛ AD k ɛ AD r
kelab	k ə AD l a AD p
kelapa	k ə AD l a AD p a AD
kelar	k ə AD l a AD r
kelinci	k ə AD l ɪ AD n t ʃ i AD
keluarga	k ə AD l u AF a AD r ɡ a AD
kembang	k ə AD m b a AD ŋ
kempetai	k e AD m p e AD t a AD i̯ AH
ken	k ɛ AD n
kenapa	k ə AD n a AD p a AD
kencana	k ə AD n t ʃ a AD n a AD
kendaraan	k ə AD n d a AD r a AD ʔ a AD n
kendi	k ə AD n d i AD
kendo	k ɛ AD n d o AF
kenek	k ə AD n ɛ AD k
kening	k ə AD n ɪ AD ŋ
kepala	k ə AD p a AD l a AD
keparat	k ə AD p a AD r a AD t
kerajaan	k ə AD r a AD d ʒ a AD a AD n
keranda	k ə AD r a AD n d a AD
keraton	k ə AD r a AD t ɔ AF n
kerbau	k ə AD r b a AD u̯ AI
kerosin	k e AD r o AF s ɪ AD n
kertas	k ə AD r t a AD s
ketinggalan	k ə AD t i AD ŋ ɡ a AD l a AD n
keturunan	k ə AD t u AF r ʊ AF n a AD n
keuskupan	k ə AD u AF s k u AF p a AD n
khalifah	x a AD l i AD f a AD ʔ
khatam	x a AD t a AD m
khawatir	x a AD w AC a AD t i AD r
khilafah	x i AD l a AD f a AD ʔ
kiai	k i AD a AD i̯ AH
kidal	k i AD d a AD l
kilang	k i AD l a AD ŋ
kimono	k i AD m o AF n o AF
kira	k i AD r a AD
kirana	k i AD r a AD n a AD
kita	k i AD t a AD
kitab	k i AD t a AD p̚
klasikal	k l a AD s ɪ AD k a AD l
klaver	k l a AD v ə AD r
klem	k l ɛ AD m
klep	k l ɛ AD p
klinikal	k l i AD n i AD k a AD l
klinis	k l i AD n i AD s
klop	k l ɔ AF p̚
kolaborator	k ɔ AF l a AD b ɔ AF r a AD t ɔ AF r
kolam	k o AF l a AD m
kolega	k o AF l e AD ɡ a AD
kolik	k o AF l ɪ AD k
komandan	k o AF m a AD n d a AD n
komet	k o AF m ɛ AD t̚
komisi	k o AF m i AD s i AD
komite	k o AF m i AD t e AD
komplot	k o AF m p l o AF t
komunikasi	k o AF m u AF n i AD k a AD s i AD
komunis	k o AF m u AF n ɪ AD s
koneksi	k o AF n ɛ AD k s i AD
konfeti	k o AF n f e AD t i AD
koordinasi	k o AF ɔ AF r d i AD n a AD s i AD
kop	k o AF p
koper	k o AF p ə AD r
koperasi	k o AF p ə AD r a AD s i AD
kopi	k o AF p i AD
kopitiam	k o AF p i AD t i AD a AD m
kor	k ɔ AF r
koroner	k o AF r o AF n ɛ AD r
korupsi	k o AF r u AF p s i AD
kosakata	k o AF s a AD k a AD t a AD
kosmonaut	k ɔ AF s m o AF n a AD u̯ AI t̚
kota	k o AF t a AD
kredo	k r e AD d o AF
krida	k r i AD d a AD
kring	k r ɪ AD ŋ
kristen	k r ɪ AD s t ə AD n
kruk	k r ʊ AF k
krusial	k r u AF s i AD a AD l
ku	k u AF
kuartal	k u AF a AD r t a AD l
kucing	k u AF t ʃ ɪ AD ŋ
kuda	k u AF d a AD
kuil	k u AF ɪ AD l
kuilu	k u AF i AD l u AF
kuintal	k w AC i AD n t a AD l
kuitansi	k u AF i̯ AH t a AD n s i AD
kuliah	k u AF l i AD a AD h AA
kumico	k u AF m i AD t ʃ o AF
kuna	k u AF n a AD
kuno	k u AF n o AF
kurang	k u AF r a AD ŋ
kusta	k ʊ AF s t a AD
kusuma	k u AF s u AF m a AD
kutang	k u AF t a AD ŋ
lada	l a AD d a AD
lagi	l a AD ɡ i AD
laher	l a AD h AA ə AD r
laki	l a AD k i AD
laksa	l a AD k s a AD
laksamana	l a AD k s a AD m a AD n a AD
laksana	l a AD k s a AD n a AD
laksmi	l a AD k s m i AD
lalat	l a AD l a AD t̚
laler	l a AD l ə AD r
lama	l a AD m a AD
lanca	l a AD n t ʃ a AD
lancia	l a AD n t ʃ i AD a̯
langau	l a AD ŋ a AD u̯ AI
langca	l a AD ŋ t ʃ a AD
langcia	l a AD ŋ t ʃ i AD a̯
langit	l a AD ŋ i AD t
langka	l a AD ŋ k a AD
lantai	l a AD n t a AD i̯ AH
lapang	l a AD p a AD ŋ
lapangan	l a AD p a AD ŋ a AD n
laskar	l a AD s k a AD r
lawan	l a AD w AC a AD n
lazuardi	l a AD z u AF a AD r d i AD
leger	l ɛ AD ɡ ə AD r
lekong	l e AD k o AF ŋ
lektor	l ɛ AD k t o AF r
lelang	l ɛ AD l a AD ŋ
lemah	l ə AD m a AD h AA
lembar	l ə AD m b a AD r
lemper	l ə AD m p ə AD r
lengan	l ə AD ŋ a AD n
lengket	l ɛ AD ŋ k ɛ AD t̚
lensa	l ɛ AD n s a AD
lepra	l ɛ AD p r a AD
libur	l i AD b u AF r
lipur	l i AD p ʊ AF r
lisan	l i AD s a AD n
literasi	l i AD t ə AD r a AD s i AD
lobak	l o AF b a AD k
loji	l o AF d ʒ i AD
loka	l o AF k a AD
lokalisasi	l o AF k a AD l i AD s a AD s i AD
lokalisir	l o AF k a AD l i AD s ɪ AD r
loket	a AD b o AF n ə AD m ɛ AD n
loper	l o AF p ə AD r
losin	l o AF s i AD n
losmen	l o AF s m ɛ AD n
lues	l u AF e AD s
luncur	l ʊ AF n t ʃ ʊ AF r
lupa	l u AF p a AD
lurus	l u AF r u AF s
lusin	l u AF s i AD n
madrasah	m a AD d r a AD s a AD h AA
mahakuasa	m a AD h AA a AD k u AF a AD s a AD
main	m a AD i AD n
majelis	m a AD d ʒ ə AD l ɪ AD s
makan	m a AD k a AD n
makanan	m a AD k a AD n a AD n
maklumat	m a AD k̚ l u AF m a AD t̚
mala	m a AD l a AD
malam	m a AD l a AD m
malingsial	m ä l ɪ AD ŋ s i AD a AD l
mampu	m a AD m p u AF
mana	m a AD n a AD
mancanegara	m a AD n t ʃ a AD n ə AD ɡ a AD r a AD
manga	m a AD n ɡ a AD
mangaka	m a AD n ɡ a AD k a AD
mantel	m a AD n t ə AD l
mantra	m a AD n t r a AD
mantri	m a AD n t ə AD r i AD
map	m a AD p̚
maret	m a AD r ə AD t̚
marga	m a AD r ɡ a AD
mari	m a AD r i AD
markas	m a AD r k a AD s
masih	m a AD s i AD h AA
masker	m a AD s k ə AD r
matahari	m a AD t a AD h AA a AD r i AD
maya	m a AD j AB a AD
mayat	m a AD j AB a AD t̚
mayit	m a AD j AB i AD t̚
mazbah	m a AD z b a AD h AA
mecin	m ɛ AD t ʃ i AD n
medan	m ɛ AD d a AD n
mei	m e AD i̯ AH
melekaskan	m ə AD l ə AD k a AD s k a AD n
meletus	m ə AD l ə AD t u AF s
meloka	m ə AD l o AF k a AD
memaafkan	m ə AD m a AD a AD f k a AD n
memakan	m ə AD m a AD k a AD n
memasang	m ə AD m a AD s a AD ŋ
membaca	m ə AD m b a AD t ʃ a AD
membakar	m ə AD m b a AD k a AD r
membangun	m ə AD m b a AD ŋ ʊ AF n
membantah	m ə AD m b a AD n t a AD h AA
membeli	m ə AD m b e AD l i AD
memberantakkan	m ə AD m b ə AD r a AD n t a AD k k a AD n
membunuh	m ə AD m b u AF n ʊ AF h AA
meme	m e AD m e AD
memerban	m ə AD m ə AD r b a AD n
memetieskan	m ə AD m ə AD t i AD ɛ AD s k a AD n
memilih	m ə AD m i AD l i AD h AA
memindai	m ə AD m i AD n d a AD i̯ AH
memodernkan	m ə AD m o AF d ɛ AD r n k a AD n
memperketat	m ə AD m p ə AD r k ə AD t a AD t
memukul	m ə AD m u AF k ʊ AF l
memunculkan	m ə AD m u AF n t ʃ ʊ AF l k a AD n
memutakhirkan	m ə AD m u AF t a AD x i AD r k a AD n
menabelkan	m ə AD n a AD b ə AD l k a AD n
menambah	m ə AD n a AD m b a AD h AA
menampilkan	m ə AD n a AD m p i AD l k a AD n
menang	m ə AD n a AD ŋ
menara	m ə AD n a AD r a AD
menatapi	m ə AD n a AD t a AD p i AD
menayangkan	m ə AD n a AD j AB a AD ŋ k a AD n
mencacat	m ə AD n t ʃ a AD t ʃ a AD t
mencekoki	m ə AD ɲ t ʃ ə AD k o AF ʔ i AD
mencekokkan	m ə AD n t ʃ ə AD k o AF ʔ k a AD n
mencela	m ə AD ŋ t ʃ ə AD l a AD
mencium	m ə AD ɲ t ʃ i AD u AF m
mendengar	m ə AD n d ə AD ŋ a AD r
mendiamkan	m ə AD n d i AD a AD m k a AD n
mendoa	m ə AD n d o AF a AD
mendobrak	m ə AD n d o AF b r a AD k
mendung	m ə AD n d u AF ŋ
menelaah	m ə AD n ə AD l a AD a AD h AA
mengabadi	m ə AD ŋ a AD b a AD d i AD
mengaben	m ə AD ŋ a AD b ɛ AD n
menganiaya	m ə AD ŋ a AD n i AD a AD j AB a AD
menganiayai	m ə AD ŋ a AD n i AD a AD j AB a AD i AD
mengapa	m ə AD ŋ a AD p a AD
mengenai	m ə AD ɲ ə AD n a AD i AD
mengencingi	m ə AD ŋ e AD n c i AD ŋ i AD
mengendalikan	m ə AD ŋ ə AD n d a AD l i AD k a AD n
mengetatkan	m ə AD ŋ ə AD t a AD t̚ k a AD n
menggali	m ə AD ŋ ɡ a AD l i AD
menggarisbawahi	m ə AD ŋ ɡ a AD r i AD s b a AD w AC a AD h AA i AD
menggarisi	m ə AD ŋ ɡ a AD r i AD s i AD
menggempita	m ə AD ŋ ɡ ə AD m p i AD t a AD
menghadiri	m ə AD ŋ h AA a AD d i AD r i AD
menghadirkan	m ə AD ŋ h AA a AD d i AD r k a AD n
menghasilkan	m ə AD ŋ h AA a AD s i AD l k a AD n
menghukum	m ə AD ŋ h AA u AF k ʊ AF m
mengiler	m ə AD ŋ i AD l ə AD r
mengimbuh	m ə AD ŋ i AD m b u AF h AA
mengoplos	m ə AD ŋ o AF p l o AF s
mengubah	m ə AD ŋ u AF b a AD h AA
mengumpamakan	m ə AD ŋ u AF m p a AD m a AD k a AD n
menikah	m ə AD n i AD k a AD h AA
menilai	m ə AD n i AD l a AD i AD
meninggali	m ə AD n i AD ŋ ɡ a AD l i AD
menit	m ə AD n ɪ AD t
menjijikkan	m ə AD n d ʒ i AD d ʒ ɪ AD ʔ k a AD n
menorah	m e AD n o AF r a AD h AA
menuntut	m ə AD n u AF n t ʊ AF t
menyerahkan	m ə AD ɲ ə AD r a AD h AA k a AD n
menyiarkan	m ə AD ɲ i AD a AD r k a AD n
menyimpan	m ə AD ɲ i AD m p a AD n
menyita	m ə AD ɲ i AD t a AD
menyunting	m ə AD ɲ u AF n t i AD ŋ
menyusun	m ə AD ɲ u AF s ʊ AF n
meong	m ɛ AD o AF ŋ
meraih	m ə AD r a AD i AD h AA
meraja	m ə AD r a AD d ʒ a AD
merebus	m ə AD r ə AD b ʊ AF s
mereka	m ə AD r e AD k a AD
merica	m ə AD r i AD t ʃ a AD
merupakan	m ə AD r u AF p a AD k a AD n
merusak	m ə AD r u AF s a AD ʔ
mesir	m ə AD s i AD r
meta	a AD b o AF n ə AD m ɛ AD n
micin	m i AD t ʃ i AD n
minaret	m i AD n a AD r ɛ AD t
minder	m ɪ AD n d ə AD r
mirin	m i AD r i AD n
mobil	m o AF b i AD l
moci	m o AF t ʃ i AD
moksa	m o AF k s a AD
monarki	m o AF n a AD r k i AD
mu	m u AF
muda	m u AF d a AD
mudra	m u AF d r a AD
muka	m u AF k a AD
mula	m u AF l a AD
mur	m u AF r
mutasi	m u AF t a AD s i AD
n	ɛ AD n
nagari	n a AD ɡ a AD r i AD
nah	n a AD h AA
nakhoda	n a AD x o AF d a AD
nanas	n a AD n a AD s
nanti	n a AD n t i AD
nasrani	n a AD s r a AD n i AD
natal	n a AD t a AD l
naufal	n a AD u AF f a AD l
negeri	n ə AD ɡ ə AD r i AD
negoisasi	n ɛ AD ɡ o AF s i AD a AD s i AD
nestapa	n ə AD s t a AD p a AD
netra	n ə AD t r a AD
nila	n i AD l a AD
nira	n i AD r a AD
nirwana	n i AD r w AC a AD n a AD
nopek	n o AF p ɛ AD ʔ
nori	n o AF r i AD
not	n ɔ AF t
november	n o AF v ɛ AD m b ə AD r
nyanyi	ɲ a AD ɲ i AD
nyendok	ɲ ə AD n d o AF ʔ
nyiur	ɲ i AD ʊ AF r
nyonya	ɲ o AF ɲ a AD
obesitas	o AF b ɛ AD s i AD t a AD s
obi	o AF b i AD
oke	ɔ AF k e AD
oktober	ɔ AF k̚ t o AF b ə AD r
onagata	o AF n a AD ɡ a AD t a AD
onderdil	o AF n d ə AD r d i AD l
ongkos	o AF ŋ k o AF s
onigiri	o AF n i AD ɡ i AD r i AD
onsen	o AF n s ɛ AD n
oplos	o AF p̚ l o AF s
oplosan	o AF p l o AF s a AD n
orang	o AF r a AD ŋ
origami	o AF r i AD ɡ a AD m i AD
oto	o AF t o AF
otomobil	o AF t o AF m o AF b i AD l
padi	p a AD d i AD
padri	p a AD d r i AD
paduka	p a AD d u AF k a AD
pagu	p a AD ɡ u AF
pahala	p a AD h AA a AD l a AD
paham	p a AD h AA a AD m
pahlawan	p a AD h AA l a AD w AC a AD n
pala	p a AD l a AD
palu	p a AD l u AF
panas	p a AD n a AD s
pandemi	p a AD n d e AD m i AD
pandemik	p a AD n d e AD m ɪ AD k
panekuk	p a AD n ə AD k u AF k
pangkat	p a AD ŋ k a AD t
pangsit	p a AD ŋ s i AD t
panko	p a AD n k o AF
pap	p a AD p
papa	p a AD p a AD
pariwisata	p a AD r i AD w AC i AD s a AD t a AD
parlemen	p a AD r l ə AD m ɛ AD n
parlementer	p a AD r l ə AD m ɛ AD n t ɛ AD r
paroki	p a AD r o AF k i AD
partikelir	p a AD r t i AD k ə AD l ɪ AD r
pasar	p a AD s a AD r
pasien	p a AD s i AD ɛ AD n
paskah	p a AD s k a AD h AA
pasraman	p a AD s r a AD m a AD n
pastor	p a AD s t o AF r
pataka	p a AD t a AD k a AD
pejabat	p ə AD d ʒ a AD b a AD t
pek	p ɛ AD k
pekan	p ə AD k a AD n
pekerjaan	p ə AD k ə AD r d ʒ a AD ʔ a AD n
pelacur	p ə AD l a AD t ʃ ʊ AF r
pelajar	p ə AD l a AD d ʒ a AD r
pelan	p ə AD l a AD n
peler	p ə AD l e AD r
pelopor	p ə AD l o AF p ɔ AF r
pemain	p ə AD m a AD i AD n
pembohong	p ə AD m b o AF h AA o AF n ɡ
pembunuh	p ə AD m b u AF n ʊ AF h AA
pemerintah	p ə AD m ə AD r i AD n t a AD h AA
pemerintahan	p ə AD m ə AD r i AD n t a AD h AA a AD n
penakut	p ə AD n a AD k u AF t
pencemaran	p ə AD n t ʃ ə AD m a AD r a AD n
penderita	p ə AD n d ə AD r i AD t a AD
pendeta	p ə AD n d ɛ AD t a AD
pendukung	p ə AD n d u AF k ʊ AF ŋ
pengairan	p ə AD ŋ a AD ʔ ɪ AD r a AD n
penganiaya	p ə AD ŋ a AD n i AD a AD j AB a AD
penganiayaan	p ə AD ŋ a AD n i AD a AD j AB a AD a AD n
penggalian	p ə AD ŋ ɡ a AD l i AD a AD n
penggiling	p ə AD ŋ ɡ ɪ AD l ɪ AD ŋ
pengguna	p ə AD ŋ ɡ u AF n a AD
pengoplos	p ɘ AD ŋ o AF p l o AF s
penjagaan	p ə AD n d ʒ a AD ɡ a AD ʔ a AD n
penuntut	p ə AD n u AF n t ʊ AF t
penyamaran	p ə AD ɲ a AD m a AD r a AD n
perambah	p ə AD r a AD m b a AD h AA
perang	p ə AD r a AD ŋ
perawat	p ə AD r a AD w AC a AD t
perban	p ə AD r b a AD n
percuma	p ə AD r t ʃ u AF m a AD
perdana	p ə AD r d a AD n a AD
perdata	p ə AD r d a AD t a AD
perdom	p ə AD r d ɔ AF m
pergi	p ə AD r ɡ i AD
perkara	p ə AD r k a AD r a AD
permainan	p ə AD r m a AD i AD n a AD n
permukaan	p ə AD r m u AF k a AD ʔ a AD n
perpeloncoan	p ə AD r p ə AD l o AF n t ʃ o AF a AD n
persada	p ə AD r s a AD d a AD
persembahan	p ə AD r s ə AD m b a AD h AA a AD n
persen	p ə AD r s ə AD n
persneling	p ə AD r s ə AD n e AD l i AD ŋ
pertama	p ə AD r t a AD m a AD
pertiwi	p ə AD r t i AD w AC i AD
perut	p ə AD r ʊ AF t̚
pesumo	p ə AD s u AF m o AF
peta	p ə AD t a AD
pidana	p i AD d a AD n a AD
piket	p i AD k ɛ AD t̚
pikir	p i AD k ɪ AD r
pintu	p i AD n t u AF
pion	p i AD o AF n
pionir	p i AD o AF n ɪ AD r
pipi	p i AD p i AD
pisang	p i AD s a AD ŋ
pita	p i AD t a AD
plafon	p ə̆ AG l a AD f ɔ AF n
plak	p l a AD k
polis	p o AF l ɪ AD s
ponsel	p o AF n s ɛ AD l
potret	p o AF t r e AD t
pr	p ɛ AD ɛ AD r
prabu	p r a AD b u AF
prahara	p r a AD h AA a AD r a AD
prakerta	p r a AD k ə AD r t a AD
praktek	p r a AD k̚ t ɛ AD k̚
praktik	p r a AD k̚ t ɪ AD k̚
prasada	p r a AD s a AD d a AD
prei	p r e AD i AD
pria	p ə AD r i AD a̯
pribadi	p r i AD b a AD d i AD
produk	p r o AF d ʊ AF k
profesor	p r o AF f ɛ AD s ɔ AF r
proses	p r o AF s ɛ AD s
proyek	p r o AF j AB ɛ AD k
psikiater	p s i AD k i AD a AD t ə AD r
psikolog	p s i AD k o AF l o AF ɡ
puja	p u AF d ʒ a AD
puji	p u AF d ʒ i AD
punia	p u AF n i AD a̯
pura	p u AF r a AD
puri	p u AF r i AD
puspa	p ʊ AF s p a AD
q	k i AD
qanun	q a AD n u AF n
raga	r a AD ɡ a AD
ramal	r a AD m a AD l
ranjang	r a AD ɲ d ʒ a AD ŋ
ransel	r a AD n s ə AD l
rapi	r a AD p i AD h AA
rasa	r a AD s a AD
rasuah	r a AD s u AF a AD h AA
ratu	r a AD t u AF
rawat	r a AD w AC a AD t
realitas	r e AD a AD l i AD t a AD s
reanimasi	r e AD a AD n i AD m a AD s i AD
rekayasa	r e AD k a AD j AB a AD s a AD
rekening	r ɛ AD k ə AD n i AD ŋ
reksa	r ə AD k s a AD
rektor	r ɛ AD k t o AF r
rem	r ɛ AD m
rengo	r e AD n ɡ o AF
renten	r ɛ AD n t ə AD n
resep	r ə AD s ɛ AD p
resi	r ə AD s i AD
resmi	r ə AD s m i AD
resusitasi	r e AD s u AF s i AD t a AD s i AD
retensi	r ə AD t ɛ AD n s i AD
rezeki	r ə AD z ə AD k i AD
riba	r i AD b a AD
risiko	r i AD s i AD k o AF
riskan	r i AD s k a AD n
ritme	r i AD t m ə AD
rokade	r o AF k a AD d ə AD
roman	r o AF m a AD n
romusa	r o AF m u AF s a AD
romusha	r o AF m u AF ʃ a AD
romusya	r o AF m u AF ʃ a AD
rusak	r u AF s a AD ʔ
saat	s a AD ʔ a AD t
sabi	s a AD b i AD
sabit	s a AD b i AD t
sabo	s a AD b o AF
sabun	s a AD b u AF n
sabung	s a AD b ʊ AF ŋ
sadar	s a AD d a AD r
sadu	s a AD d u AF
sahaya	s a AD h AA a AD j AB a AD
saja	s a AD d ʒ a AD
saka	s a AD k a AD
sake	s a AD k e AD
sakelar	s a AD k ə AD l a AD r
sakit	s a AD k i AD t
sakti	s a AD k t i AD
sal	s a AD l
sala	s a AD l a AD
salah	s a AD l a AD h AA
sama	s a AD m a AD
sambung	s a AD m b ʊ AF ŋ
samcan	s a AD m t ʃ a AD n
samsek	s a AD m s ə AD k
samurai	s a AD m u AF r a AD i AD
sancan	s a AD ɲ t ʃ a AD n
sangat	s a AD ŋ a AD t
sangga	s a AD ŋ ɡ a AD
sangka	s a AD ŋ k a AD
sangsi	s a AD ŋ s i AD
sanksi	s a AD ŋ s i AD
sarana	s a AD r a AD n a AD
sasana	s a AD s a AD n a AD
satori	s a AD t o AF r i AD
satu	s a AD t u AF
satuan	s a AD t u AF a AD n
satwa	s a AD t̚ w AC a AD
saudara	s a AD u̯ AI d a AD r a AD
saudari	s a AD u̯ AI d a AD r i AD
saya	s a AD j AB a AD
sedap	s ə AD d a AD p̚
segel	s ɛ AD ɡ ə AD l
sehat	s ɛ AD h AA a AD t̚
sein	s e AD ɪ̯ AH n
seinendan	s e AD i AD n e AD n d a AD n
sekak	s ə AD k a AD k
sekali	s ə AD k a AD l i AD
seko	s ɛ AD k o AF
sekong	s e AD k o AF ŋ
sekring	s e AD k r ɪ AD ŋ
sekrup	s ə AD k r u AF p
seksi	s ɛ AD k s i AD
sekunder	s ə AD k ʊ AF n d ɛ AD r
selada	s a AD l a AD d a AD
selalu	s ə AD l a AD l u AF
semangka	s ə AD m a AD ŋ k a AD
sembuh	s e AD m b u AF h AA
semen	s ɛ AD m ɛ AD n
seminar	s ə AD m i AD n a AD r
seminari	s ɛ AD m i AD n a AD r i AD
semir	s ə AD m i AD r
sempoa	s ə AD m p o AF a AD
sempurna	s ə AD m p u AF r n a AD
semua	s ə AD m u AF a AD
sendratari	s ə AD n d r a AD t a AD r i AD
sengsai	s ɛ AD ŋ s a AD i AD
sengsara	s ə AD ŋ s a AD r a AD
senin	s ə AD n ɪ AD n
sensei	s e AD n s e AD i AD
senter	s ɛ AD n t ə AD r
sentosa	s ə AD n t o AF s a AD
sentral	s ɛ AD n t r a AD l
seorang	s ə AD o AF r a AD ŋ
sepatu	s ə AD p a AD t u AF
sepeda	s ə AD p ɛ AD d a AD
seprai	s ə AD p r a AD i AD
seprei	s ə AD p r e AD i AD
september	s ɛ AD p̚ t ɛ AD m b ə AD r
sepur	s ə AD p u AF r
serdadu	s ə AD r d a AD d u AF
seremoni	s e AD r e AD m o AF n i AD
seri	s ə AD r i AD
sertifikat	s e AD r t i AD p i AD k a AD t
setolop	s ə AD t ɔ AF l ɔ AF p
setra	s ɛ AD t r a AD
setrap	s ə AD t r a AD p
setrum	s ə AD t r ʊ AF m
setuju	s ə AD t u AF d ʒ u AF
shinto	ʃ i AD n t o AF
shogun	ʃ o AF ɡ u AF n
sialan	s i AD a AD l a AD n
sijil	s i AD d ʒ ɪ AD l
silam	s i AD l a AD m
singapura	s i AD ŋ a AD p u AF r a AD
singgasana	s i AD ŋ ɡ a AD s a AD n a AD
singse	s i AD ŋ s ə AD
sini	s i AD n i AD
sinse	s i AD n s e AD
sipil	s i AD p ɪ AD l
sirkuler	s ɪ AD r k u AF l ɛ AD r
skala	s ə̆ AG k a AD l a AD
skalar	s k a AD l a AD r
skema	s ə AD k e AD m a AD
skim	s ə AD k ɪ AD m
slang	s ə AD l a AD ŋ
soang	s o AF a̯ ŋ
soba	s o AF b a AD
sopir	s o AF p ɪ AD r
spanduk	s ə AD p a AD n d ʊ AF k̚
spaning	s p a AD n i AD ŋ
sporadis	s p o AF r a AD d ɪ AD s
sprei	s ə AD p r e AD i AD
sri	s ə AD r i AD
staf	s t a AD f
stasi	s t a AD s i AD
stasiun	s ə̆ AG t a AD s i AD u AF n
steker	a AD b o AF n ə AD m ɛ AD n
step	s ə AD t ɛ AD p
stoples	s ə AD t ɔ AF p l ɛ AD s
stroberi	s t r o AF b ɛ AD r i AD
struktur	s t r ʊ AF k t ʊ AF r
suami	s u AF a̯ m i AD
suara	s u AF a AD r a AD
subuco	s u AF b u AF t ʃ o AF
suci	s u AF t ʃ i AD
sudoku	s u AF d o AF k u AF
suf	s ʊ AF f
suiseki	s u AF i AD s e AD k i AD
suka	s u AF k a AD
sumber	s ʊ AF m b ə AD r
sumo	s u AF m o AF
sungai	s u AF ŋ a AD i̯ AH
surabaya	s u AF r a AD b a AD j AB a AD
surakarta	s u AF r a AD k a AD r t a AD
surga	s u AF r ɡ a AD
survei	s ʊ AF r v e AD i̯ AH
surya	s u AF r j AB a AD
suster	s u AF s t ə AD r
susyi	s u AF ʃ i AD
sutra	s u AF t r a AD
swafoto	s w AC a AD f o AF t o AF
swasembada	s w AC a AD s ə AD m b a AD d a AD
swasta	s w AC a AD s t a AD
swatantra	s ʋ AC a AD t a AD n t r a AD
syah	ʃ a AD h AA
syahadat	ʃ a AD h AA a AD d a AD t̚
syahbandar	ʃ a AD h AA b a AD n d a AD r
syogun	ʃ ɔ AF ɡ u AF n
syuriken	ʃ u AF r i AD k ɛ AD n
tabel	t a AD b ɛ AD l
tabelaris	t a AD b ə AD l a AD r ɪ AD s
tabib	t a AD b ɪ AD p̚
tahu	t a AD ʊ AF
tahun	t a AD h AA ʊ AF n
taiso	t a AD i AD s o AF
takal	t a AD k a AD l
takeyari	t a AD k e AD y AF a AD r i AD
takhta	t a AD x t a AD
takoyaki	t a AD k o AF j AB a AD k i AD
takraw	t a AD k̚ r a AD w AC
taksi	t a AD k̚ s i AD
takut	t a AD k u AF t
tampil	t a AD m p i AD l
tanah	t a AD n a AD h AA
tangan	t a AD ŋ a AD n
tangki	t a AD ŋ k i AD
tank	t ɛ AD ŋ k
tante	t a AD n t ə AD
tanya	t a AD ɲ a AD
tapa	t a AD p a AD
tar	t a AD r
taring	t a AD r ɪ AD ŋ
taruna	t a AD r u AF n a AD
tas	t a AD s
tatap	t a AD t a AD p̚
tau	t a AD ʊ AF
tebusan	t ə AD b u AF s a AD n
teh	t ɛ AD h AA
tekidanto	t ɛ AD k i AD d a AD n t o AF
tekor	t ə AD k o AF r
telaah	t ə AD l a AD a AD h AA
telaga	t ə AD l a AD ɡ a AD
telepon	t ɛ AD l ɛ AD p ɔ AF n
televisi	t e AD l e AD v i AD s i AD
tembak	t e AD m b a AD k
tempat	t ə AD m p a AD t
tempo	t e AD m p o AF
tempura	t ə AD m p u AF r a AD
temu	t ə AD m u AF
tensi	t ɛ AD n s i AD
tentang	t ə AD n t a AD ŋ
tentara	t ə AD n t a AD r a AD
teori	t e AD o AF r i AD
tepat	t ə AD p a AD t
ter	t ɛ AD r
teraniaya	t ə AD r a AD n i AD a AD j AB a AD
terbang	t ə AD r b a AD ŋ
terbesar	t ə AD r b ə AD s a AD r
terein	t ə AD r e AD ɪ AD n
teriyaki	t ɛ AD r i AD j AB a AD k i AD
terjemah	t ɛ AD r d ʒ ɛ AD m a AD h AA
terkenal	t ə AD r k ə AD n a AD l
terlalu	t ə AD r l a AD l u AF
terwelu	t ə AD r w AC ɛ AD l u AF
tidur	t i AD d u AF r
tiga	t i AD ɡ a AD
timbal	t i AD m b a AD l
timbel	t i AD m b ə AD l
timur	t i AD m ʊ AF r
tindakan	t ɪ AD n d a AD k a AD n
tinggal	t i AD ŋ ɡ a AD l
tinggi	t i AD ŋ ɡ i AD
tinta	t i AD n t a AD
tipu	t i AD p u AF
tirani	t i AD r a AD n i AD
tirta	t i AD r t a AD
tobang	t o AF b a AD ŋ
tobiko	t o AF b i AD k o AF
tofu	t o AF f u AF
toh	t o AF h AA
toilet	t o AF i̯ AH l ɛ AD t̚
toko	t o AF k o AF
tol	t o AF l
toto	t o AF t o AF
tren	t r ɛ AD n
tromol	t r o AF m o AF l
tsuru	ʃ u AF r u AF
tua	t u AF a AD
tuas	t u AF a AD s
tugas	t u AF ɡ a AD s
tuhan	t u AF h AA a AD n
tukang	t u AF k a AD ŋ
tumbuhan	t u AF m b u AF h AA a AD n
tuntut	t u AF n t ʊ AF t
tustel	t u AF s t ɛ AD l
udon	u AF d o AF n
umami	u AF m a AD m i AD
umur	u AF m ʊ AF r
unggul	u AF ŋ ɡ ʊ AF l
unta	ʊ AF n t a AD
untung	u AF n t ʊ AF ŋ
upacara	u AF p a AD t ʃ a AD r a AD
upawasa	u AF p a AD w AC a AD s a AD
upaya	u AF p a AD j AB a AD
usada	u AF s a AD d a AD
usang	u AF s a AD ŋ
uskup	u AF s k ʊ AF p
utama	ʊ AF t a AD m a AD
utan	u AF t a AD n
utara	u AF t a AD r a AD
vetsin	v ɛ AD t ʃ i AD n
visite	v i AD s i AD t ə AD
vokal	v o AF k a AD l
w	w AC ɛ AD
waduh	w AC a AD d ʊ AF h AA
wafat	w AC a AD f a AD t̚
wagyu	w AC a AD ɡʲ u AF
wahana	w AC a AD h AA a AD n a AD
wajah	w AC a AD d ʒ a AD h AA
wajib	w AC a AD d ʒ ɪ AD p
waktu	w AC a AD k t u AF
wali	w AC a AD l i AD
wana	w AC a AD n a AD
wanara	w AC a AD n a AD r a AD
wangsa	w AC a AD ŋ s a AD
wanita	w AC a AD n i AD t a AD
wanprestasi	w AC a AD n p r e AD s t a AD s i AD
warsa	w AC a AD r s a AD
waruna	w AC a AD r u AF n a AD
wasabi	w AC a AD s a AD b i AD
wasbak	w AC a AD s b a AD k̚
wastafel	w AC a AD s t a AD f ə AD l
wayang	w AC a AD j AB a AD ŋ
wazari	w AC a AD z a AD r i AD
weker	w AC ɛ AD k ə AD r
wibu	w AC i AD b u AF
wicara	w AC i AD t ʃ a AD r a AD
widyaiswara	w AC i AD t j AB a AD i AD s ʋ AC a AD r a AD
wihara	w AC i AD h AA a AD r a AD
wilapa	w AC i AD l a AD p a AD
wilayah	w AC i AD l aː AE y AF ɑː AE
wira	w AC i AD r a AD
wol	w AC ɔ AF l
wortel	w AC o AF r t ə AD l
wreda	w AC r ə AD d a AD
x	ɛ AD k s
yakitori	j AB a AD k i AD t o AF r i AD
yen	j AB ɛ AD n
yogyakarta	j AB o AF ɡ j AB a AD k a AD r t a AD
yudisium	j AB u AF d i AD s i AD ʊ AF m
yuyitsu	j AB u AF j AB i AD t s u AF
zen	z ɛ AD n
