က	k AC a̰ AL
ကကုသန်	k AC a̰ AL k AC ṵ θ AJ a AL ɴ AG
ကကုသန်ဘုရား	k AC a̰ AL k AC ṵ θ AJ a AL ɴ AG pʰ AI ə AL j AB a AL
ကက်စီနို	k AC ɛ AL ʔ AC s AJ i AL n AG o AM
ကက်ပတိန်	k AC ɛ AL ʔ AC p AH ə AL t AC e AL ɪ AL ɴ AG
ကက်သလစ်	k AC ɛ AL ʔ AC θ AJ ə AL l AE ɪ AL ʔ AC
ကကြီး	k AC a̰ AL d AC ʑ AJ i AL
ကချင်	k AC ə AL t AC ɕʰ BA ɪ AL ɴ AG
ကချေသည်	k AC a̰ AL d AC ʑ AJ e AL ð AJ e AL
ကင်ဆာရောဂါ	k AC ɪ AL ɴ AG sʰ BA a AL j AB ɔ AM ɡ AC a AL
ကင်ညာ	k AC ɪ AL ɴ AG ɲ AG a AL
ကင်ပွန်း	k AC ɪ AL ɴ AG b AH ʊ AM ɴ AG
ကင်မရာ	k AC ɪ AL ɴ AG m AF ə AL ɹ AB a AL
ကင်မရွန်း	k AC ɪ AL ɴ AG m AF a̰ AL ɹ AB ʊ AM ɴ AG
ကင်း	k AC ɪ AL ɴ AG
ကင်းခြေများ	k AC ɪ AL ɴ AG t AC ɕ AJ i AL m AF j AB a AL
ကင်းပုံ	k AC ɪ AL ɴ AG b AH o AM ʊ AM ɴ AG
ကင်းမြီးကောက်	k AC ɪ AL ɴ AG m AF j AB i AL ɡ AC a AL ʊ AM ʔ AC
ကင်းမွန်	k AC ɪ AL ɴ AG m AF ʊ AM ɴ AG
ကစား	ɡ AC ə AL z AJ a AL
ကစားကွင်း	ɡ AC ə AL z AJ a AL ɡ AC w AK ɪ AL ɴ AG
ကစားစရာ	ɡ AC ə AL z AJ a AL z AJ ə AL j AB a AL
ကစားသမား	ɡ AC ə AL s AJ a AL ð AJ ə AL m AF a AL
ကဆုန်	k AC ə AL sʰ BA o AM ʊ AM ɴ AG
ကဆုန်လပြည့်နေ့	k AC ə AL sʰ BA o AM ʊ AM ɴ AG l AE a̰ AL p AH j AB ḭ n AG ḛ
ကညာ	k AC ə AL ɲ AG a AL
ကညွတ်ရိုး	k AC ə AL ɲ AG ʊ AM ʔ AC j AB o AM
ကဏန်း	ɡ AC ə AL n AG a AL ɴ AG
ကဏ္ဍ	k AC a AL n AG d AC a̰ AL
ကတည်းက	ɡ AC ə AL d AC ɛ AL ɡ AC a̰ AL
ကတိ	ɡ AC ə AL d AC ḭ
ကတော့	ɡ AC ə AL d AC ɔ̰ AM
ကတော်	ɡ AC ə AL d AC ɔ AM
ကတ္တား	k AC a AL ʔ AC t AC a AL
ကတ္တီပါ	ɡ AC ə AL d AC i AL b AH a AL
ကတ်	k AC a AL ʔ AC
ကတ်ကြေး	k AC a AL ʔ AC t AC ɕ AJ i AL
ကတ်ကြေးကိုက်	k AC a AL ʔ AC t AC ɕ AJ i AL k AC a AL ɪ AL ʔ AC
ကတ်ပြား	k AC a AL ʔ AC p AH j AB a AL
ကတ်သလိတ်	k AC a AL ʔ AC θ AJ ə AL l AE e AL ɪ AL ʔ AC
ကတွတ်ယို	k AC ə AL d AC ʊ AM ʔ AC j AB o AM
ကထိန်	k AC ə AL tʰ AD e AL ɪ AL ɴ AG
ကဒ်	k AC a AL d AC
ကနခို	k AC ə AL n AG ə AL kʰ AD o AM
ကနစိုး	k AC ə AL n AG ə AL z AJ o AM
ကနား	k AC ə AL n AG a AL
ကနုကမာ	k AC ə AL n AG ṵ k AC ə AL m AF a AL
ကနုတ်	k AC ə AL n AG o AM ʊ AM ʔ AC
ကနေဒါ	k AC a̰ AL n AG e AL d AC a AL
ကန့်	k AC a̰ AL ɴ AG
ကန့်လန့်ကာ	k AC ə AL l AE ə AL ɡ AC a AL
ကန္တာရ	k AC a AL ɴ AG t AC a AL j AB a̰ AL
ကန်	k AC a AL ɴ AG
ကန်စွန်း	ɡ AC ə AL z AJ ʊ AM ɴ AG
ကန်စွန်းဥ	ɡ AC ə AL z AJ ʊ AM ɴ AG ʔ AC ṵ
ကန်တော့	ɡ AC ə AL d AC ɔ̰ AM
ကန်ထရိုက်	k AC a AL ɴ AG tʰ AD ə AL ɹ AB a AL ɪ AL ʔ AC
ကပ္ပလီ	k AC a AL ʔ AC p AH ə AL l AE i AL
ကပ္ပလီပင်လယ်	k AC a AL ʔ AC p AH ə AL l AE i AL p AH ɪ AL ɴ AG l AE ɛ AL
ကပ်	k AC a AL ʔ AC
ကပ်ကြီးသုံးပါး	k AC a AL ʔ AC d AC ʑ AJ i AL θ AJ o AM ʊ AM ɴ AG b AH a AL
ကပ်နာ	k AC a AL ʔ AC n AG a AL
ကပ်ပယ်	k AC a AL ʔ AC p AH ɛ AL
ကပ်ပါး	k AC a AL ʔ AC p AH a AL
ကပ်ရောဂါ	k AC a AL ʔ AC j AB ɔ AM ɡ AC a AL
ကပွဲရုံ	k AC a̰ AL b AH w AK ɛ AL j AB o AM ʊ AM ɴ AG
ကဖီး	k AC ə AL pʰ AI i AL
ကဗျာ	ɡ AC ə AL b AH j AB a AL
ကဘီလူး	k AC a̰ AL b AH ə AL l AE u AM
ကမန်	k AC a̰ AL m AF a AL ɴ AG
ကမာ	k AC ə AL m AF a AL
ကမာရွတ်	k AC ə AL m AF a AL j AB ʊ AM ʔ AC
ကမ္ဗလာ	ɡ AC ə AL b AH ə AL l AE a AL
ကမ္ဗောဇ	k AC a AL ɴ AG b AH ɔ AM z AJ a̰ AL
ကမ္ဘာ	ɡ AC ə AL b AH a AL
ကမ္ဘာဂြိုဟ်	ɡ AC ə AL b AH a AL d AC ʑ AJ o AM
ကမ္ဘာလုံးခြမ်း	ɡ AC ə AL b AH a AL l AE o AM ʊ AM ɴ AG d AC ʑ AJ a AL ɴ AG
ကမ္ဘောဒီးယား	k AC a AL ɴ AG b AH ɔ AM d AC i AL j AB a AL
ကမ်စော်	k AC a AL ɴ AG z AJ ɔ AM
ကမ်း	k AC a AL ɴ AG
ကမ်းခြေ	k AC a AL ɴ AG d AC ʑ AJ e AL
ကယား	k AC ə AL j AB a AL
ကယ်တင်ရှင်	k AC ɛ AL t AC ɪ AL ɴ AG ʃ AJ ɪ AL ɴ AG
ကယ်လဆီယမ်	k AC ɛ AL l AE ə AL sʰ BA i AL j AB a AL ɴ AG
ကရင်	k AC ə AL j AB ɪ AL ɴ AG
ကရစ်ကက်	k AC ə AL ɹ AB ɪ AL ʔ AC k AC ɛ AL ʔ AC
ကရဝိက်	k AC ə AL ɹ AB a̰ AL w AK e AL ɪ AL ʔ AC
ကရိန်း	k AC ə AL ɹ AB e AL ɪ AL ɴ AG
ကလပ်	k AC ə AL l AE a AL ʔ AC
ကလမောင်း	k AC ə AL l AE ə AL m AF a AL ʊ AM ɴ AG
ကလာပ်စည်း	k AC ə AL l AE a AL ʔ AC s AJ i AL
ကလိုရင်း	k AC ə AL l AE o AM ɹ AB ɪ AL ɴ AG
ကလီစာ	k AC ə AL l AE i AL z AJ a AL
ကလောင်	k AC ə AL l AE a AL ʊ AM ɴ AG
ကလေး	kʰ AD ə AL l AE e AL
ကလျာ	k AC ə AL l AE ə AL j AB a AL
ကလျာဏမိတ္တ	k AC ə AL l AE ə AL j AB a AL n AG a̰ AL m AF e AL ɪ AL ʔ AC t AC a̰ AL
ကလျာဏီ	k AC ə AL l AE ə AL j AB a AL n AG i AL
ကဝိ	k AC ə AL w AK ḭ
ကဝေ	k AC ə AL w AK e AL
ကသည်း	k AC ə AL θ AJ i AL
ကာ	k AC a AL
ကာကွယ်	k AC a AL ɡ AC w AK ɛ AL
ကာကွယ်ဆေး	k AC a AL ɡ AC w AK ɛ AL z AJ e AL
ကာကွယ်ရေး	k AC a AL ɡ AC w AK ɛ AL j AB e AL
ကာဂစ်စတန်	k AC ə AL ɡ AC ɪ AL ʔ AC s AJ ə AL t AC a AL ɴ AG
ကာဂျစ္စတန်	k AC ə AL d AC ʑ AJ ɪ AL ʔ AC s AJ ə AL t AC a AL ɴ AG
ကာဇက်စတန်	k AC a AL z AJ ɛ AL ʔ AC s AJ ə AL t AC a AL ɴ AG
ကာတာ	k AC a AL t AC a AL
ကာတွန်း	k AC a AL t AC ʊ AM ɴ AG
ကာဗွန်	k AC a AL b AH ʊ AM ɴ AG
ကာမ	k AC a AL m AF a̰ AL
ကာယ	k AC ə AL j AB a̰ AL
ကာယကံ	k AC a AL j AB ə AL ɡ AC a AL ɴ AG
ကာယပညာ	k AC a AL j AB a̰ AL p AH a̰ AL ɲ AG a AL
ကာရန်	k AC ə AL j AB a AL ɴ AG
ကာလ	k AC a AL l AE a̰ AL
ကာလဝမ်း	k AC a AL l AE ə AL w AK ʊ AM ɴ AG
ကာလသား	k AC a AL l AE ə AL ð AJ a AL
ကာလသားရောဂါ	k AC a AL l AE a̰ AL θ AJ a AL j AB ɔ AM ɡ AC a AL
ကာလာမသုတ်	k AC a AL l AE a AL m AF a̰ AL θ AJ o AM ʊ AM ʔ AC
ကာလီဖိုးနီးယား	k AC a AL l AE i AL pʰ AI o AM n AG i AL j AB a AL
ကား	k AC a AL
ကားဂိတ်	k AC a AL ɡ AC e AL ɪ AL ʔ AC
ကားမှတ်တိုင်	k AC a AL m̥ AF a AL ʔ AC t AC a AL ɪ AL ɴ AG
ကားရုံ	k AC a AL j AB o AM ʊ AM ɴ AG
ကိစ္စ	k AC e AL ɪ AL ʔ AC s AJ a̰ AL
ကိတ်	k AC e AL ɪ AL ʔ AC
ကိတ်ဗာဒီ	k AC e AL ɪ AL ʔ AC b AH ə AL d AC i AL
ကိတ်မုန့်	k AC e AL ɪ AL ʔ AC m AF o̰ AM ʊ AM ɴ AG
ကိန္နရာ	k AC e AL ɪ AL ɴ AG n AG ə AL j AB a AL
ကိန္နရီ	k AC e AL ɪ AL ɴ AG n AG ə AL j AB i AL
ကိန်း	k AC e AL ɪ AL ɴ AG
ကိမိလဗေဒ	k AC ḭ m AF ḭ l AE a̰ AL b AH e AL d AC a̰ AL
ကိရိယာ	k AC ə AL ɹ AB ḭ j AB a AL
ကိလေသာ	k AC ḭ l AE e AL θ AJ a AL
ကို	ʔ AC
ကိုကာကိုလာ	k AC o AM k AC a AL k AC o AM l AE a AL
ကိုက်	k AC a AL ɪ AL ʔ AC
ကိုက်လန်	k AC a AL ɪ AL ʔ AC l AE a AL ɴ AG
ကိုင်	k AC a AL ɪ AL ɴ AG
ကိုဆိုဗို	k AC o AM sʰ BA o AM b AH o AM
ကိုဘော့	k AC o AM b AH ɔ̰ AM
ကိုမိုရို	k AC o AM m AF o AM ɹ AB o AM
ကိုယ့်ဥမှဥထင်	k AC o̰ AM j AB ʔ AC ṵ m̥ AF a̰ AL ʔ AC ṵ tʰ AD ɪ AL ɴ AG
ကိုယ်	k AC o AM
ကိုယ်စားလှယ်	k AC o AM j AB z AJ ə AL l̥ AE ɛ AL
ကိုယ်လုပ်တော်	k AC o AM l AE o AM ʊ AM ʔ AC t AC ɔ AM
ကိုယ်ဝန်	k AC o AM j AB w AK ʊ AM ɴ AG
ကိုယ်ဝန်ဆောင်	k AC o AM j AB w AK ʊ AM ɴ AG sʰ BA a AL ʊ AM ɴ AG
ကိုယ်ဝန်ရှိ	k AC o AM j AB w AK ʊ AM ɴ AG ʃ AJ ḭ
ကိုရမ်ကျမ်း	k AC o AM ɹ AB a AL ɴ AG t AC ɕ AJ a AL ɴ AG
ကိုရီးယား	k AC o AM ɹ AB i AL j AB a AL
ကိုလိုနီ	k AC o AM l AE o AM n AG i AL
ကိုလံဘီယာ	k AC o AM l AE a AL ɴ AG b AH i AL j AB a AL
ကိုး	k AC o AM
ကိုးကန့်	k AC o AM ɡ AC a̰ AL ɴ AG
ကိုးလ	k AC o AM l AE a̰ AL
ကီလိုဂရမ်	k AC i AL l AE o AM ɡ AC ə AL ɹ AB a AL ɴ AG
ကီးမား	k AC i AL m AF a AL
ကီးယက်	k AC i AL j AB ɛ AL ʔ AC
ကုဋေ	ɡ AC ə AL d AC e AL
ကုတ်	k AC o AM ʊ AM ʔ AC
ကုတ်ဟီးနာ	k AC o AM ʊ AM ʔ AC h AA i AL n AG a AL
ကုန်	k AC o AM ʊ AM ɴ AG
ကုန်ကား	k AC o AM ʊ AM ɴ AG ɡ AC a AL
ကုန်ကုန်	k AC o AM ʊ AM ɴ AG ɡ AC o AM ʊ AM ɴ AG
ကုန်စည်	k AC o AM ʊ AM ɴ AG z AJ i AL
ကုန်တင်ကား	k AC o AM ʊ AM ɴ AG d AC ɪ AL ɴ AG ɡ AC a AL
ကုန်သည်	k AC o AM ʊ AM ɴ AG ð AJ e AL
ကုန်း	k AC o AM ʊ AM ɴ AG
ကုန်းနှီး	k AC o AM ʊ AM ɴ AG n̥ AG i AL
ကုဗ	k AC ṵ b AH a̰ AL
ကုမ္ပဏီ	k AC o AM ʊ AM ɴ AG p AH ə AL n AG i AL
ကုလသမဂ္ဂ	k AC ṵ l AE a̰ AL θ AJ a̰ AL m AF ɛ AL ʔ AC ɡ AC a̰ AL
ကုလား	k AC ə AL l AE a AL
ကုလားထိုင်	k AC ə AL l AE ə AL tʰ AD a AL ɪ AL ɴ AG
ကုလားနို့	k AC ə AL l AE ə AL n AG o̰ AM
ကုလားပဲ	k AC ə AL l AE ə AL p AH ɛ AL
ကုလားဖြူ	k AC ə AL l AE ə AL pʰ AI j AB u AM
ကုလားအုတ်	k AC ə AL l AE ə AL ʔ AC o AM ʊ AM ʔ AC
ကုသိုလ်	k AC ṵ θ AJ o AM
ကုသိုလ်ကံ	k AC ṵ ð AJ o AM ɡ AC a AL ɴ AG
ကုသိုလ်ရှင်	k AC ṵ θ AJ o AM ʃ AJ ɪ AL ɴ AG
ကုံကုမံ	ɡ AC o AM ʊ AM ɴ AG ɡ AC ə AL m AF a AL ɴ AG
ကူ	k AC u AM
ကူညီ	k AC u AM ɲ AG i AL
ကူဖီ	k AC u AM pʰ AI i AL
ကူလီ	k AC u AM l AE i AL
ကူဝိတ်	k AC u AM w AK e AL ɪ AL ʔ AC
ကူး	k AC u AM
ကူးစက်ရောဂါ	k AC u AM z AJ ɛ AL ʔ AC j AB ɔ AM ɡ AC a AL
ကူးတို့	ɡ AC ə AL d AC o̰ AM
ကူးတို့ဆိပ်	ɡ AC ə AL d AC o̰ AM z AJ e AL ɪ AL ʔ AC
ကူးပြောင်း	k AC u AM p AH j AB a AL ʊ AM ɴ AG
ကေ	k AC e AL
ကေတုမဒီ	k AC e AL t AC ṵ m AF ə AL d AC i AL
ကေသ	k AC e AL θ AJ a̰ AL
ကေသာ	k AC e AL θ AJ a AL
ကော	ɡ AC ɔ AM
ကောက်	k AC a AL ʊ AM ʔ AC
ကောက်ညှင်း	k AC a AL ʊ AM ʔ AC ɲ̊ AG ɪ AL ɴ AG
ကောက်ညှင်းပေါင်း	k AC a AL ʊ AM ʔ AC ɲ̊ AG ɪ AL ɴ AG b AH a AL ʊ AM ɴ AG
ကောက်ရိုး	k AC a AL ʊ AM ʔ AC j AB o AM
ကောင်	k AC a AL ʊ AM ɴ AG
ကောင်ငယ်	k AC a AL ʊ AM ɴ AG ŋ AG ɛ AL
ကောင်စစ်ဝန်	k AC a AL ʊ AM ɴ AG s AJ ɪ AL ʔ AC w AK ʊ AM ɴ AG
ကောင်စစ်ဝန်ရုံး	k AC a AL ʊ AM ɴ AG s AJ ɪ AL ʔ AC w AK ʊ AM ɴ AG j AB o AM ʊ AM ɴ AG
ကောင်စီ	k AC a AL ʊ AM ɴ AG s AJ i AL
ကောင်တာ	k AC a AL ʊ AM ɴ AG t AC a AL
ကောင်မငယ်	k AC a AL ʊ AM ɴ AG m AF a̰ AL ŋ AG ɛ AL
ကောင်မလေး	k AC a AL ʊ AM ɴ AG m AF a̰ AL l AE e AL
ကောင်း	k AC a AL ʊ AM ɴ AG
ကောင်းကင်	k AC a AL ʊ AM ɴ AG ɡ AC ɪ AL ɴ AG
ကောင်းကင်ကြိုး	k AC a AL ʊ AM ɴ AG ɡ AC ɪ AL ɴ AG d AC ʑ AJ o AM
ကောင်းကင်တမန်	k AC a AL ʊ AM ɴ AG ɡ AC ɪ AL ɴ AG t AC ə AL m AF a AL ɴ AG
ကောင်းကင်ဘုံ	k AC a AL ʊ AM ɴ AG ɡ AC ɪ AL ɴ AG b AH o AM ʊ AM ɴ AG
ကောင်းကောင်း	k AC a AL ʊ AM ɴ AG ɡ AC a AL ʊ AM ɴ AG
ကောဏဂုံ	k AC ɔ AM n AG ə AL ɡ AC o AM ʊ AM ɴ AG
ကောဏဂုံဘုရား	k AC ɔ AM n AG ə AL ɡ AC o AM ʊ AM ɴ AG pʰ AI ə AL j AB a AL
ကောဏ္ဍည	k AC ɔ AM n AG d AC ə AL ɲ AG a̰ AL
ကောဏ္ဍညဘုရား	k AC ɔ AM n AG d AC ə AL ɲ AG a̰ AL pʰ AI ə AL j AB a AL
ကောလာဟလ	k AC ɔ AM l AE a AL h AA a̰ AL l AE a̰ AL
ကောလိပ်	k AC ɔ AM l AE e AL ɪ AL ʔ AC
ကောလိသိန်	k AC ɔ AM l AE ḭ θ AJ e AL ɪ AL ɴ AG
ကော့စတာရီကာ	k AC ɔ̰ AM s AJ ə AL t AC a AL ɹ AB i AL k AC a AL
ကော်	k AC ɔ AM
ကော်ဇော	k AC ɔ AM z AJ ɔ AM
ကော်တွန်	k AC ɔ AM t AC ʊ AM ɴ AG
ကော်ပီ	k AC ɔ AM p AH i AL
ကော်ပီစာအုပ်	k AC ɔ AM p AH i AL s AJ a AL ʔ AC o AM ʊ AM ʔ AC
ကော်ပြန့်	k AC ɔ AM p AH j AB a̰ AL ɴ AG
ကော်ပြန့်ကြော်	k AC ɔ AM p AH j AB a̰ AL ɴ AG d AC ʑ AJ ɔ AM
ကော်ပြန့်စိမ်း	k AC ɔ AM p AH j AB a̰ AL ɴ AG z AJ e AL ɪ AL ɴ AG
ကော်ဖီ	k AC ɔ AM pʰ AI i AL
ကော်မတီ	k AC ɔ AM m AF ə AL t AC i AL
ကော်ရည်ခေါက်ဆွဲ	k AC ɔ AM j AB i AL kʰ AD a AL ʊ AM ʔ AC sʰ BA w AK ɛ AL
ကော်လာ	k AC ɔ AM l AE a AL
ကဲ့	k AC ɛ̰ AL
ကံ	k AC a AL ɴ AG
ကံကြမ္မာ	k AC a AL ɴ AG t AC ɕ AJ ə AL m AF a AL
ကံသုံးပါး	k AC a AL ɴ AG θ AJ o AM ʊ AM ɴ AG b AH a AL
ကံ့ကူတံ	k AC a̰ AL ɴ AG ɡ AC u AM d AC a AL ɴ AG
ကံ့ကော်	ɡ AC a̰ AL ɴ AG ɡ AC ɔ AM
ကျ	t AC ɕ AJ a̰ AL
ကျက်သရေ	t AC ɕ AJ ɛ AL ʔ AC θ AJ ə AL j AB e AL
ကျင်ကြီး	t AC ɕ AJ ɪ AL ɴ AG d AC ʑ AJ i AL
ကျင်ချောင်း	t AC ɕ AJ ɪ AL ɴ AG t AC ɕʰ BA a AL ʊ AM ɴ AG
ကျင်စွယ်	t AC ɕ AJ ɪ AL ɴ AG z AJ w AK ɛ AL
ကျဉ်း	t AC ɕ AJ ɪ AL ɴ AG
ကျဉ်းကျပ်	t AC ɕ AJ ɪ AL ɴ AG t AC ɕ AJ a AL ʔ AC
ကျည်	t AC ɕ AJ i AL
ကျည်ကပ်	t AC ɕ AJ i AL ɡ AC a AL ʔ AC
ကျည်ဖူး	t AC ɕ AJ i AL b AH u AM
ကျနော်	t AC ɕ AJ ə AL n AG ɔ AM
ကျန်	t AC ɕ AJ a AL ɴ AG
ကျန်း	t AC ɕ AJ a AL ɴ AG
ကျန်းမာရေး	t AC ɕ AJ a AL ɴ AG m AF a AL j AB e AL
ကျပ်	t AC ɕ AJ a AL ʔ AC
ကျပ်သား	t AC ɕ AJ a AL ʔ AC θ AJ a AL
ကျမ	t AC ɕ AJ ə AL m AF a̰ AL
ကျယ်	t AC ɕ AJ ɛ AL
ကျယ်ဝန်း	t AC ɕ AJ ɛ AL w AK ʊ AM ɴ AG
ကျား	t AC ɕ AJ a AL
ကျားကျားလျားလျား	t AC ɕ AJ a AL d AC ʑ AJ a AL j AB a AL j AB a AL
ကျားမ	t AC ɕ AJ a AL m AF a̰ AL
ကျားမျက်လုံး	t AC ɕ AJ a AL m AF j AB ɛ AL ʔ AC l AE o AM ʊ AM ɴ AG
ကျားလက်သည်း	t AC ɕ AJ a AL l AE ɛ AL ʔ AC θ AJ ɛ AL
ကျားလျှာ	t AC ɕ AJ a AL ʃ AJ a AL
ကျားသစ်	t AC ɕ AJ ə AL θ AJ ɪ AL ʔ AC
ကျိန္တလီ	t AC ɕ AJ e AL ɪ AL ɴ AG t AC a̰ AL l AE i AL
ကျိန်း	t AC ɕ AJ e AL ɪ AL ɴ AG
ကျို	t AC ɕ AJ o AM
ကျိုက္ခမီ	t AC ɕ AJ a AL ɪ AL ʔ AC kʰ AD ə AL m AF i AL
ကျိုက်ထို	t AC ɕ AJ a AL ɪ AL ʔ AC tʰ AD o AM
ကျိုက်ထီးရိုး	t AC ɕ AJ a AL ɪ AL ʔ AC tʰ AD i AL j AB o AM
ကျိုက်မရော	t AC ɕ AJ a AL ɪ AL ʔ AC m AF ə AL ɹ AB ɔ AM
ကျိုင်းတုံ	t AC ɕ AJ a AL ɪ AL ɴ AG t AC o AM ʊ AM ɴ AG
ကျီး	t AC ɕ AJ i AL
ကျီးအ	t AC ɕ AJ i AL ʔ AC a̰ AL
ကျုပ်	t AC ɕ AJ o AM ʊ AM ʔ AC
ကျုပ်တို့	t AC ɕ AJ o AM ʊ AM ʔ AC t AC o̰ AM
ကျူးဘား	t AC ɕ AJ u AM b AH a AL
ကျော	t AC ɕ AJ ɔ AM
ကျောက်	t AC ɕ AJ a AL ʊ AM ʔ AC
ကျောက်ကပ်	t AC ɕ AJ a AL ʊ AM ʔ AC k AC a AL ʔ AC
ကျောက်ကြီး	t AC ɕ AJ a AL ʊ AM ʔ AC t AC ɕ AJ i AL
ကျောက်ဂွမ်း	t AC ɕ AJ a AL ʊ AM ʔ AC ɡ AC ʊ AM ɴ AG
ကျောက်စိမ်း	t AC ɕ AJ a AL ʊ AM ʔ AC s AJ e AL ɪ AL ɴ AG
ကျောက်နီ	t AC ɕ AJ a AL ʊ AM ʔ AC n AG i AL
ကျောက်ပွင့်သုပ်	t AC ɕ AJ a AL ʊ AM ʔ AC p AH w AK ɪ̰ AL ɴ AG θ AJ o AM ʊ AM ʔ AC
ကျောက်ဖရုံ	t AC ɕ AJ a AL ʊ AM ʔ AC pʰ AI ə AL j AB o AM ʊ AM ɴ AG
ကျောက်ဖြူ	t AC ɕ AJ a AL ʊ AM ʔ AC pʰ AI j AB u AM
ကျောက်မီး	t AC ɕ AJ a AL ʊ AM ʔ AC m AF i AL
ကျောက်မီးသွေး	t AC ɕ AJ a AL ʊ AM ʔ AC m AF i AL ð AJ w AK e AL
ကျောက်သင်ပုန်း	t AC ɕ AJ a AL ʊ AM ʔ AC θ AJ ɪ AL ɴ AG b AH o AM ʊ AM ɴ AG
ကျောင်း	t AC ɕ AJ a AL ʊ AM ɴ AG
ကျောင်းနေဖက်	t AC ɕ AJ a AL ʊ AM ɴ AG n AG e AL b AH ɛ AL ʔ AC
ကျောင်းသား	t AC ɕ AJ a AL ʊ AM ɴ AG ð AJ a AL
ကျောင်းသုံးစာအုပ်	t AC ɕ AJ a AL ʊ AM ɴ AG ð AJ o AM ʊ AM ɴ AG s AJ a AL ʔ AC o AM ʊ AM ʔ AC
ကျောင်းသူ	t AC ɕ AJ a AL ʊ AM ɴ AG ð AJ u AM
ကျောပိုးအိတ်	t AC ɕ AJ ɔ AM b AH o AM ʔ AC e AL ɪ AL ʔ AC
ကျောရိုး	t AC ɕ AJ ɔ AM j AB o AM
ကျေးဇူး	t AC ɕ AJ e AL z AJ u AM
ကျေးဇူးတင်	t AC ɕ AJ e AL z AJ u AM t AC ɪ AL ɴ AG
ကျေးဇူးတင်ပါတယ်	t AC ɕ AJ e AL z AJ u AM t AC ɪ AL ɴ AG b AH a AL d AC ɛ AL
ကျေးဇူးပြု၍	t AC ɕ AJ e AL z AJ u AM p AH j AB ṵ j AB w AK ḛ
ကျေးဇူးရှင်	t AC ɕ AJ e AL z AJ u AM ʃ AJ ɪ AL ɴ AG
ကျဲ	t AC ɕ AJ ɛ AL
ကျွန်	t AC ɕ AJ ʊ AM ɴ AG
ကျွန်တော့်	t AC ɕ AJ ʊ AM ɴ AG d AC ɔ̰ AM
ကျွန်တော်	t AC ɕ AJ ʊ AM ɴ AG d AC ɔ AM
ကျွန်တော်တို့	t AC ɕ AJ ʊ AM ɴ AG d AC ɔ AM d AC o̰ AM
ကျွန်မ	t AC ɕ AJ ʊ AM ɴ AG m AF a̰ AL
ကျွန်မတို့	t AC ɕ AJ ʊ AM ɴ AG m AF a̰ AL d AC o̰ AM
ကျွန်း	t AC ɕ AJ ʊ AM ɴ AG
ကျွန်းကလေး	t AC ɕ AJ ʊ AM ɴ AG ɡ AC ə AL l AE e AL
ကျွန်းကိုင်းမှီကိုင်းကျွန်းမှီ	t AC ɕ AJ ʊ AM ɴ AG k AC a AL ɪ AL ɴ AG m̥ AF i AL k AC a AL ɪ AL ɴ AG t AC ɕ AJ ʊ AM ɴ AG m̥ AF i AL
ကျွန်းဆွယ်	t AC ɕ AJ ʊ AM ɴ AG z AJ w AK ɛ AL
ကျွဲ	t AC ɕ AJ w AK ɛ AL
ကျွဲကော	t AC ɕ AJ w AK ɛ AL ɡ AC ɔ AM
ကျွဲပြည့်စင်	t AC ɕ AJ w AK ɛ AL p AH j AB ḭ z AJ ɪ AL ɴ AG
ကြက်	t AC ɕ AJ ɛ AL ʔ AC
ကြက်ခြေ	t AC ɕ AJ ɛ AL ʔ AC t AC ɕʰ BA e AL
ကြက်ခြေနီ	t AC ɕ AJ ɛ AL ʔ AC t AC ɕʰ BA e AL n AG i AL
ကြက်ခြေနီအသင်း	t AC ɕ AJ ɛ AL ʔ AC t AC ɕʰ BA e AL n AG i AL ʔ AC ə AL θ AJ ɪ AL ɴ AG
ကြက်ဆင်	t AC ɕ AJ ɛ AL ʔ AC sʰ BA ɪ AL ɴ AG
ကြက်ဆီထမင်း	t AC ɕ AJ ɛ AL ʔ AC sʰ BA i AL tʰ AD ə AL m AF ɪ AL ɴ AG
ကြက်ဆူ	t AC ɕ AJ ɛ AL ʔ AC sʰ BA u AM
ကြက်တူရွေး	t AC ɕ AJ ɛ AL ʔ AC t AC u AM j AB w AK e AL
ကြက်ဖ	t AC ɕ AJ ɛ AL ʔ AC pʰ AI a̰ AL
ကြက်မ	t AC ɕ AJ ɛ AL ʔ AC m AF a̰ AL
ကြက်မောက်	t AC ɕ AJ ɛ AL ʔ AC m AF a AL ʊ AM ʔ AC
ကြက်မောက်သီး	t AC ɕ AJ ɛ AL ʔ AC m AF a AL ʊ AM ʔ AC θ AJ i AL
ကြက်သား	t AC ɕ AJ ɛ AL ʔ AC θ AJ a AL
ကြက်သီးထ	t AC ɕ AJ ɛ AL ʔ AC θ AJ e AL ɪ AL ɴ AG tʰ AD a̰ AL
ကြက်သီးမွေးညင်းထ	t AC ɕ AJ ɛ AL ʔ AC θ AJ e AL ɪ AL ɴ AG m AF w AK e AL ɲ AG ɪ AL ɴ AG tʰ AD a̰ AL
ကြက်သွန်	t AC ɕ AJ ɛ AL ʔ AC θ AJ ʊ AM ɴ AG
ကြက်သွန်နီ	t AC ɕ AJ ɛ AL ʔ AC θ AJ ʊ AM ɴ AG n AG i AL
ကြက်သွန်ဖြူ	t AC ɕ AJ ɛ AL ʔ AC θ AJ ʊ AM ɴ AG b AH j AB u AM
ကြက်သွန်မြိတ်	t AC ɕ AJ ɛ AL ʔ AC θ AJ ʊ AM ɴ AG m AF j AB e AL ɪ AL ʔ AC
ကြက်ဟင်းခါးသီး	t AC ɕ AJ ɛ AL ʔ AC h AA ɪ AL ɴ AG ɡ AC a AL ð AJ i AL
ကြက်အူချောင်း	t AC ɕ AJ ɛ AL ʔ AC ʔ AC u AM d AC ʑ AJ a AL ʊ AM ɴ AG
ကြခတ်ဝါး	t AC ɕ AJ ə AL kʰ AD a AL ʔ AC w AK a AL
ကြငှန်း	t AC ɕ AJ ə AL ŋ̊ AG a AL ɴ AG
ကြဉ်	t AC ɕ AJ ɪ AL ɴ AG
ကြည့်	t AC ɕ AJ ḭ
ကြည့်မြင်တိုင်	t AC ɕ AJ ḭ m AF j AB ɪ AL ɴ AG d AC a AL ɪ AL ɴ AG
ကြည်	t AC ɕ AJ ɪ AL ɴ AG
ကြည်းတပ်	t AC ɕ AJ i AL d AC a AL ʔ AC
ကြမ္မာ	t AC ɕ AJ ə AL m AF a AL
ကြမ်း	t AC ɕ AJ a AL ɴ AG
ကြယ်	t AC ɕ AJ ɛ AL
ကြယ်စု	t AC ɕ AJ ɛ AL z AJ ṵ
ကြယ်တံခွန်	t AC ɕ AJ ɛ AL d AC ə AL ɡ AC ʊ AM ɴ AG
ကြယ်သီး	t AC ɕ AJ ɛ AL θ AJ i AL
ကြာ	t AC ɕ AJ a AL
ကြာကြာ	t AC ɕ AJ a AL d AC ʑ AJ a AL
ကြာချည်	t AC ɕ AJ a AL t AC ɕʰ BA i AL
ကြာဆံ	t AC ɕ AJ a AL z AJ a AL ɴ AG
ကြာဆံသုပ်	t AC ɕ AJ a AL z AJ a AL ɴ AG θ AJ o AM ʊ AM ʔ AC
ကြာညို့	t AC ɕ AJ a AL ɲ AG o̰ AM
ကြာသပတေး	t AC ɕ AJ a AL θ AJ a̰ AL p AH a̰ AL d AC e AL
ကြား	t AC ɕ AJ a AL
ကြိမ်	t AC ɕ AJ e AL ɪ AL ɴ AG
ကြိယာ	k AC ə AL ɹ AB ḭ j AB a AL
ကြိယာဝိသေသန	k AC ə AL ɹ AB ḭ j AB a AL w AK ḭ θ AJ e AL θ AJ ə AL n AG a̰ AL
ကြိုက်	t AC ɕ AJ a AL ɪ AL ʔ AC
ကြိုဆိုပါ၏	t AC ɕ AJ o AM z AJ o AM b AH a AL ʔ AC ɛ̰ AL
ကြို့	t AC ɕ AJ o̰ AM
ကြိုး	t AC ɕ AJ o AM
ကြိုးကြာ	d AC ʑ AJ o AM d AC ʑ AJ a AL
ကြိုးစင်	t AC ɕ AJ o AM z AJ ɪ AL ɴ AG
ကြိုးစား	t AC ɕ AJ o AM z AJ a AL
ကြီး	t AC ɕ AJ i AL
ကြီးကြီး	t AC ɕ AJ i AL d AC ʑ AJ i AL
ကြီးမား	t AC ɕ AJ i AL m AF a AL
ကြောက်	t AC ɕ AJ a AL ʊ AM ʔ AC
ကြောင့်	d AC ʑ AJ a̰ AL ʊ AM ɴ AG
ကြောင်	t AC ɕ AJ a AL ʊ AM ɴ AG
ကြောင်ကလေး	t AC ɕ AJ a AL ʊ AM ɴ AG ɡ AC ə AL l AE e AL
ကြောင်ထီး	t AC ɕ AJ a AL ʊ AM ɴ AG d AC i AL
ကြောင်မ	t AC ɕ AJ a AL ʊ AM ɴ AG m AF a̰ AL
ကြောင်လိမ်လှေကား	t AC ɕ AJ a AL ʊ AM ɴ AG l AE e AL ɪ AL ɴ AG l̥ AE e AL ɡ AC a AL
ကြောင်အိမ်	t AC ɕ AJ a AL ʊ AM ɴ AG ʔ AC e AL ɪ AL ɴ AG
ကြော်	t AC ɕ AJ ɔ AM
ကြော်ငြာ	t AC ɕ AJ ɔ AM ɲ AG a AL
ကြော်ငြာစာ	t AC ɕ AJ ɔ AM ɲ AG a AL z AJ a AL
ကြေး	t AC ɕ AJ e AL
ကြေးကြီး	t AC ɕ AJ e AL t AC ɕ AJ i AL
ကြေးငွေ	t AC ɕ AJ e AL ŋ AG w AK e AL
ကြေးစည်	t AC ɕ AJ e AL z AJ i AL
ကြေးနန်း	t AC ɕ AJ e AL n AG a AL ɴ AG
ကြေးနီ	t AC ɕ AJ e AL n AG i AL
ကြေးမုံ	t AC ɕ AJ e AL m AF o AM ʊ AM ɴ AG
ကြေးဝါ	t AC ɕ AJ e AL w AK a AL
ကြေးအိုး	t AC ɕ AJ e AL ʔ AC o AM
ကြံ	t AC ɕ AJ a AL ɴ AG
ကြံ့	t AC ɕ AJ a̰ AL ɴ AG
ကြံ့လျော်	t AC ɕ AJ a̰ AL ɴ AG ʃ AJ ɔ AM
ကြွ	t AC ɕ AJ w AK a̰ AL
ကြွက်	t AC ɕ AJ w AK ɛ AL ʔ AC
ကြွက်နို့	t AC ɕ AJ w AK ɛ AL ʔ AC n AG o̰ AM
ကြွက်သား	t AC ɕ AJ w AK ɛ AL ʔ AC θ AJ a AL
ကြွင်း	t AC ɕ AJ w AK ɪ AL ɴ AG
ကြွပ်	t AC ɕ AJ ʊ AM ʔ AC
ကြွယ်	t AC ɕ AJ w AK ɛ AL
ကြွေ	t AC ɕ AJ w AK e AL
ကြွေး	t AC ɕ AJ w AK e AL
ကွင်း	k AC w AK ɪ AL ɴ AG
ကွင်းထိုးဖိနပ်	ɡ AC w AK ɪ AL ɴ AG d AC o AM pʰ AI ə AL n AG a AL ʔ AC
ကွတ်	k AC ʊ AM ʔ AC
ကွန်	k AC ʊ AM ɴ AG
ကွန်ကရစ်	k AC ʊ AM ɴ AG ɡ AC ə AL ɹ AB ɪ AL ʔ AC
ကွန်ဂို	k AC ʊ AM ɴ AG ɡ AC o AM
ကွန်ဒုံး	k AC ʊ AM ɴ AG d AC o AM ʊ AM ɴ AG
ကွန်ပါ	k AC ʊ AM ɴ AG p AH a AL
ကွန်ပျူတာ	k AC ʊ AM ɴ AG p AH j AB u AM t AC a AL
ကွန်ဖရင့်	k AC ʊ AM ɴ AG pʰ AI ə AL ɹ AB ɪ̰ AL ɴ AG
ကွန်ဖြူးရှပ်	k AC ʊ AM ɴ AG pʰ AI j AB u AM ʃ AJ a AL ʔ AC
ကွန်ရက်	k AC ʊ AM ɴ AG j AB ɛ AL ʔ AC
ကွမ်ရင်	k AC w AK a AL ɴ AG j AB ɪ AL ɴ AG
ကွမ်ရင်မယ်တော်	k AC w AK a AL ɴ AG j AB ɪ AL ɴ AG m AF ɛ AL d AC ɔ AM
ကွမ်းတောင်	k AC ʊ AM ɴ AG d AC a AL ʊ AM ɴ AG
ကွမ်းမွှေး	k AC ʊ AM ɴ AG m̥ AF w AK e AL
ကွမ်းယာ	k AC ʊ AM ɴ AG j AB a AL
ကွမ်းရွက်ပင်	k AC ʊ AM ɴ AG j AB w AK ɛ AL ʔ AC p AH ɪ AL ɴ AG
ကွယ်လွန်	k AC w AK ɛ AL l AE ʊ AM ɴ AG
ကွာစေ့	k AC w AK a AL s AJ ḭ
ကွာလာလမ်ပူ	k AC w AK a AL l AE a AL l AE a AL ɴ AG p AH u AM
ကွီး	k AC w AK i AL
ကွဲ	k AC w AK ɛ AL
ကဿပ	k AC a AL ʔ AC θ AJ ə AL p AH a̰ AL
ကဿပဘုရား	k AC a AL ʔ AC θ AJ ə AL p AH a̰ AL pʰ AI ə AL j AB a AL
ခ	kʰ AD a̰ AL
ခက်	kʰ AD ɛ AL ʔ AC
ခက်ရင်း	kʰ AD ə AL j AB ɪ AL ɴ AG
ခကွေး	kʰ AD a̰ AL ɡ AC w AK e AL
ခင်	kʰ AD ɪ AL ɴ AG
ခင်ပွန်း	kʰ AD ɪ AL ɴ AG b AH ʊ AM ɴ AG
ခင်ဗျာ	kʰ AD ə AL m AF j AB a AL
ခင်ဗျာ့	kʰ AD ɪ AL ɴ AG b AH j AB a̰ AL
ခင်ဗျား	kʰ AD ɪ AL ɴ AG b AH j AB a AL
ခင်ဗျားတို့	kʰ AD ɪ AL ɴ AG b AH j AB a AL d AC o̰ AM
ခင်မင်မှု	kʰ AD ɪ AL ɴ AG m AF ɪ AL ɴ AG m̥ AF ṵ
ခဏ	kʰ AD ə AL n AG a̰ AL
ခဏခဏ	kʰ AD ə AL n AG a̰ AL ɡ AC ə AL n AG a̰ AL
ခတ္တိယ	kʰ AD a AL ʔ AC t AC ḭ j AB a̰ AL
ခနုံထုပ်	kʰ AD ə AL n AG o AM ʊ AM ɴ AG d AC o AM ʊ AM ʔ AC
ခနုံအီ	kʰ AD ə AL n AG o AM ʊ AM ɴ AG ʔ AC i AL
ခန္တီ	kʰ AD a AL ɴ AG t AC i AL
ခန္ဓာ	kʰ AD a AL ɴ AG d AC a AL
ခန္ဓာငါးပါး	kʰ AD a AL ɴ AG d AC a AL ŋ AG a AL b AH a AL
ခန္ဓာဗေဒ	kʰ AD a AL ɴ AG d AC a AL b AH e AL d AC a̰ AL
ခန်တမာ	kʰ AD a AL ɴ AG t AC ə AL m AF a AL
ခန်း	kʰ AD a AL ɴ AG
ခပ်သိမ်း	kʰ AD a AL ʔ AC θ AJ e AL ɪ AL ɴ AG
ခမည်းတော်	kʰ AD ə AL m AF i AL d AC ɔ AM
ခမာ	kʰ AD ə AL m AF a AL
ခမောက်	kʰ AD ə AL m AF a AL ʊ AM ʔ AC
ခယ်မ	kʰ AD ɛ AL m AF a̰ AL
ခရင်း	kʰ AD ə AL j AB ɪ AL ɴ AG
ခရစ္စမတ်	kʰ AD ə AL ɹ AB ɪ AL ʔ AC s AJ ə AL m AF a AL ʔ AC
ခရစ်	kʰ AD ə AL ɹ AB ɪ AL ʔ AC
ခရစ်တော်	kʰ AD ə AL ɹ AB ɪ AL ʔ AC t AC ɔ AM
ခရစ်ယာန်	kʰ AD ə AL ɹ AB ɪ AL ʔ AC j AB a AL n AG
ခရမ်း	kʰ AD ə AL j AB a AL ɴ AG
ခရမ်းချဉ်	kʰ AD ə AL j AB a AL ɴ AG d AC ʑ AJ ɪ AL ɴ AG
ခရမ်းသီး	kʰ AD ə AL j AB a AL ɴ AG θ AJ i AL
ခရာမွှေး	kʰ AD ə AL j AB a AL m̥ AF w AK e AL
ခရိုင်	kʰ AD ə AL j AB a AL ɪ AL ɴ AG
ခရိုမီယမ်	kʰ AD ə AL ɹ AB o AM m AF i AL j AB a AL ɴ AG
ခရိုအေးရှား	kʰ AD ə AL ɹ AB o AM ʔ AC e AL ʃ AJ a AL
ခရီး	kʰ AD ə AL j AB i AL
ခရီးသည်	kʰ AD ə AL j AB i AL ð AJ e AL
ခရု	kʰ AD ə AL j AB ṵ
ခရုပက်ကျိ	kʰ AD ə AL j AB ṵ p AH ɛ AL ʔ AC t AC ɕ AJ ḭ
ခရေ	kʰ AD ə AL j AB e AL
ခလာသီ	kʰ AD ə AL l AE a AL θ AJ i AL
ခလုတ်	kʰ AD ə AL l AE o AM ʊ AM ʔ AC
ခလုတ်ခုံ	kʰ AD ə AL l AE o AM ʊ AM ʔ AC kʰ AD o AM ʊ AM ɴ AG
ခဝဲ	kʰ AD ə AL w AK ɛ AL
ခါ	kʰ AD a AL
ခါး	kʰ AD a AL
ခါးပတ်	ɡ AC ə AL b AH a AL ʔ AC
ခို	kʰ AD o AM
ခိုး	kʰ AD o AM
ခိုးစား	kʰ AD o AM s AJ a AL
ခု	kʰ AD ṵ
ခုခံအားကျရောဂါ	kʰ AD ṵ ɡ AC a AL ɴ AG ʔ AC a AL t AC ɕ AJ a̰ AL j AB ɔ AM ɡ AC a AL
ခုနစ်	kʰ AD ʊ AM ɴ AG n̥ AG ɪ AL ʔ AC
ခုနစ်လ	kʰ AD ʊ AM ɴ AG n̥ AG ə AL l AE a̰ AL
ခုန်	kʰ AD o AM ʊ AM ɴ AG
ခုံတန်းလျား	kʰ AD o AM ʊ AM ɴ AG t AC a AL ɴ AG j AB a AL
ခုံရှည်	kʰ AD o AM ʊ AM ɴ AG ʃ AJ e AL
ခေတ္တ	kʰ AD ɪ AL ʔ AC t AC a̰ AL
ခေတ်	kʰ AD ɪ AL ʔ AC
ခေမာရဋ္ဌ	kʰ AD e AL m AF a AL j AB ə AL tʰ AD a̰ AL
ခေါက်	kʰ AD a AL ʊ AM ʔ AC
ခေါက်ဆွဲ	kʰ AD a AL ʊ AM ʔ AC sʰ BA w AK ɛ AL
ခေါက်ဆွဲဆိုင်	kʰ AD a AL ʊ AM ʔ AC sʰ BA w AK ɛ AL z AJ a AL ɪ AL ɴ AG
ခေါက်ဆွဲသုပ်	kʰ AD a AL ʊ AM ʔ AC sʰ BA w AK ɛ AL θ AJ o AM ʊ AM ʔ AC
ခေါက်မုန့်	kʰ AD a AL ʊ AM ʔ AC m AF o̰ AM ʊ AM ɴ AG
ခေါင်း	ɡ AC a AL ʊ AM ɴ AG
ခေါင်းဆောင်	ɡ AC a AL ʊ AM ɴ AG z AJ a AL ʊ AM ɴ AG
ခေါင်းပေါင်း	ɡ AC a AL ʊ AM ɴ AG b AH a AL ʊ AM ɴ AG
ခေါင်းလောင်း	kʰ AD a AL ʊ AM ɴ AG l AE a AL ʊ AM ɴ AG
ခေါင်းလျှော်ရည်	ɡ AC a AL ʊ AM ɴ AG ʃ AJ ɔ AM j AB e AL
ခေါင်းအုံး	ɡ AC a AL ʊ AM ɴ AG ʔ AC o AM ʊ AM ɴ AG
ခေါပုတ်	kʰ AD ɔ AM b AH o AM ʊ AM ʔ AC
ခေါပျဉ်	kʰ AD ɔ AM b AH j AB ɪ AL ɴ AG
ခေါ်	kʰ AD ɔ AM
ခေး	kʰ AD e AL
ခဲ	kʰ AD ɛ AL
ခဲတံ	kʰ AD ɛ AL d AC a AL ɴ AG
ခဲဖျက်	kʰ AD ɛ AL b AH j AB ɛ AL ʔ AC
ခဲယဉ်း	kʰ AD ɛ AL j AB ɪ AL ɴ AG
ခဲအို	kʰ AD ɛ AL ʔ AC o AM
ခဲ့	ɡ AC ɛ̰ AL
ခံ	kʰ AD a AL ɴ AG
ခံစား	kʰ AD a AL ɴ AG z AJ a AL
ခံတပ်	kʰ AD a AL ɴ AG d AC a AL ʔ AC
ခံမြို့	kʰ AD a AL ɴ AG m AF j AB o̰ AM
ခံယူချက်	kʰ AD a AL ɴ AG j AB u AM d AC ʑ AJ ɛ AL ʔ AC
ချက်	t AC ɕʰ BA ɛ AL ʔ AC
ချက်ကြိုး	t AC ɕʰ BA ɛ AL ʔ AC t AC ɕ AJ o AM
ချက်သမ္မတ	t AC ɕʰ BA ɛ AL ʔ AC θ AJ ə AL m AF ə AL d AC a̰ AL
ချင်	t AC ɕʰ BA ɪ AL ɴ AG
ချင်း	t AC ɕʰ BA ɪ AL ɴ AG
ချင်းမိုင်	t AC ɕʰ BA ɪ AL ɴ AG m AF a AL ɪ AL ɴ AG
ချင်းသုပ်	d AC ʑ AJ ɪ AL ɴ AG ð AJ o AM ʊ AM ʔ AC
ချစ်	t AC ɕʰ BA ɪ AL ʔ AC
ချစ်ခင်	t AC ɕʰ BA ɪ AL ʔ AC kʰ AD ɪ AL ɴ AG
ချစ်တီး	t AC ɕʰ BA ɪ AL ʔ AC t AC i AL
ချစ်သူ	t AC ɕʰ BA ɪ AL ʔ AC θ AJ u AM
ချဉ်	t AC ɕʰ BA ɪ AL ɴ AG
ချဉ်ပေါင်	t AC ɕʰ BA ɪ AL ɴ AG b AH a AL ʊ AM ɴ AG
ချည်	t AC ɕʰ BA i AL
ချည်လုံး	t AC ɕʰ BA i AL l AE o AM ʊ AM ɴ AG
ချဒ်	t AC ɕʰ BA a AL d AC
ချပါတီ	t AC ɕʰ BA ə AL p AH a AL t AC i AL
ချပ်	d AC ʑ AJ a AL ʔ AC
ချမ်း	t AC ɕʰ BA a AL ɴ AG
ချယ်ရီ	t AC ɕʰ BA ɛ AL ɹ AB i AL
ချာတိတ်	t AC ɕʰ BA a AL t AC e AL ɪ AL ʔ AC
ချားလ်	t AC ɕʰ BA a AL l AE
ချိတ်	d AC ʑ AJ e AL ɪ AL ʔ AC
ချို	t AC ɕʰ BA o AM
ချိုချဉ်	t AC ɕʰ BA o AM t AC ɕʰ BA ɪ AL ɴ AG
ချိုး	t AC ɕʰ BA o AM
ချီလီ	t AC ɕʰ BA i AL l AE i AL
ချုပ်	t AC ɕʰ BA o AM ʊ AM ʔ AC
ချူးအင်းဂမ်း	t AC ɕʰ BA u AM ʔ AC ɪ AL ɴ AG ɡ AC a AL ɴ AG
ချေ	t AC ɕʰ BA i AL
ချော	t AC ɕʰ BA ɔ AM
ချောကလက်	t AC ɕʰ BA ɔ AM k AC ə AL l AE ɛ AL ʔ AC
ချောက်	t AC ɕʰ BA a AL ʊ AM ʔ AC
ချောင်	t AC ɕʰ BA a AL ʊ AM ɴ AG
ချောင်း	t AC ɕʰ BA a AL ʊ AM ɴ AG
ချော်	t AC ɕʰ BA ɔ AM
ချေး	t AC ɕʰ BA i AL
ချေးထုပ်	t AC ɕʰ BA e AL tʰ AD o AM ʊ AM ʔ AC
ချဲ့ချဲ့	t AC ɕʰ BA ɛ̰ AL d AC ʑ AJ ɛ̰ AL
ချွန်	t AC ɕʰ BA ʊ AM ɴ AG
ချွန်ထက်	t AC ɕʰ BA ʊ AM ɴ AG tʰ AD ɛ AL ʔ AC
ချွေး	t AC ɕʰ BA w AK e AL
ချွေးမ	t AC ɕʰ BA w AK e AL m AF a̰ AL
ချွံချွံ	t AC ɕʰ BA ʊ AM ɴ AG d AC ʑ AJ ʊ AM ɴ AG
ခြ	t AC ɕʰ BA a̰ AL
ခြင်	t AC ɕʰ BA ɪ AL ɴ AG
ခြင်း	t AC ɕʰ BA ɪ AL ɴ AG
ခြင်းလုံး	t AC ɕʰ BA ɪ AL ɴ AG l AE o AM ʊ AM ɴ AG
ခြင်္သေ့	t AC ɕʰ BA ɪ AL ɴ AG ð AJ ḛ
ခြင်္သေ့ကလေး	t AC ɕʰ BA ɪ AL ɴ AG ð AJ ḛ ɡ AC ə AL l AE e AL
ခြင်္သေ့မ	t AC ɕʰ BA ɪ AL ɴ AG ð AJ ḛ m AF a̰ AL
ခြည်	t AC ɕʰ BA i AL
ခြတောင်ပို့	t AC ɕʰ BA a̰ AL t AC a AL ʊ AM ɴ AG b AH o̰ AM
ခြမ်း	t AC ɕʰ BA a AL ɴ AG
ခြား	t AC ɕʰ BA a AL
ခြားနား	t AC ɕʰ BA a AL n AG a AL
ခြားနားချက်	t AC ɕʰ BA a AL n AG a AL d AC ʑ AJ ɛ AL ʔ AC
ခြေ	t AC ɕʰ BA e AL
ခြေစွပ်	t AC ɕʰ BA e AL z AJ ʊ AM ʔ AC
ခြေထောက်	t AC ɕʰ BA e AL d AC a AL ʊ AM ʔ AC
ခြေနင်း	t AC ɕʰ BA e AL n AG ɪ AL ɴ AG
ခြေဖနောင့်	t AC ɕʰ BA e AL b AH ə AL n AG a̰ AL ʊ AM ɴ AG
ခြေဖဝါး	t AC ɕʰ BA e AL b AH ə AL w AK a AL
ခြေသည်း	t AC ɕʰ BA e AL ð AJ e AL
ခြေအိတ်	t AC ɕʰ BA e AL ʔ AC e AL ɪ AL ʔ AC
ခြောက်	t AC ɕʰ BA a AL ʊ AM ʔ AC
ခြောက်လ	t AC ɕʰ BA a AL ʊ AM ʔ AC l AE a̰ AL
ခြံ	t AC ɕʰ BA a AL ɴ AG
ခွက်	kʰ AD w AK ɛ AL ʔ AC
ခွင့်လွှတ်	kʰ AD w AK ɪ̰ AL ɴ AG l̥ AE ʊ AM ʔ AC
ခွဆုံ	ɡ AC w AK a̰ AL z AJ o AM ʊ AM ɴ AG
ခွန်	kʰ AD ʊ AM ɴ AG
ခွန်း	kʰ AD ʊ AM ɴ AG
ခွာ	kʰ AD w AK a AL
ခွာနာလျှာနာ	kʰ AD w AK a AL n AG a AL ʃ AJ a AL n AG a AL
ခွေး	kʰ AD w AK e AL
ခွေးမ	kʰ AD w AK e AL m AF a̰ AL
ခွေးမသား	kʰ AD w AK e AL m AF a̰ AL ð AJ a AL
ခွေးရူးပြန်ရောဂါ	kʰ AD w AK e AL j AB u AM b AH j AB a AL ɴ AG j AB ɔ AM ɡ AC a AL
ခွေးသူတောင်းစား	kʰ AD w AK e AL ð AJ ə AL d AC a AL ʊ AM ɴ AG z AJ a AL
ခွေးအိမ်	kʰ AD w AK e AL ʔ AC e AL ɪ AL ɴ AG
ခွဲ	kʰ AD w AK ɛ AL
ခွံ	kʰ AD ʊ AM ɴ AG
ဂငယ်	ɡ AC a̰ AL ŋ AG ɛ AL
ဂငယ်ကွေ့	ɡ AC a̰ AL ŋ AG ɛ AL ɡ AC w AK ḛ
ဂင်းနီဗစ်ဆော	ɡ AC ɪ AL ɴ AG n AG i AL b AH ɪ AL ʔ AC sʰ BA ɔ AM
ဂင်္ဂါ	ɡ AC ɪ AL ɴ AG ɡ AC a AL
ဂဏန်း	ɡ AC ə AL n AG a AL ɴ AG
ဂဏန်းတွက်စက်	ɡ AC ə AL n AG a AL ɴ AG t AC w AK ɛ AL ʔ AC s AJ ɛ AL ʔ AC
ဂန္ထဗေဒ	ɡ AC a AL ɴ AG tʰ AD a̰ AL b AH e AL d AC a̰ AL
ဂန္ထဝင်	ɡ AC a AL ɴ AG d AC ə AL w AK ɪ AL ɴ AG
ဂန္ဒမာ	ɡ AC a AL ɴ AG d AC ə AL m AF a AL
ဂန်ဂျာ	ɡ AC a AL ɴ AG d AC ʑ AJ a AL
ဂန်ဒူး	ɡ AC a AL ɴ AG d AC u AM
ဂမ်ဘီယာ	ɡ AC a AL ɴ AG b AH i AL j AB a AL
ဂယ်လက်ဆီ	ɡ AC ɛ AL l AE ɛ AL ʔ AC sʰ BA i AL
ဂရပ်	ɡ AC ə AL ɹ AB a AL ʔ AC
ဂရမ်	ɡ AC ə AL ɹ AB a AL ɴ AG
ဂရိ	ɡ AC ə AL ɹ AB ḭ
ဂရိတ်ဗြိတိန်	ɡ AC ə AL ɹ AB e AL ɪ AL ʔ AC b AH j AB ḭ t AC e AL ɪ AL ɴ AG
ဂရု	ɡ AC ə AL j AB ṵ
ဂလင်း	ɡ AC ə AL l AE ɪ AL ɴ AG
ဂဠုန်	ɡ AC ə AL l AE o AM ʊ AM ɴ AG
ဂါထာ	ɡ AC a AL tʰ AD a AL
ဂါနာ	ɡ AC a AL n AG a AL
ဂါဘွန်	ɡ AC a AL b AH ʊ AM ɴ AG
ဂိတ်	ɡ AC e AL ɪ AL ʔ AC
ဂိတ်ဆုံး	ɡ AC e AL ɪ AL ʔ AC sʰ BA o AM ʊ AM ɴ AG
ဂိမှာန်	ɡ AC e AL ɪ AL ɴ AG m̥ AF a AL ɴ AG
ဂိရိမေခလာ	ɡ AC ḭ ɹ AB ḭ m AF e AL kʰ AD ə AL l AE a AL
ဂိုင်ယာနာ	ɡ AC a AL ɪ AL ɴ AG j AB a AL n AG a AL
ဂိုဏ်း	ɡ AC o AM n AG
ဂိုဏ်းချုပ်	ɡ AC a AL ɪ AL ɴ AG d AC ʑ AJ o AM ʊ AM ʔ AC
ဂိုဏ်းထောက်	ɡ AC o AM n AG d AC a AL ʊ AM ʔ AC
ဂိုဏ်းအုပ်	ɡ AC o AM n AG ʔ AC o AM ʊ AM ʔ AC
ဂိုဒေါင်	ɡ AC o AM d AC a AL ʊ AM ɴ AG
ဂီတ	ɡ AC i AL t AC a̰ AL
ဂီတပညာ	ɡ AC i AL t AC a̰ AL p AH a̰ AL ɲ AG a AL
ဂီတသမား	ɡ AC i AL t AC a̰ AL ð AJ ə AL m AF a AL
ဂီတာ	ɡ AC i AL t AC a AL
ဂီနီ	ɡ AC i AL n AG i AL
ဂုဏ်	ɡ AC o AM ʊ AM ɴ AG
ဂုန္တန်	ɡ AC o AM ʊ AM ɴ AG d AC a AL ɴ AG
ဂုရု	ɡ AC ṵ ɹ AB ṵ
ဂူ	ɡ AC u AM
ဂေဟဗေဒ	ɡ AC e AL h AA a̰ AL t AC a̰ AL b AH e AL d AC a̰ AL
ဂေါက်	ɡ AC a AL ʊ AM ʔ AC
ဂေါတမ	ɡ AC ɔ AM t AC ə AL m AF a̰ AL
ဂေါတမဘုရား	ɡ AC ɔ AM t AC ə AL m AF a̰ AL pʰ AI ə AL j AB a AL
ဂေါ်	ɡ AC ɔ AM
ဂေါ်ဖီထုပ်	ɡ AC ɔ AM b AH i AL d AC o AM ʊ AM ʔ AC
ဂေါ်ဖီပန်း	ɡ AC ɔ AM b AH i AL p AH a AL ɴ AG
ဂေါ်မိတ်	ɡ AC ɔ AM m AF e AL ɪ AL ʔ AC
ဂေါ်ရခါး	ɡ AC ɔ AM j AB ə AL kʰ AD a AL
ဂေါ်ရခါးသီး	ɡ AC ɔ AM j AB ə AL kʰ AD a AL θ AJ i AL
ဂျက်	d AC ʑ AJ ɛ AL ʔ AC
ဂျင်	d AC ʑ AJ ɪ AL ɴ AG
ဂျင်းဘောင်းဘီ	d AC ʑ AJ ɪ AL ɴ AG b AH a AL ʊ AM ɴ AG b AH i AL
ဂျပန်	d AC ʑ AJ ə AL p AH a AL ɴ AG
ဂျမေကာ	d AC ʑ AJ ə AL m AF e AL k AC a AL
ဂျလေဘီ	d AC ʑ AJ ə AL l AE e AL b AH i AL
ဂျာမနီ	d AC ʑ AJ a AL m AF ə AL n AG i AL
ဂျာမန်	d AC ʑ AJ a AL m AF a AL ɴ AG
ဂျီဘူတီ	d AC ʑ AJ i AL b AH u AM t AC i AL
ဂျုံ	d AC ʑ AJ o AM ʊ AM ɴ AG
ဂျုံမှုန့်	d AC ʑ AJ o AM ʊ AM ɴ AG m̥ AF o̰ AM ʊ AM ɴ AG
ဂျူး	d AC ʑ AJ u AM
ဂျေရုဆလင်	d AC ʑ AJ e AL ɹ AB ṵ sʰ BA a̰ AL l AE ɪ AL ɴ AG
ဂျော့ခ်ျ	d AC ʑ AJ ɔ̰ AM t AC ɕʰ BA ə AL
ဂျော်ဂျီယာ	d AC ʑ AJ ɔ AM d AC ʑ AJ i AL j AB a AL
ဂျော်ဒန်	d AC ʑ AJ ɔ AM d AC a AL ɴ AG
ဂျော်နီ	d AC ʑ AJ ɔ AM n AG i AL
ဂြိုဟ်	d AC ʑ AJ o AM
ဂြိုဟ်တု	d AC ʑ AJ o AM h AA d AC ṵ
ဂွမ်း	ɡ AC ʊ AM ɴ AG
ဂွါတီမာလာ	ɡ AC w AK a AL t AC i AL m AF a AL l AE a AL
ဂွေး	ɡ AC w AK e AL
ဃကြီး	ɡ AC a̰ AL d AC ʑ AJ i AL
င	ŋ AG a̰ AL
ငချိတ်	ŋ AG ə AL t AC ɕʰ BA e AL ɪ AL ʔ AC
ငတ်	ŋ AG a AL ʔ AC
ငန်	ŋ AG a AL ɴ AG
ငန်း	ŋ AG a AL ɴ AG
ငယ်	ŋ AG ɛ AL
ငရုတ်	ŋ AG ə AL j AB o AM ʊ AM ʔ AC
ငရုတ်ကောင်း	ŋ AG ə AL j AB o AM ʊ AM ʔ AC ɡ AC a AL ʊ AM ɴ AG
ငရဲ	ŋ AG ə AL j AB ɛ AL
ငရဲကြီးရှစ်ထပ်	ŋ AG ə AL j AB ɛ AL d AC ʑ AJ i AL ʃ AJ ɪ AL ʔ AC tʰ AD a AL ʔ AC
ငရဲမင်း	ŋ AG ə AL j AB ɛ AL m AF ɪ AL ɴ AG
ငရဲသား	ŋ AG ə AL j AB ɛ AL ð AJ a AL
ငလျင်	ŋ AG ə AL l AE j AB ɪ AL ɴ AG
ငါ	ŋ AG a AL
ငါတို့	ŋ AG a AL t AC o̰ AM
ငါ့	ŋ AG a̰ AL
ငါး	ŋ AG a AL
ငါးကျပ်တင်	ŋ AG a AL t AC ɕ AJ a AL ʔ AC t AC ɪ AL ɴ AG
ငါးကြင်း	ŋ AG a AL d AC ʑ AJ ɪ AL ɴ AG
ငါးခူ	ŋ AG ə AL kʰ AD u AM
ငါးပိ	ŋ AG ə AL p AH ḭ
ငါးပိထောင်း	ŋ AG a AL p AH ḭ tʰ AD a AL ʊ AM ɴ AG
ငါးပိရည်	ŋ AG ə AL p AH ḭ j AB e AL
ငါးပုဏ္ဏား	ŋ AG ə AL p AH o AM ʊ AM ɴ AG n AG a AL
ငါးပေါင်းထုပ်	ŋ AG ə AL b AH a AL ʊ AM ɴ AG d AC o AM ʊ AM ʔ AC
ငါးဖန်ခွက်	ŋ AG ə AL pʰ AI a AL ɴ AG ɡ AC w AK ɛ AL ʔ AC
ငါးဖယ်	ŋ AG ə AL pʰ AI ɛ AL
ငါးဖျင်းသလက်	ŋ AG ə AL pʰ AI j AB ɪ AL ɴ AG θ AJ ə AL l AE ɛ AL ʔ AC
ငါးမန်း	ŋ AG ə AL m AF a AL ɴ AG
ငါးမုန့်	ŋ AG a AL m AF o̰ AM ʊ AM ɴ AG
ငါးမူး	ŋ AG a AL m AF u AM
ငါးမျှားတံ	ŋ AG ə AL m̥ AF j AB a AL d AC a AL ɴ AG
ငါးမြစ်ချင်း	ŋ AG ə AL m AF j AB ɪ AL ʔ AC t AC ɕʰ BA ɪ AL ɴ AG
ငါးရံ့	ŋ AG ə AL j AB a̰ AL ɴ AG
ငါးလ	ŋ AG a AL l AE a̰ AL
ငါးသလောက်	ŋ AG ə AL θ AJ ə AL l AE a AL ʊ AM ʔ AC
ငါးသလောက်ပေါင်း	ŋ AG ə AL θ AJ ə AL l AE a AL ʊ AM ʔ AC b AH a AL ʊ AM ɴ AG
ငါးဥ	ŋ AG a AL ʔ AC ṵ
ငို	ŋ AG o AM
ငု	ŋ AG ṵ
ငုစပ်	ŋ AG ṵ z AJ a AL ʔ AC
ငုသိမ်	ŋ AG ṵ ð AJ e AL ɪ AL ɴ AG
ငူတူတူ	ŋ AG u AM t AC u AM d AC u AM
ငံ	ŋ AG a AL ɴ AG
ငံပြာရည်	ŋ AG a AL ɴ AG b AH j AB a AL j AB e AL
ငြာ	ɲ AG a AL
ငြိမ်းချမ်းရေး	ɲ AG e AL ɪ AL ɴ AG d AC ʑ AJ a AL ɴ AG j AB e AL
ငွေ	ŋ AG w AK e AL
ငွေကြေး	ŋ AG w AK e AL t AC ɕ AJ e AL
ငွေသား	ŋ AG w AK e AL ð AJ a AL
ငွေ့ငွေ့	ŋ AG w AK ḛ ŋ AG w AK ḛ
ငှက်	ŋ̊ AG ɛ AL ʔ AC
ငှက်ဆိုး	ŋ̊ AG ɛ AL ʔ AC sʰ BA o AM
ငှက်ပျော	ŋ AG ə AL p AH j AB ɔ AM
ငှက်ပျောပေါင်း	ŋ̊ AG ə AL b AH j AB ɔ AM b AH a AL ʊ AM ɴ AG
ငှက်ဖျား	ŋ̊ AG ɛ AL ʔ AC pʰ AI j AB a AL
ငှါး	ŋ̊ AG a AL
ငှား	ŋ̊ AG a AL
စ	s AJ a̰ AL
စကတ်	s AJ ə AL k AC a AL ʔ AC
စကား	z AJ ə AL ɡ AC a AL
စကားထာ	z AJ ə AL ɡ AC ə AL tʰ AD a AL
စကားနည်းရန်စဲ	z AJ ə AL ɡ AC a AL n AG ɛ AL j AB a AL ɴ AG z AJ ɛ AL
စကားပုံ	z AJ ə AL ɡ AC ə AL b AH o AM ʊ AM ɴ AG
စကားပြန်	z AJ ə AL ɡ AC ə AL b AH j AB a AL ɴ AG
စကားပြောကြေးနန်း	z AJ ə AL ɡ AC a AL b AH j AB ɔ AM t AC ɕ AJ e AL n AG a AL ɴ AG
စကားလုံး	z AJ ə AL ɡ AC ə AL l AE o AM ʊ AM ɴ AG
စကားဝှက်	z AJ ə AL ɡ AC ə AL ʍ AN ɛ AL ʔ AC
စက္ကန့်	s AJ ɛ AL ʔ AC k AC a̰ AL ɴ AG
စက္ကရီတေရီ	s AJ ɛ AL ʔ AC k AC ə AL ɹ AB i AL t AC e AL j AB i AL
စက္ကူ	s AJ ɛ AL ʔ AC k AC u AM
စက်	s AJ ɛ AL ʔ AC
စက်ခေါင်း	s AJ ɛ AL ʔ AC ɡ AC a AL ʊ AM ɴ AG
စက်ဆရာ	s AJ ɛ AL ʔ AC sʰ BA ə AL j AB a AL
စက်ဆုပ်	s AJ ɛ AL ʔ AC sʰ BA o AM ʊ AM ʔ AC
စက်တင်ဘာ	s AJ ɛ AL ʔ AC t AC ɪ AL ɴ AG b AH a AL
စက်ဘီး	s AJ ɛ AL ʔ AC b AH e AL ɪ AL ɴ AG
စက်ရုပ်	s AJ ɛ AL ʔ AC j AB o AM ʊ AM ʔ AC
စက်ရုံ	s AJ ɛ AL ʔ AC j AB o AM ʊ AM ɴ AG
စက်လှေကား	s AJ ɛ AL ʔ AC l̥ AE e AL ɡ AC a AL
စက်သုံးဆီဆိုင်	s AJ ɛ AL ʔ AC θ AJ o AM ʊ AM ɴ AG sʰ BA i AL sʰ BA a AL ɪ AL ɴ AG
စက်သေနတ်	s AJ ɛ AL ʔ AC θ AJ ə AL n AG a AL ʔ AC
စကြဝဠာ	s AJ ɛ AL ʔ AC t AC ɕ AJ a AL w AK ə AL l AE a AL
စကြာ	s AJ ɛ AL ʔ AC t AC ɕ AJ a AL
စကြာဝဠာဗေဒ	s AJ ɛ AL ʔ AC t AC ɕ AJ a AL w AK ə AL l AE a AL b AH e AL d AC a̰ AL
စခန်း	s AJ ə AL kʰ AD a AL ɴ AG
စင်	s AJ ɪ AL ɴ AG
စင်ကာပူ	s AJ ɪ AL ɴ AG ɡ AC ə AL p AH u AM
စင်စင်	s AJ ɪ AL ɴ AG z AJ ɪ AL ɴ AG
စင်း	s AJ ɪ AL ɴ AG
စင်္ကာပူ	s AJ ɪ AL ɴ AG ɡ AC ə AL p AH u AM
စင်္ကြံ	z AJ ɪ AL ɴ AG d AC ʑ AJ a AL ɴ AG
စစ်	s AJ ɪ AL ʔ AC
စစ်ကိုင်း	z AJ ə AL ɡ AC a AL ɪ AL ɴ AG
စစ်ကဲ	s AJ ɪ AL ʔ AC k AC ɛ AL
စစ်တပ်	s AJ ɪ AL ʔ AC t AC a AL ʔ AC
စစ်တုရင်	s AJ ɪ AL ʔ AC b AH ə AL j AB ɪ AL ɴ AG
စစ်တွေ	s AJ ɪ AL ʔ AC t AC w AK e AL
စစ်ဗိုလ်	s AJ ɪ AL ʔ AC b AH o AM
စစ်သား	s AJ ɪ AL ʔ AC θ AJ a AL
စဉ်းစား	s AJ ɪ AL ɴ AG z AJ a AL
စည်	s AJ i AL
စည်ပိုင်း	s AJ i AL b AH a AL ɪ AL ɴ AG
စည်း	s AJ i AL
စည်းပုံ	s AJ i AL b AH o AM ʊ AM ɴ AG
စတိုး	s AJ ə AL t AC o AM
စတု	z AJ ə AL t AC ṵ
စတုဂံ	s AJ ə AL t AC ṵ ɡ AC a AL ɴ AG
စတုတ္ထ	z AJ ə AL d AC o AM ʊ AM ʔ AC tʰ AD a̰ AL
စတုဒိသာ	s AJ ə AL t AC ṵ d AC ḭ θ AJ a AL
စတုရန်း	s AJ ə AL t AC ṵ j AB a AL ɴ AG
စတေဒီယံ	s AJ ə AL t AC e AL d AC i AL j AB a AL ɴ AG
စနစ်	s AJ ə AL n AG ɪ AL ʔ AC
စနေ	s AJ ə AL n AG e AL
စန္ဒရား	s AJ a AL ɴ AG d AC ə AL j AB a AL
စန္ဒာ	s AJ a AL ɴ AG d AC a AL
စန္ဒီ	s AJ a AL ɴ AG d AC i AL
စန္ဒြမာသ	s AJ a AL ɴ AG d AC ɹ AB a̰ AL m AF a AL θ AJ a̰ AL
စန္ဒြာ	s AJ a AL ɴ AG d AC ɹ AB a AL
စန်း	s AJ a AL ɴ AG
စပါး	z AJ ə AL b AH a AL
စပါးလင်	z AJ ə AL b AH ə AL l AE ɪ AL ɴ AG
စပိန်	s AJ ə AL p AH e AL ɪ AL ɴ AG
စပ်	s AJ a AL ʔ AC
စပျစ်	z AJ ə AL b AH j AB ɪ AL ʔ AC
စပျစ်သီး	z AJ ə AL b AH j AB ɪ AL ʔ AC θ AJ i AL
စပွတ်နစ်	s AJ ə AL p AH ʊ AM ʔ AC n AG ɪ AL ʔ AC
စမတ်	s AJ ə AL m AF a AL ʔ AC
စမူဆာ	s AJ ə AL m AF u AM z AJ a AL
စမူဆာသုပ်	s AJ ə AL m AF u AM z AJ a AL θ AJ o AM ʊ AM ʔ AC
စမ်း	s AJ a AL ɴ AG
စရိတ်	z AJ ə AL j AB e AL ɪ AL ʔ AC
စရိုက်	z AJ ə AL j AB a AL ɪ AL ʔ AC
စလုံး	s AJ a̰ AL l AE o AM ʊ AM ɴ AG
စလွယ်	s AJ ə AL l AE w AK e AL
စအို	s AJ ə AL ʔ AC o AM
စာ	s AJ a AL
စာကိုယ်	s AJ a AL ɡ AC o AM
စာကြည့်တိုက်	s AJ a AL t AC ɕ AJ ḭ d AC a AL ɪ AL ʔ AC
စာချုပ်	s AJ ə AL t AC ɕʰ BA o AM ʊ AM ʔ AC
စာစောင်	s AJ a AL z AJ a AL ʊ AM ɴ AG
စာဆို	s AJ a AL z AJ o AM
စာတိုက်	s AJ a AL d AC a AL ɪ AL ʔ AC
စာပို့	s AJ a AL p AH o̰ AM
စာပုံး	s AJ a AL b AH o AM ʊ AM ɴ AG
စာပေ	s AJ a AL p AH e AL
စာဖတ်	s AJ a AL pʰ AI a AL ʔ AC
စာမရီ	s AJ a AL m AF ə AL j AB i AL
စာမေးပွဲ	s AJ a AL m AF e AL b AH w AK ɛ AL
စာမျက်နှာ	s AJ a AL m AF j AB ɛ AL ʔ AC n̥ AG a AL
စာမွဲ	s AJ ə AL m AF w AK ɛ AL
စာရင်း	s AJ ə AL j AB ɪ AL ɴ AG
စာရင်းကိုင်	s AJ ə AL j AB ɪ AL ɴ AG ɡ AC a AL ɪ AL ɴ AG
စာရင်းကိုင်ပညာ	s AJ ə AL j AB ɪ AL ɴ AG ɡ AC a AL ɪ AL ɴ AG p AH j AB ɪ AL ɴ AG ɲ AG a AL
စာရင်းအင်း	s AJ a AL j AB ɪ AL ɴ AG ʔ AC ɪ AL ɴ AG
စာရေး	s AJ ə AL j AB e AL
စာရေးဆရာ	s AJ a AL j AB e AL sʰ BA ə AL j AB a AL
စာရွက်စာတမ်း	s AJ a AL j AB w AK ɛ AL ʔ AC s AJ a AL d AC a AL ɴ AG
စာလုံးပေါင်းသတ်ပုံ	s AJ ə AL l AE o AM ʊ AM ɴ AG b AH a AL ʊ AM ɴ AG θ AJ a AL ʔ AC p AH o AM ʊ AM ɴ AG
စာသင်ခန်း	s AJ a AL θ AJ ɪ AL ɴ AG ɡ AC a AL ɴ AG
စာသား	s AJ a AL ð AJ a AL
စာအိတ်	s AJ a AL ʔ AC e AL ɪ AL ʔ AC
စာအုပ်	s AJ a AL ʔ AC o AM ʊ AM ʔ AC
စာအုပ်ဆိုင်	s AJ a AL ʔ AC o AM ʊ AM ʔ AC sʰ BA a AL ɪ AL ɴ AG
စား	s AJ a AL
စားချဉ့်ပြန်	s AJ ə AL t AC ɕʰ BA ɪ̰ AL ɴ AG p AH j AB a AL ɴ AG
စားစရာ	s AJ a AL z AJ ə AL j AB a AL
စားတော်ဆက်	s AJ a AL d AC ɔ AM z AJ ɛ AL ʔ AC
စားပြီးပြီလား	s AJ a AL p AH i AL b AH i AL l AE a AL
စားပွဲ	z AJ ə AL b AH w AK ɛ AL
စားပွဲထိုး	z AJ a AL b AH w AK ɛ AL d AC o AM
စားဖို	s AJ ə AL pʰ AI o AM
စားဖိုဆောင်	s AJ ə AL pʰ AI o AM z AJ a AL ʊ AM ɴ AG
စားမြုံ့ပြန်	s AJ ə AL m AF j AB o̰ AM ʊ AM ɴ AG p AH j AB a AL ɴ AG
စားသောက်ဆိုင်	s AJ a AL θ AJ a AL ʊ AM ʔ AC sʰ BA a AL ɪ AL ɴ AG
စိတ္တဇ	s AJ e AL ɪ AL ʔ AC d AC ə AL z AJ a̰ AL
စိတ္တဇပန်းချီ	s AJ e AL ɪ AL ʔ AC d AC ə AL z AJ a̰ AL b AH ə AL d AC ʑ AJ i AL
စိတ္တဇရောဂါ	s AJ e AL ɪ AL ʔ AC d AC ə AL z AJ a̰ AL j AB ɔ AM ɡ AC a AL
စိတ္တဗေဒ	s AJ e AL ɪ AL ʔ AC t AC a̰ AL b AH e AL d AC a̰ AL
စိတ်	s AJ e AL ɪ AL ʔ AC
စိတ်ဆိုး	s AJ e AL ɪ AL ʔ AC sʰ BA o AM
စိတ်ဓာတ်	s AJ e AL ɪ AL ʔ AC d AC a AL t AC
စိတ်ပညာ	s AJ e AL ɪ AL ʔ AC p AH j AB ɪ AL ɴ AG ɲ AG a AL
စိတ်မှတ်	s AJ e AL ɪ AL ʔ AC m̥ AF a AL ʔ AC
စိတ်ရောဂါ	s AJ e AL ɪ AL ʔ AC j AB ɔ AM ɡ AC a AL
စိန်	s AJ e AL ɪ AL ɴ AG
စိန်ဖြူ	s AJ e AL ɪ AL ɴ AG pʰ AI j AB u AM
စိမ့်	s AJ ḛ ɪ AL ɴ AG
စိမ်း	s AJ e AL ɪ AL ɴ AG
စိမ်းစားဥ	s AJ e AL ɪ AL ɴ AG z AJ a AL ʔ AC ṵ
စို	s AJ o AM
စိုက်	s AJ a AL ɪ AL ʔ AC
စိုက်ပျိုးရေး	s AJ a AL ɪ AL ʔ AC p AH j AB o AM j AB e AL
စိုင်း	s AJ a AL ɪ AL ɴ AG
စိုထိုင်း	s AJ o AM tʰ AD a AL ɪ AL ɴ AG
စို့	s AJ o̰ AM
စီဒီ	s AJ i AL d AC i AL
စီလုံ	s AJ i AL l AE o AM ʊ AM ɴ AG
စီလုံတီး	s AJ i AL l AE o AM ʊ AM ɴ AG t AC i AL
စီး	s AJ i AL
စီးကရက်	s AJ i AL k AC ə AL ɹ AB ɛ AL ʔ AC
စီးကလိပ်	s AJ i AL k AC ə AL l AE e AL ɪ AL ʔ AC
စီးနင်း	s AJ i AL n AG ɪ AL ɴ AG
စီးပွား	s AJ i AL b AH w AK a AL
စီးပွားရေး	s AJ i AL b AH w AK a AL j AB e AL
စီးပွားရေးသမား	s AJ i AL b AH w AK a AL j AB e AL ð AJ ə AL m AF a AL
စုတ်	s AJ o AM ʊ AM ʔ AC
စုန်း	s AJ o AM ʊ AM ɴ AG
စုပ်	s AJ o AM ʊ AM ʔ AC
စုပ်စုပ်	s AJ o AM ʊ AM ʔ AC s AJ o AM ʊ AM ʔ AC
စုလျား	s AJ ṵ j AB a AL
စုံစမ်း	s AJ o AM ʊ AM ɴ AG z AJ a AL ɴ AG
စုံထောက်	s AJ o AM ʊ AM ɴ AG d AC a AL ʊ AM ʔ AC
စုံဖက်	s AJ o AM ʊ AM ɴ AG pʰ AI ɛ AL ʔ AC
စူပါမားကတ်	s AJ u AM p AH ə AL m AF a AL k AC a AL ʔ AC
စူးစူး	s AJ u AM z AJ u AM
စေတနာ	s AJ e AL d AC ə AL n AG a AL
စေတနာရှင်	s AJ e AL d AC ə AL n AG a AL ʃ AJ ɪ AL ɴ AG
စေတီ	z AJ e AL d AC i AL
စော	s AJ ɔ AM
စောက်	s AJ a AL ʊ AM ʔ AC
စောင့်	s AJ a̰ AL ʊ AM ɴ AG
စောင်	s AJ a AL ʊ AM ɴ AG
စောင်း	s AJ a AL ʊ AM ɴ AG
စောင်းလျား	z AJ a AL ʊ AM ɴ AG j AB a AL
စောစော	s AJ ɔ AM z AJ ɔ AM
စောပြာ	s AJ ɔ AM b AH j AB a AL
စော်ဘွား	s AJ ɔ AM b AH w AK a AL
စေ့စပ်	s AJ ḛ z AJ a AL ʔ AC
စဲ	s AJ ɛ AL
စံပယ်	z AJ ə AL b AH ɛ AL
စွင့်	s AJ w AK ɪ̰ AL ɴ AG
စွတ်စွတ်နာ	s AJ ʊ AM ʔ AC s AJ ʊ AM ʔ AC n AG a AL
စွတ်ဖါး	s AJ ʊ AM ʔ AC pʰ AI a AL
စွန်	s AJ ʊ AM ɴ AG
စွန်ကုပ်	s AJ ʊ AM ɴ AG ɡ AC o AM ʊ AM ʔ AC
စွပ်	s AJ ʊ AM ʔ AC
စွပ်ပြုတ်	s AJ ʊ AM ʔ AC p AH j AB o AM ʊ AM ʔ AC
စွမ်း	s AJ w AK a AL ɴ AG
စွမ်းအင်	s AJ w AK a AL ɴ AG ʔ AC ɪ AL ɴ AG
စွယ်	s AJ w AK ɛ AL
စွေ့စွေ့	s AJ w AK ḛ z AJ w AK ḛ
ဆက္ကဂံ	sʰ BA ɛ AL ʔ AC k AC ə AL ɡ AC a AL ɴ AG
ဆက်	sʰ BA ɛ AL ʔ AC
ဆက်ဆံ	sʰ BA ɛ AL ʔ AC sʰ BA a AL ɴ AG
ဆက်သွယ်ရေး	sʰ BA ɛ AL ʔ AC θ AJ w AK ɛ AL j AB e AL
ဆင့်	sʰ BA ɪ̰ AL ɴ AG
ဆင်	sʰ BA ɪ AL ɴ AG
ဆင်ခြေထောက်ရောဂါ	sʰ BA ɪ AL ɴ AG t AC ɕʰ BA e AL d AC a AL ʊ AM ʔ AC j AB ɔ AM ɡ AC a AL
ဆင်စွယ်	sʰ BA ɪ AL ɴ AG z AJ w AK ɛ AL
ဆင်ဝင်	sʰ BA ɪ AL ɴ AG w AK ɪ AL ɴ AG
ဆင်း	sʰ BA ɪ AL ɴ AG
ဆင်းရဲ	sʰ BA ɪ AL ɴ AG j AB ɛ AL
ဆစ်ဒနီ	sʰ BA ɪ AL ʔ AC d AC ə AL n AG i AL
ဆဋ္ဌမ	sʰ BA a AL ʔ AC tʰ AD ə AL m AF a̰ AL
ဆန့်ကျင်	sʰ BA a̰ AL ɴ AG d AC ʑ AJ ɪ AL ɴ AG
ဆန့်ကျင်ဘက်	sʰ BA a̰ AL ɴ AG d AC ʑ AJ ɪ AL ɴ AG b AH ɛ AL ʔ AC
ဆန္ဒ	sʰ BA a AL ɴ AG d AC a̰ AL
ဆန္ဒပြပွဲ	sʰ BA a AL ɴ AG d AC a̰ AL p AH j AB a̰ AL b AH w AK ɛ AL
ဆန်	sʰ BA a AL ɴ AG
ဆန်ခါ	z AJ ə AL ɡ AC a AL
ဆန်ပြုတ်	sʰ BA a AL ɴ AG b AH j AB o AM ʊ AM ʔ AC
ဆန်မာရီနို	sʰ BA a AL ɴ AG m AF a AL ɹ AB i AL n AG o AM
ဆန်း	sʰ BA a AL ɴ AG
ဆန်းဒဝစ်	sʰ BA a AL ɴ AG d AC ə AL w AK ɪ AL ʔ AC
ဆနွင်းမကင်း	sʰ BA ə AL n AG w AK ɪ AL ɴ AG m AF ə AL k AC ɪ AL ɴ AG
ဆပ္ပတ်	sʰ BA a AL ʔ AC p AH a AL ʔ AC
ဆပ်	sʰ BA a AL ʔ AC
ဆပ်ကပ်	sʰ BA a AL ʔ AC k AC a AL ʔ AC
ဆပ်ပြာ	sʰ BA a AL ʔ AC p AH j AB a AL
ဆပ်သွားဖူး	sʰ BA a AL ʔ AC θ AJ w AK a AL pʰ AI u AM
ဆယ့်တစ်	sʰ BA ɛ̰ AL t AC ɪ AL ʔ AC
ဆယ့်တစ်လ	sʰ BA ɛ̰ AL t AC ɪ AL ʔ AC l AE a̰ AL
ဆယ့်နှစ်	sʰ BA ɛ̰ AL n̥ AG ɪ AL ʔ AC
ဆယ့်နှစ်ရာသီ	sʰ BA ɛ̰ AL n̥ AG ə AL j AB a AL θ AJ i AL
ဆယ့်နှစ်လ	sʰ BA ɛ̰ AL n̥ AG ə AL l AE a̰ AL
ဆယ်	sʰ BA ɛ AL
ဆယ်လ	sʰ BA ɛ AL l AE a̰ AL
ဆရာ	sʰ BA ə AL j AB a AL
ဆရာတော်	sʰ BA ə AL j AB a AL d AC ɔ AM
ဆရာမ	sʰ BA ə AL j AB a AL m AF a̰ AL
ဆရာလေး	sʰ BA ə AL j AB a AL l AE e AL
ဆရာဝန်	sʰ BA a̰ AL j AB a AL w AK ʊ AM ɴ AG
ဆရာသမား	sʰ BA a̰ AL j AB a AL θ AJ ə AL m AF a AL
ဆလတ်	sʰ BA ə AL l AE a AL ʔ AC
ဆလဗ	sʰ BA ə AL l AE a̰ AL b AH a̰ AL
ဆလိမ်	sʰ BA a̰ AL l AE e AL ɪ AL ɴ AG
ဆလိုင်း	sʰ BA ə AL l AE a AL ɪ AL ɴ AG
ဆလိုဗားကီးယား	sʰ BA ə AL l AE o AM b AH a AL k AC i AL j AB a AL
ဆလိုဗေးနီးယား	sʰ BA ə AL l AE o AM b AH e AL n AG i AL j AB a AL
ဆာ	sʰ BA a AL
ဆာဂျင်	sʰ BA a AL d AC ʑ AJ ɪ AL ɴ AG
ဆာမူရိုင်း	sʰ BA a AL m AF u AM ɹ AB a AL ɪ AL ɴ AG
ဆာယာ	sʰ BA a AL j AB a AL
ဆာရီ	sʰ BA a AL ɹ AB i AL
ဆာလဖာ	sʰ BA a AL l AE ə AL pʰ AI a AL
ဆား	sʰ BA a AL
ဆားကြက်ဥ	sʰ BA a AL t AC ɕ AJ ɛ AL ʔ AC ʔ AC ṵ
ဆားဘီးယား	sʰ BA a AL b AH i AL j AB a AL
ဆားဘဲဥ	sʰ BA a AL b AH ɛ AL ʔ AC ṵ
ဆားရည်	sʰ BA a AL j AB e AL
ဆိတ်	sʰ BA e AL ɪ AL ʔ AC
ဆိတ်ကုလား	sʰ BA e AL ɪ AL ʔ AC k AC ə AL l AE a AL
ဆိတ်ချေး	sʰ BA e AL ɪ AL ʔ AC t AC ɕʰ BA i AL
ဆိတ်ထီး	sʰ BA e AL ɪ AL ʔ AC tʰ AD i AL
ဆိတ်မ	sʰ BA e AL ɪ AL ʔ AC m AF a̰ AL
ဆိပ်	sʰ BA e AL ɪ AL ʔ AC
ဆိပ်ကမ်း	sʰ BA e AL ɪ AL ʔ AC k AC a AL ɴ AG
ဆိမ့်	sʰ BA ḛ ɪ AL ɴ AG
ဆို	sʰ BA o AM
ဆိုကရေးတီး	sʰ BA o AM k AC ə AL ɹ AB e AL t AC i AL
ဆိုက်	sʰ BA a AL ɪ AL ʔ AC
ဆိုက်ကား	sʰ BA a AL ɪ AL ʔ AC k AC a AL
ဆိုက်ပရပ်စ်	sʰ BA a AL ɪ AL ʔ AC p AH ə AL ɹ AB a AL ʔ AC s AJ
ဆိုက်ဘေးရီးယား	sʰ BA a AL ɪ AL ʔ AC b AH e AL ɹ AB i AL j AB a AL
ဆိုင်	sʰ BA a AL ɪ AL ɴ AG
ဆိုင်း	sʰ BA a AL ɪ AL ɴ AG
ဆိုင်းထိုး	sʰ BA a AL ɪ AL ɴ AG tʰ AD o AM
ဆိုင်းဘုတ်	sʰ BA a AL ɪ AL ɴ AG b AH o AM ʊ AM ʔ AC
ဆိုင်းဝိုင်း	sʰ BA a AL ɪ AL ɴ AG w AK a AL ɪ AL ɴ AG
ဆိုဆုံးမ	sʰ BA o AM sʰ BA o AM ʊ AM ɴ AG m AF a̰ AL
ဆိုထုံး	sʰ BA o AM d AC o AM ʊ AM ɴ AG
ဆိုဒီယမ်	sʰ BA o AM d AC i AL j AB a AL ɴ AG
ဆိုဖာ	sʰ BA o AM pʰ AI a AL
ဆိုဗီယက်	sʰ BA o AM b AH i AL j AB ɛ AL ʔ AC
ဆိုမာလီယာ	sʰ BA o AM m AF a AL l AE i AL j AB a AL
ဆိုမြည်	sʰ BA o AM m AF j AB i AL
ဆိုရိုးစကား	sʰ BA o AM j AB o AM z AJ ə AL ɡ AC a AL
ဆိုး	sʰ BA o AM
ဆိုးဆေး	sʰ BA o AM z AJ e AL
ဆီ	sʰ BA i AL
ဆီချက်	sʰ BA i AL d AC ʑ AJ ɛ AL ʔ AC
ဆီချက်ခေါက်ဆွဲ	sʰ BA i AL d AC ʑ AJ ɛ AL ʔ AC kʰ AD a AL ʊ AM ʔ AC sʰ BA w AK ɛ AL
ဆီထမင်း	sʰ BA i AL tʰ AD ə AL m AF ɪ AL ɴ AG
ဆီနီဂေါ	sʰ BA i AL n AG i AL ɡ AC ɔ AM
ဆီပြန်	sʰ BA i AL b AH j AB a AL ɴ AG
ဆီမီးတောက်	sʰ BA i AL m AF i AL d AC a AL ʊ AM ʔ AC
ဆီယူ	sʰ BA i AL j AB u AM
ဆီရာလီယွန်	sʰ BA i AL ɹ AB a AL l AE i AL j AB ʊ AM ɴ AG
ဆီး	sʰ BA i AL
ဆီးချို	sʰ BA i AL d AC ʑ AJ o AM
ဆီးချုပ်ရောဂါ	sʰ BA i AL d AC ʑ AJ o AM ʊ AM ʔ AC j AB ɔ AM ɡ AC a AL
ဆီးပူညောင်းကျ	sʰ BA i AL p AH u AM ɲ AG a AL ʊ AM ɴ AG t AC ɕ AJ a̰ AL
ဆီးဖြူ	z AJ i AL b AH j AB u AM
ဆီးရီးယား	sʰ BA i AL ɹ AB i AL j AB a AL
ဆီးအောင့်ရောဂါ	sʰ BA i AL ʔ AC a̰ AL ʊ AM ɴ AG j AB ɔ AM ɡ AC a AL
ဆု	sʰ BA ṵ
ဆုံး	sʰ BA o AM ʊ AM ɴ AG
ဆုံးဖြတ်	sʰ BA o AM ʊ AM ɴ AG pʰ AI j AB a AL ʔ AC
ဆူ	sʰ BA u AM
ဆူဒန်	sʰ BA u AM d AC a AL ɴ AG
ဆူရာနမ်	sʰ BA u AM ɹ AB a AL n AG a AL ɴ AG
ဆူရှီ	sʰ BA u AM ʃ AJ i AL
ဆူး	sʰ BA u AM
ဆူးပုပ်	sʰ BA u AM b AH o AM ʊ AM ʔ AC
ဆောက်	sʰ BA a AL ʊ AM ʔ AC
ဆောင်	sʰ BA a AL ʊ AM ɴ AG
ဆောင်ပုဒ်	sʰ BA a AL ʊ AM ɴ AG b AH o AM ʊ AM ʔ AC
ဆောင်း	sʰ BA a AL ʊ AM ɴ AG
ဆောင်းပါး	sʰ BA a AL ʊ AM ɴ AG b AH a AL
ဆောင်းရာသီ	sʰ BA a AL ʊ AM ɴ AG j AB a AL ð AJ i AL
ဆောင်းဦး	sʰ BA a AL ʊ AM ɴ AG ʔ AC u AM
ဆောင်းဦးရာသီ	sʰ BA a AL ʊ AM ɴ AG ʔ AC u AM j AB a AL ð AJ i AL
ဆောရီး	sʰ BA ɔ AM ɹ AB i AL
ဆော့	sʰ BA ɔ̰ AM
ဆော့ဖ်ဝဲလ်	sʰ BA a AL ʊ AM ʔ AC w AK ɛ AL
ဆော်ဒီအာရေဗျ	sʰ BA ɔ AM d AC i AL ʔ AC a AL ɹ AB e AL b AH j AB a̰ AL
ဆေး	sʰ BA e AL
ဆေးခန်း	sʰ BA e AL kʰ AD a AL ɴ AG
ဆေးခြောက်	sʰ BA e AL d AC ʑ AJ a AL ʊ AM ʔ AC
ဆေးဆိုင်	sʰ BA e AL z AJ a AL ɪ AL ɴ AG
ဆေးတံ	sʰ BA e AL d AC a AL ɴ AG
ဆေးပေါ့လိပ်	sʰ BA e AL b AH ɔ̰ AM l AE e AL ɪ AL ʔ AC
ဆေးပြင်းလိပ်	sʰ BA e AL b AH j AB ɪ AL ɴ AG l AE e AL ɪ AL ʔ AC
ဆေးဘဲဥ	sʰ BA e AL b AH ɛ AL ʔ AC ṵ
ဆေးရုံ	sʰ BA e AL j AB o AM ʊ AM ɴ AG
ဆေးရှဲ	sʰ BA e AL ʃ AJ ɛ AL
ဆေးလိပ်	sʰ BA e AL l AE e AL ɪ AL ʔ AC
ဆေးလိပ်မသောက်ရ	sʰ BA e AL l AE e AL ɪ AL ʔ AC m AF ə AL θ AJ a AL ʊ AM ʔ AC j AB a̰ AL
ဆေးလုံး	sʰ BA e AL l AE o AM ʊ AM ɴ AG
ဆံ	sʰ BA a AL ɴ AG
ဆံတော်ချ	sʰ BA a AL ɴ AG t AC ɔ AM t AC ɕʰ BA a̰ AL
ဆံပင်	z AJ ə AL b AH ɪ AL ɴ AG
ဆံပင်ညှပ်	z AJ ə AL b AH ɪ AL ɴ AG ɲ̊ AG a AL ʔ AC
ဆံပင်တု	z AJ ə AL b AH ɪ AL ɴ AG d AC ṵ
ဆွစ်ဇာလန်	sʰ BA w AK ɪ AL ʔ AC z AJ ə AL l AE a AL ɴ AG
ဆွဆွ	sʰ BA w AK a̰ AL z AJ w AK a̰ AL
ဆွပ်	sʰ BA ʊ AM ʔ AC
ဆွမ်း	sʰ BA ʊ AM ɴ AG
ဆွမ်းမွှေး	sʰ BA ʊ AM ɴ AG m̥ AF w AK e AL
ဆွမ်းအုပ်	sʰ BA ʊ AM ɴ AG ʔ AC o AM ʊ AM ʔ AC
ဆွယ်တာ	sʰ BA w AK ɛ AL t AC a AL
ဆွာဇီလန်	sʰ BA w AK a AL z AJ i AL l AE a AL ɴ AG
ဆွီဒင်	sʰ BA w AK i AL d AC ɪ AL ɴ AG
ဆွေခုနစ်ဆက်မျိုးခုနစ်ဆက်	sʰ BA w AK e AL kʰ AD ə AL n AG ə AL z AJ ɛ AL ʔ AC m AF j AB o AM kʰ AD ə AL n AG ə AL z AJ ɛ AL ʔ AC
ဆွဲ	sʰ BA w AK ɛ AL
ဇကွဲ	z AJ a̰ AL ɡ AC w AK ɛ AL
ဇင့်ခ်	z AJ ɪ̰ AL ɴ AG
ဇင်ဘာဘွေ	z AJ ɪ AL ɴ AG b AH a AL b AH w AK e AL
ဇင်းမယ်	z AJ ɪ AL ɴ AG m AF ɛ AL
ဇင်္ဂမဥစ္စာ	z AJ ɪ AL ɴ AG ɡ AC ə AL m AF a̰ AL ʔ AC o AM ʊ AM ʔ AC s AJ a AL
ဇစ်	z AJ ɪ AL ʔ AC
ဇနပုဒ်	z AJ ə AL n AG ə AL p AH o AM ʊ AM ʔ AC
ဇနီး	z AJ ə AL n AG i AL
ဇန်နဝါရီ	z AJ a AL ɴ AG n AG ə AL w AK a AL ɹ AB i AL
ဇမ်ဘီယာ	z AJ a AL ɴ AG b AH i AL j AB a AL
ဇယ	z AJ ə AL j AB a̰ AL
ဇယား	z AJ ə AL j AB a AL
ဇရပ်	z AJ ə AL j AB a AL ʔ AC
ဇရာ	z AJ ə AL j AB a AL
ဇလဗေဒ	z AJ ə AL l AE a̰ AL b AH e AL d AC a̰ AL
ဇလုံ	z AJ ə AL l AE o AM ʊ AM ɴ AG
ဇာ	z AJ a AL
ဇာဂနာ	z AJ a AL ɡ AC ə AL n AG a AL
ဇာတိ	z AJ a AL t AC ḭ
ဇာတိပ္ဖိုလ်	z AJ a AL d AC e AL ɪ AL ʔ AC pʰ AI o AM
ဇာတိပ္ဖိုလ်စေ့	z AJ a AL d AC e AL ɪ AL ʔ AC pʰ AI o AM z AJ ḛ
ဇာတ်	z AJ a AL ʔ AC
ဇာတ်ကား	z AJ a AL ʔ AC k AC a AL
ဇာတ်ကြီးဆယ်ဘွဲ့	z AJ a AL t AC d AC ʑ AJ i AL sʰ BA ɛ AL b AH w AK ɛ̰ AL
ဇာတ်ခုံ	z AJ a AL ʔ AC kʰ AD o AM ʊ AM ɴ AG
ဇာတ်ဆောင်	z AJ a AL ʔ AC sʰ BA a AL ʊ AM ɴ AG
ဇာတ်ညွှန်း	z AJ a AL t AC ɲ̊ AG ʊ AM ɴ AG
ဇာတ်တော်	z AJ a AL t AC
ဇာတ်ရုံ	z AJ a AL ʔ AC j AB o AM ʊ AM ɴ AG
ဇာနည်	z AJ a AL n AG i AL
ဇိန	z AJ ḭ n AG a̰ AL
ဇိမ်မယ်	z AJ e AL ɪ AL ɴ AG m AF ɛ AL
ဇီဇဝါ	z AJ i AL z AJ ə AL w AK a AL
ဇီရာ	z AJ i AL j AB a AL
ဇီရာစေ့	z AJ i AL j AB a AL s AJ ḛ
ဇီဝ	z AJ i AL w AK a̰ AL
ဇီဝကမ္မဗေဒ	z AJ i AL w AK a̰ AL k AC a AL ɴ AG m AF a̰ AL b AH e AL d AC a̰ AL
ဇီဝစက်	z AJ i AL w AK a̰ AL s AJ ɛ AL ʔ AC
ဇီဝဓာတုဗေဒ	z AJ i AL w AK a̰ AL d AC a AL t AC ṵ b AH e AL d AC a̰ AL
ဇီဝဗေဒ	z AJ i AL w AK a̰ AL b AH e AL d AC a̰ AL
ဇူလိုင်	z AJ u AM l AE a AL ɪ AL ɴ AG
ဇေ	z AJ e AL
ဇေယျ	z AJ e AL j AB a̰ AL
ဇေယျာပူရ	z AJ e AL j AB a AL p AH u AM ɹ AB a̰ AL
ဇော်ဂျီ	z AJ ɔ AM d AC ʑ AJ i AL
ဇွန်	z AJ ʊ AM ɴ AG
ဇွန်း	z AJ ʊ AM ɴ AG
ဈမျဉ်းဆွဲ	z AJ a̰ AL m AF j AB ɪ AL ɴ AG z AJ w AK ɛ AL
ဈာန်	z AJ a AL n AG
ဈာပန	z AJ a AL p AH ə AL n AG a̰ AL
ဈေး	z AJ e AL
ဈေးကြီး	z AJ e AL t AC ɕ AJ i AL
ဈေးချို	z AJ e AL t AC ɕʰ BA o AM
ဈေးနှုန်း	z AJ e AL n̥ AG o AM ʊ AM ɴ AG
ဉာဏ်	ɲ AG a AL n AG
ဉာဏ်စမ်း	ɲ AG a AL n AG s AJ a AL ɴ AG
ဉာဏ်တော်	ɲ AG a AL ɴ AG d AC ɔ AM
ဉာဏ်ပူဇော်ခ	ɲ AG a AL n AG p AH u AM z AJ ɔ AM kʰ AD a̰ AL
ည	ɲ AG a̰ AL
ညကလေး	ɲ AG a̰ AL k AC ə AL l AE e AL
ညကြီး	ɲ AG a̰ AL t AC ɕ AJ i AL
ညစာ	ɲ AG a̰ AL z AJ a AL
ညစ်	ɲ AG ɪ AL ʔ AC
ညစ်ထည်း	ɲ AG ɪ AL ʔ AC tʰ AD e AL
ညည်း	ɲ AG i AL
ညနေ	ɲ AG a̰ AL n AG e AL
ညနေခင်း	ɲ AG a̰ AL n AG e AL ɡ AC ɪ AL ɴ AG
ညလေး	ɲ AG a̰ AL l AE e AL
ညာ	ɲ AG a AL
ညို	ɲ AG o AM
ညီ	ɲ AG i AL
ညီနောင်	ɲ AG i AL n AG a AL ʊ AM ɴ AG
ညီမ	ɲ AG i AL m AF a̰ AL
ညီမျှခြင်း	ɲ AG i AL m̥ AF j AB a̰ AL d AC ʑ AJ ɪ AL ɴ AG
ညီလာခံ	ɲ AG i AL l AE a AL ɡ AC a AL ɴ AG
ညီအစ်ကို	ɲ AG i AL ʔ AC ə AL k AC o AM
ညီအစ်မ	ɲ AG i AL ʔ AC ə AL m AF a̰ AL
ညောင်	ɲ AG a AL ʊ AM ɴ AG
ညောင်ဖြူ	ɲ AG a AL ʊ AM ɴ AG b AH j AB u AM
ညောင်ဗောဓိ	ɲ AG a AL ʊ AM ɴ AG b AH ɔ AM d AC ḭ
ညောင်လေးပင်	ɲ AG a AL ʊ AM ɴ AG l AE e AL p AH ɪ AL ɴ AG
ညောင်းကျရောဂါ	ɲ AG a AL ʊ AM ɴ AG t AC ɕ AJ a̰ AL j AB ɔ AM ɡ AC a AL
ညေး	ɲ AG e AL
ညံစာစာ	ɲ AG a AL ɴ AG s AJ a AL z AJ a AL
ညွန့်	ɲ AG ʊ̰ AM ɴ AG
ညှင်း	ɲ̊ AG ɪ AL ɴ AG
ညှစ်	ɲ̊ AG ɪ AL ʔ AC
ညှပ်	ɲ̊ AG a AL ʔ AC
ညှာ	ɲ̊ AG a AL
ဋသန်လျင်းချိတ်	t AC a̰ AL θ AJ ə AL j AB ɪ AL ɴ AG d AC ʑ AJ e AL ɪ AL ʔ AC
ဌဝမ်းဘဲ	tʰ AD a̰ AL w AK ʊ AM ɴ AG b AH ɛ AL
ဌာန	tʰ AD a AL n AG a̰ AL
ဌာပနာ	tʰ AD a AL p AH ə AL n AG a AL
ဌေး	tʰ AD e AL
ဍရင်ကောက်	d AC a̰ AL j AB ɪ AL ɴ AG ɡ AC a AL ʊ AM ʔ AC
ဎရေမှုတ်	d AC a̰ AL j AB e AL m̥ AF o AM ʊ AM ʔ AC
ဏကြီး	n AG a̰ AL d AC ʑ AJ i AL
တ	t AC ə AL
တကယ်	d AC ə AL ɡ AC ɛ AL
တကာ	d AC ə AL ɡ AC a AL
တက္ကစီ	t AC ɛ AL ʔ AC k AC ə AL s AJ i AL
တက္ကဗေဒ	t AC ɛ AL ʔ AC k AC a̰ AL b AH e AL d AC a̰ AL
တက္ကသိုလ်	t AC ɛ AL ʔ AC k AC ə AL θ AJ o AM
တက်	t AC ɛ AL ʔ AC
တကွ	d AC ə AL ɡ AC w AK a̰ AL
တချို့	t AC ə AL t AC ɕʰ BA o̰ AM
တခြား	t AC ə AL t AC ɕʰ BA a AL
တင့်ကား	t AC ɪ̰ AL ɴ AG k AC a AL
တင်	t AC ɪ AL ɴ AG
တင်ကူး	t AC ɪ AL ɴ AG ɡ AC u AM
တင်ဒါ	t AC ɪ AL ɴ AG d AC a AL
တင်ပါ့ဘုရား	t AC ɪ AL ɴ AG b AH a̰ AL pʰ AI ə AL j AB a AL
တင်းတင်း	t AC ɪ AL ɴ AG t AC ɪ AL ɴ AG
တင်းထိမ်	t AC ɪ AL ɴ AG d AC e AL ɪ AL ɴ AG
တင်းနစ်	t AC ɪ AL ɴ AG n AG ɪ AL ʔ AC
တစပြင်	d AC ə AL z AJ a̰ AL b AH j AB ɪ AL ɴ AG
တစောင်း	d AC ə AL z AJ a AL ʊ AM ɴ AG
တစ္ဆေ	t AC ə AL sʰ BA e AL
တစ်	t AC ɪ AL ʔ AC
တစ်ခုလပ်	t AC ə AL kʰ AD ṵ l AE a AL ʔ AC
တစ်ချောင်းပုဒ်	t AC ə AL t AC ɕʰ BA a AL ʊ AM ɴ AG p AH o AM ʊ AM ʔ AC
တစ်ဆယ်	t AC ə AL z AJ ɛ AL
တစ်ထောင်	t AC ə AL tʰ AD a AL ʊ AM ɴ AG
တစ်ပင်တိုင်မင်းသမီး	d AC ə AL b AH ɪ AL ɴ AG d AC a AL ɪ AL ɴ AG m AF ɪ AL ɴ AG ð AJ ə AL m AF i AL
တစ်ရာ	t AC ə AL j AB a AL
တစ်လ	t AC ə AL l AE a̰ AL
တဆယ်	t AC ə AL z AJ ɛ AL
တဆေး	t AC ə AL sʰ BA e AL
တညင်း	d AC ə AL ɲ AG ɪ AL ɴ AG
တညင်းသီး	d AC ə AL ɲ AG ɪ AL ɴ AG ð AJ i AL
တည်	t AC ɛ AL
တည်ဆောက်	t AC i AL sʰ BA a AL ʊ AM ʔ AC
တည်တံ့	t AC i AL d AC a̰ AL ɴ AG
တည်း	tʰ AD ɛ AL
တဏှင်္ကရာ	t AC ə AL n̥ AG ɪ AL ɴ AG k AC ə AL ɹ AB a AL
တဏှင်္ကရာဘုရား	t AC ə AL n̥ AG ɪ AL ɴ AG k AC ə AL ɹ AB a AL pʰ AI ə AL j AB a AL
တဏှာ	t AC ə AL n̥ AG a AL
တတိယ	t AC a̰ AL t AC ḭ j AB a̰ AL
တတ်	ʔ AC
တန	t AC a̰ AL n AG a̰ AL
တနင်္ဂနွေ	t AC ə AL n AG ɪ AL ɴ AG ɡ AC ə AL n AG w AK e AL
တနင်္လာ	t AC ə AL n AG ɪ AL ɴ AG l AE a AL
တန်ခိုးရှင်	t AC a AL ɴ AG kʰ AD o AM ʃ AJ ɪ AL ɴ AG
တန်ခူး	d AC ə AL ɡ AC u AM
တန်ဆောင်မုန်း	d AC ə AL z AJ a AL ʊ AM ɴ AG m AF o AM ʊ AM ɴ AG
တန်ဇေးနီးယား	t AC a AL ɴ AG z AJ e AL n AG i AL j AB a AL
တပည့်တော်	d AC ə AL b AH ḭ d AC ɔ AM
တပည့်တော်မ	d AC ə AL b AH ḭ d AC ɔ AM m AF a̰ AL
တပို့တွဲ	d AC ə AL b AH o̰ AM d AC w AK ɛ AL
တပေါင်း	d AC ə AL b AH a AL ʊ AM ɴ AG
တပေါင်းလပြည့်နေ့	d AC ə AL b AH a AL ʊ AM ɴ AG l AE a̰ AL p AH j AB ḭ n AG ḛ
တပ်	t AC a AL ʔ AC
တပ်ကြပ်	t AC a AL ʔ AC t AC ɕ AJ a AL ʔ AC
တပ်ကြပ်ကြီး	t AC a AL ʔ AC t AC ɕ AJ a AL ʔ AC t AC ɕ AJ i AL
တပ်ခွဲတပ်ကြပ်ကြီး	t AC a AL ʔ AC kʰ AD w AK ɛ AL t AC a AL ʔ AC t AC ɕ AJ a AL ʔ AC t AC ɕ AJ i AL
တပ်မတော်	t AC a AL ʔ AC m AF ə AL d AC ɔ AM
တပ်မတော်နေ့	t AC a AL ʔ AC m AF ə AL d AC ɔ AM n AG ḛ
တဘက်	d AC ə AL b AH ɛ AL ʔ AC
တမန်	t AC ə AL m AF a AL ɴ AG
တမန်တော်	t AC ə AL m AF a AL ɴ AG d AC ɔ AM
တမလန်း	t AC ə AL m AF ə AL l AE a AL ɴ AG
တယော	t AC ə AL j AB ɔ AM
တယ်	t AC ɛ AL
တယ်လီဖုန်း	t AC ɛ AL l AE i AL pʰ AI o AM ʊ AM ɴ AG
တယ်လီဗီးရှင်း	t AC ɛ AL l AE i AL b AH i AL ʃ AJ ɪ AL ɴ AG
တရား	t AC ə AL j AB a AL
တရားခံ	t AC ə AL j AB ə AL kʰ AD a AL ɴ AG
တရားစွဲ	t AC ə AL j AB a AL s AJ w AK ɛ AL
တရားရုံး	t AC ə AL j AB a AL j AB o AM ʊ AM ɴ AG
တရားလွှတ်တော်	t AC ə AL j AB a AL l̥ AE ʊ AM ʔ AC t AC ɔ AM
တရားလွှတ်တော်ချုပ်	t AC ə AL j AB a AL l̥ AE ʊ AM ʔ AC t AC ɔ AM d AC ʑ AJ o AM ʊ AM ʔ AC
တရားသူကြီး	t AC ə AL j AB a AL ð AJ u AM d AC ʑ AJ i AL
တရုတ်	t AC ə AL j AB o AM ʊ AM ʔ AC
တရုတ်စံကား	t AC a̰ AL j AB o AM ʊ AM ʔ AC s AJ a AL ɴ AG k AC a AL
တရုတ်ဆီးသီး	t AC ə AL j AB o AM ʊ AM ʔ AC z AJ i AL θ AJ i AL
တရုတ်နံနံ	t AC a̰ AL j AB o AM ʊ AM ʔ AC n AG a AL ɴ AG n AG a AL ɴ AG
တရုတ်နှင်းသီး	t AC a̰ AL j AB o AM ʊ AM ʔ AC n̥ AG ɪ AL ɴ AG θ AJ i AL
တရုတ်မဆလာ	t AC ə AL j AB o AM ʊ AM ʔ AC m AF ə AL sʰ BA ə AL l AE a AL
တလည်း	t AC ə AL l AE e AL
တလိုင်း	t AC ə AL l AE a AL ɪ AL ɴ AG
တလွဲ	t AC ə AL l AE w AK ɛ AL
တာချီလိတ်	t AC a AL t AC ɕʰ BA i AL l AE e AL ɪ AL ʔ AC
တာဂျစ်ကစ္စတန်	t AC a AL d AC ʑ AJ ɪ AL ʔ AC k AC ɪ AL ʔ AC s AJ ə AL t AC a AL ɴ AG
တာတား	t AC a AL t AC a AL
တာမွေ	t AC a AL m AF w AK e AL
တာယာ	t AC a AL j AB a AL
တာရာ	t AC a AL j AB a AL
တာလုဇ	t AC a AL l AE ṵ z AJ a̰ AL
တာဝတိံသာ	t AC a AL w AK a̰ AL t AC e AL ɪ AL ɴ AG θ AJ a AL
တာဝန်	t AC a AL w AK ʊ AM ɴ AG
တာ့ခ်မင်နစ္စတန်	t AC a̰ AL kʰ AD m AF ɪ AL ɴ AG n AG ɪ AL ʔ AC s AJ ə AL t AC a AL ɴ AG
တား	t AC a AL
တိ	t AC ḭ
တိတ်	t AC e AL ɪ AL ʔ AC
တိန်းညက်	t AC e AL ɪ AL ɴ AG ɲ AG ɛ AL ʔ AC
တိပိဋက	t AC ḭ p AH ḭ t AC ə AL k AC a̰ AL
တိမ်	t AC e AL ɪ AL ɴ AG
တိရစ္ဆာန်	t AC ə AL ɹ AB e AL ɪ AL ʔ AC sʰ BA a AL ɴ AG
တိရစ္ဆာန်ရုံ	t AC ə AL ɹ AB e AL ɪ AL ʔ AC sʰ BA a AL ɴ AG j AB o AM ʊ AM ɴ AG
တို	t AC o AM
တိုက်	t AC a AL ɪ AL ʔ AC
တိုက်ခန်း	t AC a AL ɪ AL ʔ AC kʰ AD a AL ɴ AG
တိုက်ပုံ	t AC a AL ɪ AL ʔ AC p AH o AM ʊ AM ɴ AG
တိုက်ပွဲ	t AC a AL ɪ AL ʔ AC p AH w AK ɛ AL
တိုက်အိမ်	t AC a AL ɪ AL ʔ AC ʔ AC e AL ɪ AL ɴ AG
တိုကျို	t AC o AM t AC ɕ AJ o AM
တိုဂို	t AC o AM ɡ AC o AM
တိုင်	t AC a AL ɪ AL ɴ AG
တိုင်ကီ	t AC a AL ɪ AL ɴ AG k AC i AL
တိုင်ပင်	t AC a AL ɪ AL ɴ AG b AH ɪ AL ɴ AG
တိုင်ဖွန်း	t AC a AL ɪ AL ɴ AG pʰ AI ʊ AM ɴ AG
တိုင်းရင်းသား	t AC a AL ɪ AL ɴ AG j AB ɪ AL ɴ AG ð AJ a AL
တိုဖူး	t AC o AM pʰ AI u AM
တိုရှေ	t AC o AM ʃ AJ e AL
တိုဟူး	t AC o AM h AA u AM
တိုဟူးနွေး	t AC o AM h AA u AM n AG w AK e AL
တိုဟူးသုပ်	t AC o AM h AA u AM θ AJ o AM ʊ AM ʔ AC
တို့	d AC o̰ AM
တိုး	t AC o AM
တိုးတက်	t AC o AM t AC ɛ AL ʔ AC
တိုးတက်ခြင်း	t AC o AM t AC ɛ AL ʔ AC d AC ʑ AJ ɪ AL ɴ AG
တိုးတက်ရေး	t AC o AM t AC ɛ AL ʔ AC j AB e AL
တိုးတိုး	t AC o AM d AC o AM
တိုးနရား	t AC o AM n AG ə AL j AB a AL
တိဿ	t AC e AL ɪ AL ʔ AC θ AJ a̰ AL
တိဿဘုရား	t AC e AL ɪ AL ʔ AC θ AJ a̰ AL pʰ AI ə AL j AB a AL
တီ	t AC i AL
တီကောင်	t AC i AL ɡ AC a AL ʊ AM ɴ AG
တီကေ့	t AC i AL k AC ḛ
တီထွင်	t AC i AL tʰ AD w AK ɪ AL ɴ AG
တီထွင်မှု	t AC i AL tʰ AD w AK ɪ AL ɴ AG m̥ AF ṵ
တီဗီ	t AC i AL b AH i AL
တီရှပ်	t AC i AL ʃ AJ a AL ʔ AC
တီဟီရန်	t AC i AL h AA i AL ɹ AB a AL ɴ AG
တီး	t AC i AL
တီးတိုးပြော	t AC i AL d AC o AM p AH j AB ɔ AM
တုတ်	d AC o AM ʊ AM ʔ AC
တုတ်မီး	d AC o AM ʊ AM ʔ AC m AF i AL
တုံး	t AC o AM ʊ AM ɴ AG
တူ	t AC u AM
တူနီးရှား	t AC u AM n AG i AL ʃ AJ a AL
တူမ	t AC u AM m AF a̰ AL
တူရကီ	t AC u AM ɹ AB ə AL k AC i AL
တူရိယာ	t AC u AM ɹ AB ḭ j AB a AL
တူး	t AC u AM
တူးမြောင်း	t AC u AM m AF j AB a AL ʊ AM ɴ AG
တူးရစ်	t AC u AM ɹ AB ɪ AL ʔ AC
တေဇော	t AC e AL z AJ ɔ AM
တေသံ	t AC e AL ð AJ a AL ɴ AG
တော	t AC ɔ AM
တောက်တဲ့	t AC a AL ʊ AM ʔ AC t AC ɛ̰ AL
တောက်ပ	t AC a AL ʊ AM ʔ AC p AH a̰ AL
တောကြက်မောက်	t AC ɔ AM t AC ɕ AJ ɛ AL ʔ AC m AF a AL ʊ AM ʔ AC
တောခွေး	t AC ɔ AM ɡ AC w AK e AL
တောင်	t AC a AL ʊ AM ɴ AG
တောင်ကိုရီးယား	t AC a AL ʊ AM ɴ AG k AC o AM ɹ AB i AL j AB a AL
တောင်ကြား	t AC a AL ʊ AM ɴ AG d AC ʑ AJ a AL
တောင်ကြီး	t AC a AL ʊ AM ɴ AG d AC ʑ AJ i AL
တောင်ငူ	t AC a AL ʊ AM ɴ AG ŋ AG u AM
တောင်ဆူဒန်	t AC a AL ʊ AM ɴ AG sʰ BA u AM d AC a AL ɴ AG
တောင်ပံ	t AC a AL ʊ AM ɴ AG b AH a AL ɴ AG
တောင်ဖက်ဝန်း	t AC a AL ʊ AM ɴ AG pʰ AI ɛ AL ʔ AC w AK ʊ AM ɴ AG
တောင်သူ	t AC a AL ʊ AM ɴ AG ð AJ u AM
တောင်သူလယ်သမား	t AC a AL ʊ AM ɴ AG ð AJ u AM l AE ɛ AL ð AJ ə AL m AF a AL
တောင်သူလယ်သမားနေ့	t AC a AL ʊ AM ɴ AG ð AJ u AM l AE ɛ AL θ AJ ə AL m AF a AL n AG ḛ
တောင်အာဖရိက	t AC a AL ʊ AM ɴ AG ʔ AC a AL pʰ AI ə AL ɹ AB ḭ k AC a̰ AL
တောင်း	t AC a AL ʊ AM ɴ AG
တောင်းပန်	t AC a AL ʊ AM ɴ AG b AH a AL ɴ AG
တောမန်ကျည်း	t AC ɔ AM m AF ə AL d AC ʑ AJ i AL
တောသား	t AC ɔ AM ð AJ a AL
တောသီတင်း	t AC ɔ AM θ AJ i AL d AC ɪ AL ɴ AG
တော်	t AC ɔ AM
တော်ပြီ	t AC ɔ AM b AH i AL
တော်လေးဝ	t AC ɔ AM l AE e AL w AK a̰ AL
တော်လှန်	t AC ɔ AM l̥ AE a AL ɴ AG
တော်လှန်ရေး	t AC ɔ AM l̥ AE a AL ɴ AG j AB e AL
တော်သလင်း	t AC ɔ AM ð AJ ə AL l AE ɪ AL ɴ AG
တေးသံရှင်	t AC e AL θ AJ a AL ɴ AG ʃ AJ ɪ AL ɴ AG
တေးသွား	t AC e AL ð AJ w AK a AL
တဲ	t AC ɛ AL
တဲ့	d AC ɛ̰ AL
တံ	t AC a AL ɴ AG
တံခါး	d AC ə AL ɡ AC a AL
တံခါးဗိုလ်	d AC ə AL ɡ AC a AL b AH o AM
တံခွန်	d AC ə AL ɡ AC ʊ AM ɴ AG
တံခွန်တိုင်	d AC ə AL ɡ AC ʊ AM ɴ AG d AC a AL ɪ AL ɴ AG
တံငါ	t AC ə AL ŋ AG a AL
တံစဉ်	d AC ə AL z AJ ɪ AL ɴ AG
တံစဉ်း	d AC ə AL z AJ ɪ AL ɴ AG
တံဆိပ်	d AC ə AL z AJ e AL ɪ AL ʔ AC
တံဆိပ်ခေါင်း	d AC ə AL z AJ e AL ɪ AL ʔ AC ɡ AC a AL ʊ AM ɴ AG
တံတား	d AC ə AL d AC a AL
တံတိုင်း	d AC ə AL d AC a AL ɪ AL ɴ AG
တံတောင်	d AC ə AL d AC a AL ʊ AM ɴ AG
တံပိုး	d AC ə AL b AH o AM
တံပူ	d AC ə AL b AH u AM
တံမြက်စည်း	d AC ə AL b AH j AB ɛ AL ʔ AC s AJ i AL
တံ့တံ့	t AC a̰ AL ɴ AG d AC a̰ AL ɴ AG
တြိ	t AC ə AL ɹ AB ḭ
တြိဂံ	t AC ɹ AB ḭ ɡ AC a AL ɴ AG
တြိပူရ	t AC ə AL ɹ AB ḭ p AH u AM j AB a̰ AL
တွက်	t AC w AK ɛ AL ʔ AC
တွင်	t AC w AK ɪ AL ɴ AG
တွင်း	t AC w AK ɪ AL ɴ AG
တွန်း	t AC ʊ AM ɴ AG
တွပ်	t AC ʊ AM ʔ AC
တွေ့	t AC w AK ḛ
တွေး	t AC w AK e AL
ထ	tʰ AD a̰ AL
ထက်	tʰ AD ɛ AL ʔ AC
ထက်ဝယ်ဖွဲ့ခွေ	tʰ AD ɛ AL ʔ AC w AK ɛ AL pʰ AI w AK ɛ̰ AL kʰ AD w AK e AL
ထင်	tʰ AD ɪ AL ɴ AG
ထင်စား	tʰ AD ɪ AL ɴ AG z AJ a AL
ထင်း	tʰ AD ɪ AL ɴ AG
ထဆင်ထူး	tʰ AD a̰ AL sʰ BA ɪ AL ɴ AG d AC u AM
ထည်	tʰ AD ɛ AL
ထနောင်း	tʰ AD ə AL n AG a AL ʊ AM ɴ AG
ထန်း	tʰ AD a AL ɴ AG
ထန်းလျက်	tʰ AD ə AL ɲ AG ɛ AL ʔ AC
ထပ်	tʰ AD a AL ʔ AC
ထပ်တစ်ရာ	tʰ AD a AL ʔ AC t AC ə AL j AB a AL
ထဘီ	tʰ AD ə AL m AF i AL
ထမင်း	tʰ AD ə AL m AF ɪ AL ɴ AG
ထမင်းကြော်	tʰ AD ə AL m AF ɪ AL ɴ AG d AC ʑ AJ ɔ AM
ထမင်းချဉ်	tʰ AD ə AL m AF ɪ AL ɴ AG d AC ʑ AJ ɪ AL ɴ AG
ထမင်းဆိုင်	tʰ AD ə AL m AF ɪ AL ɴ AG z AJ a AL ɪ AL ɴ AG
ထမင်းသုပ်	tʰ AD a̰ AL m AF ɪ AL ɴ AG θ AJ o AM ʊ AM ʔ AC
ထမနဲ	tʰ AD a̰ AL m AF a̰ AL n AG ɛ AL
ထယ်	tʰ AD ɛ AL
ထာဝရ	tʰ AD a AL w AK ə AL j AB a̰ AL
ထာဝရဥစ္စာ	tʰ AD a AL w AK ə AL j AB a̰ AL ʔ AC o AM ʊ AM ʔ AC s AJ a AL
ထား	tʰ AD a AL
ထားဝယ်	d AC ə AL w AK ɛ AL
ထိ	tʰ AD ḭ
ထိကပေါက်	tʰ AD ḭ ɡ AC ə AL b AH a AL ʊ AM ʔ AC
ထိပ်ခေါင်တင်	tʰ AD e AL ɪ AL ʔ AC kʰ AD a AL ʊ AM ɴ AG t AC ɪ AL ɴ AG
ထိပ်စုဖုရား	tʰ AD e AL ɪ AL ʔ AC s AJ ṵ pʰ AI ə AL j AB a AL
ထိမ်းမြား	tʰ AD e AL ɪ AL ɴ AG m AF j AB a AL
ထို	tʰ AD o AM
ထိုင်	tʰ AD a AL ɪ AL ɴ AG
ထိုင်ခုံ	tʰ AD a AL ɪ AL ɴ AG ɡ AC o AM ʊ AM ɴ AG
ထိုင်ပေ	tʰ AD a AL ɪ AL ɴ AG p AH e AL
ထိုင်မသိမ်း	tʰ AD a AL ɪ AL ɴ AG m AF ə AL θ AJ e AL ɪ AL ɴ AG
ထိုင်ဝမ်	tʰ AD a AL ɪ AL ɴ AG w AK a AL ɴ AG
ထိုင်း	tʰ AD a AL ɪ AL ɴ AG
ထိုမှာ	tʰ AD o AM m̥ AF a AL
ထိုး	tʰ AD o AM
ထိုးမုန့်	tʰ AD o AM m AF o̰ AM ʊ AM ɴ AG
ထီ	tʰ AD i AL
ထီး	tʰ AD i AL
ထီးတင်	tʰ AD i AL t AC ɪ AL ɴ AG
ထီးဖြူ	tʰ AD i AL b AH j AB u AM
ထုတ်ကုန်	tʰ AD o AM ʊ AM ʔ AC k AC o AM ʊ AM ɴ AG
ထုတ်လုပ်	tʰ AD o AM ʊ AM ʔ AC l AE o AM ʊ AM ʔ AC
ထုတ်လုပ်မှု	tʰ AD o AM ʊ AM ʔ AC l AE o AM ʊ AM ʔ AC m̥ AF ṵ
ထုတ်ဝေသူ	tʰ AD o AM ʊ AM ʔ AC w AK e AL ð AJ u AM
ထုံးစံ	tʰ AD o AM ʊ AM ɴ AG z AJ a AL ɴ AG
ထူ	tʰ AD u AM
ထူထဲ	tʰ AD u AM d AC ɛ AL
ထူပါ	tʰ AD u AM p AH a AL
ထူး	tʰ AD u AM
ထေရဝါဒ	tʰ AD e AL j AB a̰ AL w AK a AL d AC a̰ AL
ထော	tʰ AD ɔ AM
ထောက်	tʰ AD a AL ʊ AM ʔ AC
ထောက်ကြံ့	tʰ AD a AL ʊ AM ʔ AC t AC ɕ AJ a̰ AL ɴ AG
ထောက်ခံ	tʰ AD a AL ʊ AM ʔ AC kʰ AD a AL ɴ AG
ထောက်ပံ့	tʰ AD a AL ʊ AM ʔ AC p AH a̰ AL ɴ AG
ထောင့်	d AC a̰ AL ʊ AM ɴ AG
ထောင်	tʰ AD a AL ʊ AM ɴ AG
ထောင်ကဲ	tʰ AD a AL ʊ AM ɴ AG k AC ɛ AL
ထောင်မှူး	tʰ AD a AL ʊ AM ɴ AG m̥ AF u AM
ထောင်သား	tʰ AD a AL ʊ AM ɴ AG ð AJ a AL
ထောပတ်	tʰ AD ɔ AM b AH a AL ʔ AC
ထောပတ်ထမင်း	tʰ AD ɔ AM b AH a AL ʔ AC tʰ AD ə AL m AF ɪ AL ɴ AG
ထောပတ်သီး	tʰ AD ɔ AM p AH a AL ʔ AC θ AJ i AL
ထော်လာဂျီ	tʰ AD ɔ AM l AE a AL d AC ʑ AJ i AL
ထဲ	tʰ AD ɛ AL
ထံ	tʰ AD a AL ɴ AG
ထွက်	tʰ AD w AK ɛ AL ʔ AC
ထွက်ပေါက်	tʰ AD w AK ɛ AL ʔ AC p AH a AL ʊ AM ʔ AC
ထွက်ပြေး	tʰ AD w AK ɛ AL ʔ AC p AH j AB e AL
ထွန်	tʰ AD ʊ AM ɴ AG
ထွန်စက်	tʰ AD ʊ AM ɴ AG z AJ ɛ AL ʔ AC
ထွန်း	tʰ AD ʊ AM ɴ AG
ထွေး	tʰ AD w AK e AL
ဒကာ	d AC ə AL ɡ AC a AL
ဒက္ခိဏ	d AC ɛ AL ʔ AC kʰ AD ḭ n AG a̰ AL
ဒဂုံ	d AC ə AL ɡ AC o AM ʊ AM ɴ AG
ဒင်္ဂါး	d AC ɪ AL ɴ AG ɡ AC a AL
ဒင်္ဂါးတိုက်	d AC ɪ AL ɴ AG ɡ AC a AL d AC a AL ɪ AL ʔ AC
ဒစ္စကို	d AC ɪ AL ʔ AC s AJ a̰ AL k AC o AM
ဒဏ္ဍာရီ	d AC a AL n AG d AC a AL j AB i AL
ဒဏ်	d AC a AL n AG
ဒဏ်ငွေ	d AC a AL n AG ŋ AG w AK e AL
ဒဏ်ရာ	d AC a AL ɴ AG j AB a AL
ဒထွေး	d AC a̰ AL d AC w AK e AL
ဒန့်သလွန်	d AC a̰ AL ɴ AG ð AJ ə AL l AE ʊ AM ɴ AG
ဒန်ပူ	d AC ə AL b AH u AM
ဒန်း	d AC a AL ɴ AG
ဒသမ	d AC a̰ AL θ AJ ə AL m AF a̰ AL
ဒါ	d AC a AL
ဒါန	d AC a AL n AG a̰ AL
ဒါပါပဲ	d AC a AL b AH a AL b AH ɛ AL
ဒါပေမဲ့	d AC a AL b AH e AL m AF ɛ̰ AL
ဒါပော့	d AC a AL p AH ɔ̰ AM
ဒိန်ခဲ	d AC e AL ɪ AL ɴ AG ɡ AC ɛ AL
ဒိန်ချဉ်	d AC e AL ɪ AL ɴ AG d AC ʑ AJ ɪ AL ɴ AG
ဒိန်းမတ်	d AC e AL ɪ AL ɴ AG m AF a AL ʔ AC
ဒိုင်ခွက်	d AC a AL ɪ AL ɴ AG ɡ AC w AK ɛ AL ʔ AC
ဒိုင်နိုဆော	d AC a AL ɪ AL ɴ AG n AG o AM sʰ BA ɔ AM
ဒိုင်ယာနာ	d AC a AL ɪ AL ɴ AG j AB a AL n AG a AL
ဒိုင်ယာရီ	d AC a AL ɪ AL ɴ AG j AB ə AL ɹ AB i AL
ဒီ	d AC i AL
ဒီဂရီ	d AC i AL ɡ AC ə AL ɹ AB i AL
ဒီဃ	d AC i AL ɡ AC a̰ AL
ဒီဇင်ဘာ	d AC i AL z AJ ɪ AL ɴ AG b AH a AL
ဒီဇိုင်နာ	d AC i AL z AJ a AL ɪ AL ɴ AG n AG a AL
ဒီဇိုင်း	d AC i AL z AJ a AL ɪ AL ɴ AG
ဒီည	d AC i AL ɲ AG a̰ AL
ဒီနေ့	d AC i AL n AG ḛ
ဒီပင်္ကရာ	d AC i AL p AH ɪ AL ɴ AG k AC ə AL ɹ AB a AL
ဒီပင်္ကရာဘုရား	d AC i AL p AH ɪ AL ɴ AG k AC ə AL ɹ AB a AL pʰ AI ə AL j AB a AL
ဒီပါ	d AC i AL p AH a AL
ဒီပါဝလီ	d AC i AL p AH a AL w AK ə AL l AE i AL
ဒီဗီဒီ	d AC i AL b AH i AL d AC i AL
ဒီမိုကရေစီ	d AC i AL m AF o AM k AC ə AL ɹ AB e AL s AJ i AL
ဒီမှာ	d AC i AL m̥ AF a AL
ဒီလို	d AC i AL l AE o AM
ဒီဟာ	d AC i AL h AA a AL
ဒု	d AC ṵ
ဒုက္ခ	d AC o AM ʊ AM ʔ AC kʰ AD a̰ AL
ဒုက္ခသည်	d AC o AM ʊ AM ʔ AC kʰ AD a̰ AL ð AJ e AL
ဒုက္ခိတ	d AC o AM ʊ AM ʔ AC kʰ AD ḭ t AC a̰ AL
ဒုတိယ	d AC ṵ t AC ḭ j AB a̰ AL
ဒုတိယတပ်ကြပ်	d AC ṵ t AC ḭ j AB a̰ AL t AC a AL ʔ AC t AC ɕ AJ a AL ʔ AC
ဒုတိယဗိုလ်	d AC ṵ t AC ḭ j AB a̰ AL b AH o AM
ဒုတိယဗိုလ်ချုပ်ကြီး	d AC ṵ t AC ḭ j AB a̰ AL b AH o AM d AC ʑ AJ o AM ʊ AM ʔ AC d AC ʑ AJ i AL
ဒုတိယဗိုလ်ချုပ်မှူးကြီး	d AC ṵ t AC ḭ j AB a̰ AL b AH o AM d AC ʑ AJ o AM ʊ AM ʔ AC m̥ AF u AM d AC ʑ AJ i AL
ဒုတိယဗိုလ်မှူးကြီး	d AC ṵ t AC ḭ j AB a̰ AL b AH o AM m̥ AF u AM d AC ʑ AJ i AL
ဒုတိယအရာခံဗိုလ်	d AC ṵ t AC ḭ j AB a̰ AL ʔ AC ə AL j AB a AL ɡ AC a AL ɴ AG b AH o AM
ဒုဗ္ဘိက္ခန္တရကပ်	d AC o AM ʊ AM ʔ AC b AH e AL ɪ AL ʔ AC kʰ AD a AL ɴ AG t AC ə AL ɹ AB a̰ AL k AC a AL ʔ AC
ဒုယင်တော်	d AC ə AL j AB ɪ AL ɴ AG d AC ɔ AM
ဒုံမင်း	d AC o AM ʊ AM ɴ AG m AF ɪ AL ɴ AG
ဒုံး	d AC o AM ʊ AM ɴ AG
ဒုံးပျံ	d AC o AM ʊ AM ɴ AG b AH j AB a AL ɴ AG
ဒူလာ	d AC u AM l AE a AL
ဒူး	d AC u AM
ဒူးခေါင်း	d AC u AM ɡ AC a AL ʊ AM ɴ AG
ဒူးထောက်	d AC u AM tʰ AD a AL ʊ AM ʔ AC
ဒူးရင်းယို	d AC u AM j AB ɪ AL ɴ AG j AB o AM
ဒူးရင်းသီး	d AC u AM j AB ɪ AL ɴ AG θ AJ i AL
ဒူးလေး	d AC u AM l AE e AL
ဒူးဝါး	d AC u AM w AK a AL
ဒေတာဘေ့စ်	d AC e AL t AC a AL b AH ḛ s AJ
ဒေဝ	d AC e AL w AK a̰ AL
ဒေဝဒတ်	d AC e AL w AK ə AL d AC a AL ʔ AC
ဒေဝနာဂရီ	d AC e AL w AK a̰ AL n AG a AL ɡ AC ə AL ɹ AB i AL
ဒေဝါလီခံ	d AC e AL w AK a AL l AE i AL kʰ AD a AL ɴ AG
ဒေဝီ	d AC e AL w AK i AL
ဒေသ	d AC e AL θ AJ a̰ AL
ဒေသန္တရ	d AC e AL θ AJ a AL ɴ AG t AC ə AL j AB a̰ AL
ဒေသန္တရစကား	d AC e AL θ AJ a AL ɴ AG t AC ə AL ɹ AB a̰ AL z AJ ə AL ɡ AC a AL
ဒေသိယစကား	d AC e AL θ AJ ḭ j AB a̰ AL z AJ ə AL ɡ AC a AL
ဒေါက်တာ	d AC a AL ʊ AM ʔ AC t AC a AL
ဒေါင်း	d AC a AL ʊ AM ɴ AG
ဒေါင်းလန်း	d AC a AL ʊ AM ɴ AG l AE a AL ɴ AG
ဒေါ်	d AC ɔ AM
ဒေါ်ကြီး	d AC ɔ AM d AC ʑ AJ i AL
ဒေါ်လာ	d AC ɔ AM l AE a AL
ဒေါ်လေး	d AC ɔ AM l AE e AL
ဒံပေါက်	d AC a AL ɴ AG p AH a AL ʊ AM ʔ AC
ဒြပ်	d AC ə AL ɹ AB a AL ʔ AC
ဒြပ်စင်	d AC ə AL ɹ AB a AL ʔ AC s AJ ɪ AL ɴ AG
ဒြပ်ထု	d AC ə AL ɹ AB a AL ʔ AC tʰ AD u AM
ဒွယံဒွယံ	d AC w AK a̰ AL j AB a AL ɴ AG d AC w AK a̰ AL j AB a AL ɴ AG
ဒွာရ	d AC w AK a AL j AB a̰ AL
ဒွိ	d AC w AK ḭ
ဒွိလိင်	d AC w AK ḭ l AE e AL ɪ AL ɴ AG
ဒွေးဘော်	d AC w AK e AL b AH ɔ AM
ဒဿဂီရိ	d AC ə AL θ AJ a̰ AL ɡ AC i AL j AB ḭ
ဒဿနဗေဒ	d AC a̰ AL θ AJ ə AL n AG a̰ AL b AH e AL d AC a̰ AL
ဒဿနိကဗေဒ	d AC a̰ AL θ AJ ə AL n AG ḭ k AC a̰ AL b AH e AL d AC a̰ AL
ဓနရှင်	d AC ə AL n AG a̰ AL ʃ AJ ɪ AL ɴ AG
ဓနိတ	d AC ə AL n AG ḭ t AC a̰ AL
ဓနု	d AC ə AL n AG ṵ
ဓမ္မ	d AC ə AL m AF a̰ AL
ဓမ္မတာ	d AC ə AL m AF ə AL d AC a AL
ဓမ္မတာကာလ	d AC ə AL m AF ə AL d AC a AL k AC a AL l AE a̰ AL
ဓမ္မတာလာ	d AC ə AL m AF ə AL d AC a AL l AE a AL
ဓမ္မတာဝန်	d AC ə AL m AF ə AL d AC a AL w AK ʊ AM ɴ AG
ဓမ္မဒဿီ	d AC ə AL m AF a̰ AL m AF a̰ AL d AC a AL ʔ AC θ AJ i AL
ဓမ္မဒဿီဘုရား	d AC ə AL m AF a̰ AL d AC ə AL t AC θ AJ i AL pʰ AI ə AL j AB a AL
ဓမ္မပါလ	d AC a AL ɴ AG m AF a̰ AL p AH a AL l AE a̰ AL
ဓမ္မသတ်	d AC ə AL m AF ə AL θ AJ a AL ʔ AC
ဓလေ့	d AC ə AL l AE ḛ
ဓအောက်ခြိုက်	d AC a̰ AL ʔ AC a AL ʊ AM ʔ AC t AC ɕʰ BA a AL ɪ AL ʔ AC
ဓာတုဗေဒ	d AC a AL t AC ṵ b AH e AL d AC a̰ AL
ဓာတ်	d AC a AL ʔ AC
ဓာတ်ကြီးလေးပါး	d AC a AL t AC t AC ɕ AJ i AL l AE e AL p AH a AL
ဓာတ်ခဲ	d AC a AL ʔ AC kʰ AD e AL
ဓာတ်ခွက်	d AC a AL t AC kʰ AD w AK ɛ AL ʔ AC
ဓာတ်ငွေ့	d AC a AL ʔ AC ŋ AG w AK ḛ
ဓာတ်ဆီ	d AC a AL ʔ AC sʰ BA i AL
ဓာတ်ဆီဆိုင်	d AC a AL ʔ AC sʰ BA i AL z AJ a AL ɪ AL ɴ AG
ဓာတ်ပုံ	d AC a AL ʔ AC p AH o AM ʊ AM ɴ AG
ဓာတ်ပြား	d AC a AL ʔ AC p AH j AB a AL
ဓာတ်မီးခြစ်	d AC a AL ʔ AC m AF i AL d AC ʑ AJ ɪ AL ʔ AC
ဓာတ်မီးပူ	d AC a AL ʔ AC m AF i AL b AH u AM
ဓာတ်လှေကား	d AC a AL ʔ AC l̥ AE e AL ɡ AC a AL
ဓာတ်အိုး	d AC a AL ʔ AC ʔ AC o AM
ဓား	d AC a AL
ဓားစာခံ	d AC ə AL z AJ a AL ɡ AC a AL ɴ AG
ဓားပြ	d AC ə AL m AF j AB a̰ AL
ဓားပြား	d AC ə AL b AH j AB a AL
ဓားအိမ်	d AC ə AL ʔ AC e AL ɪ AL ɴ AG
နက္ခတ္တဗေဒ	n AG ɛ AL ʔ AC kʰ AD ə AL t AC a̰ AL b AH e AL d AC a̰ AL
နက်	n AG ɛ AL ʔ AC
နက်ဖြန်	n AG ɛ AL ʔ AC pʰ AI j AB a AL ɴ AG
နကျယ်ကောင်	n AG ə AL d AC ʑ AJ ɛ AL ɡ AC a AL ʊ AM ɴ AG
နဂါး	n AG ə AL ɡ AC a AL
နဂါးမောက်	n AG a̰ AL ɡ AC a AL m AF a AL ʊ AM ʔ AC
နဂါးမောက်သီး	n AG a̰ AL ɡ AC a AL m AF a AL ʊ AM ʔ AC θ AJ i AL
နငယ်	n AG a̰ AL ŋ AG ɛ AL
နင်	n AG ɪ AL ɴ AG
နင်တို့	n AG ɪ AL ɴ AG d AC o̰ AM
နည်း	n AG ɛ AL
နည်းနည်း	n AG ɛ AL n AG ɛ AL
နည်းနည်းချင်း	n AG i AL n AG i AL t AC ɕʰ BA ɪ AL ɴ AG
နည်းပညာ	n AG i AL p AH j AB ɪ AL ɴ AG ɲ AG a AL
နတ်	n AG a AL ʔ AC
နတ်ကွန်း	n AG a AL ʔ AC k AC ʊ AM ɴ AG
နတ်ဆိုး	n AG a AL ʔ AC sʰ BA o AM
နတ်တော်	n AG ə AL d AC ɔ AM
နတ်နန်း	n AG a AL ʔ AC n AG a AL ɴ AG
နတ်ပြည်ခြောက်ထပ်	n AG a AL ʔ AC p AH j AB i AL t AC ɕʰ BA a AL ʊ AM ʔ AC tʰ AD a AL ʔ AC
နတ်ရွာစံ	n AG a AL ʔ AC j AB w AK a AL s AJ a AL ɴ AG
နတ်သုဓာ	n AG a AL ʔ AC θ AJ o AM ʊ AM ʔ AC d AC a AL
နတ်သုဓာထမင်း	n AG a AL ʔ AC θ AJ o AM ʊ AM ʔ AC d AC a AL tʰ AD ə AL m AF ɪ AL ɴ AG
နဒီ	n AG ə AL d AC i AL
နန္ဒာ	n AG a AL ɴ AG d AC a AL
နန်း	n AG a AL ɴ AG
နန်းကထိ	n AG a AL ɴ AG k AC ə AL tʰ AD ḭ
နန်းကြီး	n AG a AL ɴ AG t AC ɕ AJ i AL
နန်းကြီးသုပ်	n AG a AL ɴ AG t AC ɕ AJ i AL θ AJ o AM ʊ AM ʔ AC
နန်းတော်	n AG a AL ɴ AG d AC ɔ AM
နန်းပြားသုပ်	n AG a AL ɴ AG b AH j AB a AL θ AJ o AM ʊ AM ʔ AC
နန်းမတော်	n AG a AL ɴ AG m AF ə AL d AC ɔ AM
နန်းမြင့်	n AG a AL ɴ AG m AF j AB ɪ̰ AL ɴ AG
နနွင်း	sʰ BA ə AL n AG w AK ɪ AL ɴ AG
နပန်း	n AG ə AL b AH a AL ɴ AG
နဖူး	n AG a̰ AL pʰ AI u AM
နမီးဘီးယား	n AG a̰ AL m AF i AL b AH i AL j AB a AL
နမူနာ	n AG ə AL m AF u AM n AG a AL
နမ်း	n AG a AL ɴ AG
နယုန်	n AG ə AL j AB o AM ʊ AM ɴ AG
နယူးဇီလန်	n AG ə AL j AB u AM z AJ i AL l AE a AL ɴ AG
နယူးဒေလီ	n AG ə AL j AB u AM d AC e AL l AE i AL
နယူးယောက်	n AG ə AL j AB u AM j AB a AL ʊ AM ʔ AC
နယ်	n AG ɛ AL
နယ်စပ်	n AG ɛ AL z AJ a AL ʔ AC
နယ်သာလန်	n AG ɛ AL ð AJ ə AL l AE a AL ɴ AG
နရက်	n AG ə AL ɹ AB ɛ AL ʔ AC
နရန်း	n AG ə AL j AB a AL ɴ AG
နရား	n AG ə AL j AB a AL
နဝကမ္မ	n AG ə AL w AK a̰ AL k AC a AL ɴ AG m AF a̰ AL
နဝမ	n AG ə AL w AK ə AL m AF a̰ AL
နဝရတ်	n AG ə AL w AK ə AL ɹ AB a AL ʔ AC
နဝရူပ	n AG a̰ AL w AK a̰ AL j AB u AM p AH a̰ AL
နာ	n AG a AL
နာဂဒေဝ	n AG a AL ɡ AC a̰ AL d AC e AL w AK a̰ AL
နာဂရီ	n AG a AL ɡ AC ə AL ɹ AB i AL
နာတာလူးပွဲ	n AG a AL t AC a AL l AE u AM b AH w AK ɛ AL
နာနတ်	n AG ə AL n AG a AL ʔ AC
နာနတ်ပွင့်	n AG ə AL n AG a AL ʔ AC p AH w AK ɪ̰ AL ɴ AG
နာနတ်သီး	n AG a AL n AG a AL ʔ AC θ AJ i AL
နာနာ	n AG a AL n AG a AL
နာနာဘာဝ	n AG a AL n AG a AL b AH a AL w AK a̰ AL
နာမ	n AG a AL m AF a̰ AL
နာမကရဏ	n AG a AL m AF a̰ AL k AC ə AL ɹ AB ə AL n AG a̰ AL
နာမကျန်း	n AG a AL m AF ə AL t AC ɕ AJ a AL ɴ AG
နာမည်	n AG a AL m AF j AB i AL
နာမဝိသေသန	n AG a AL m AF a̰ AL w AK ḭ θ AJ e AL θ AJ ə AL n AG a̰ AL
နာမ်	n AG a AL ɴ AG
နာမ်စား	n AG a AL m AF z AJ a AL
နာရဒ	n AG a AL ɹ AB ə AL d AC a̰ AL
နာရဒဘုရား	n AG a AL ɹ AB ə AL d AC a̰ AL pʰ AI ə AL j AB a AL
နာရီ	n AG a AL j AB i AL
နာရီဝက်	n AG a AL j AB i AL w AK ɛ AL ʔ AC
နား	n AG a AL
နားကပ်	n AG a AL ɡ AC a AL ʔ AC
နားကြပ်	n AG ə AL d AC ʑ AJ a AL ʔ AC
နားကွင်း	n AG a AL ɡ AC w AK ɪ AL ɴ AG
နားထင်	n AG ə AL tʰ AD ɪ AL ɴ AG
နားထောင်	n AG a AL tʰ AD a AL ʊ AM ɴ AG
နားရွက်	n AG ə AL j AB w AK ɛ AL ʔ AC
နားလည်	n AG a AL l AE ɛ AL
နိကာယ	n AG ḭ k AC a AL j AB a̰ AL
နိခါတကဗေဒ	n AG ḭ kʰ AD a AL t AC ə AL k AC a̰ AL b AH e AL d AC a̰ AL
နိဂ္ဂဟိတ	n AG e AL ɪ AL ʔ AC ɡ AC ə AL h AA ḭ t AC a̰ AL
နိစ္စ	n AG e AL s AJ a̰ AL
နိဒါန်း	n AG ḭ d AC a AL ɴ AG
နိဒ္ဒေသ	n AG e AL ɪ AL ʔ AC d AC e AL θ AJ a̰ AL
နိပေါ	n AG ḭ p AH ɔ AM
နိဗ္ဗာန်	n AG e AL ɪ AL ʔ AC b AH a AL ɴ AG
နိယာမ	n AG ḭ j AB a AL m AF a̰ AL
နိုက်ထရိုဂျင်	n AG a AL ɪ AL ʔ AC tʰ AD ə AL ɹ AB o AM d AC ʑ AJ ɪ AL ɴ AG
နိုင်	n AG a AL ɪ AL ɴ AG
နိုင်ဂျာ	n AG a AL ɪ AL ɴ AG d AC ʑ AJ a AL
နိုင်ဂျီးရီးယား	n AG a AL ɪ AL ɴ AG d AC ʑ AJ i AL ɹ AB i AL j AB a AL
နိုင်ငံ	n AG a AL ɪ AL ɴ AG ŋ AG a AL ɴ AG
နိုင်ငံကူးလက်မှတ်	n AG a AL ɪ AL ɴ AG ŋ AG a AL ɴ AG ɡ AC u AM l AE ɛ AL ʔ AC m̥ AF a AL ʔ AC
နိုင်ငံခြား	n AG a AL ɪ AL ɴ AG ŋ AG a AL ɴ AG d AC ʑ AJ a AL
နိုင်ငံခြားသား	n AG a AL ɪ AL ɴ AG ɡ AC a AL ɴ AG d AC ʑ AJ a AL ð AJ a AL
နိုင်ငံတော်	n AG a AL ɪ AL ɴ AG ŋ AG a AL ɴ AG d AC ɔ AM
နိုင်ငံတော်သီချင်း	n AG a AL ɪ AL ɴ AG ŋ AG a AL ɴ AG d AC ɔ AM θ AJ ə AL t AC ɕʰ BA ɪ AL ɴ AG
နိုင်ငံရေး	n AG a AL ɪ AL ɴ AG ŋ AG a AL ɴ AG j AB e AL
နိုင်ငံသား	n AG a AL ɪ AL ɴ AG ŋ AG a AL ɴ AG ð AJ a AL
နိုင်ငံသားအဖြစ်	n AG a AL ɪ AL ɴ AG ŋ AG a AL ɴ AG ð AJ a AL ʔ AC ə AL pʰ AI j AB ɪ AL ʔ AC
နိုင်နိုင်	n AG a AL ɪ AL ɴ AG n AG a AL ɪ AL ɴ AG
နိုဝင်ဘာ	n AG o AM w AK ɪ AL ɴ AG b AH a AL
နို့	n AG o̰ AM
နို့ဆီ	n AG o̰ AM z AJ i AL
နို့လိမ်	n AG o̰ AM l AE e AL ɪ AL ɴ AG
နို့သီး	n AG o̰ AM ð AJ i AL
နို့သီးခေါင်း	n AG o̰ AM ð AJ i AL ɡ AC a AL ʊ AM ɴ AG
နိုး	n AG o AM
နိဿယ	n AG e AL ɪ AL ʔ AC θ AJ ə AL j AB a̰ AL
နီ	n AG i AL
နီကာရာဂွါ	n AG i AL k AC a AL ɹ AB a AL ɡ AC w AK a AL
နီတိ	n AG i AL t AC ḭ
နီလာ	n AG i AL l AE a AL
နီး	n AG i AL
နုပ်	n AG o AM ʊ AM ʔ AC
နေ	n AG e AL
နေကောင်း	n AG e AL k AC a AL ʊ AM ɴ AG
နေကောင်းရဲ့လား	n AG e AL k AC a AL ʊ AM ɴ AG j AB ɛ̰ AL l AE a AL
နေစကြဝဠာ	n AG e AL s AJ ɛ AL ʔ AC t AC ɕ AJ a AL w AK ə AL l AE a AL
နေစာ	n AG e AL z AJ a AL
နေထွက်	n AG e AL tʰ AD w AK ɛ AL ʔ AC
နေပြည်တော်	n AG e AL p AH j AB i AL d AC ɔ AM
နေရာ	n AG e AL j AB a AL
နေရာငါးသွယ်	n AG e AL j AB a AL ŋ AG a AL θ AJ w AK ɛ AL
နေရာထိုင်ခင်း	n AG e AL j AB a AL tʰ AD a AL ɪ AL ɴ AG ɡ AC ɪ AL ɴ AG
နေဝင်	n AG e AL w AK ɪ AL ɴ AG
နေအိမ်	n AG e AL ʔ AC e AL ɪ AL ɴ AG
နောက်	n AG a AL ʊ AM ʔ AC
နောက်ကျ	n AG a AL ʊ AM ʔ AC t AC ɕ AJ a̰ AL
နောက်ဆက်	n AG a AL ʊ AM ʔ AC sʰ BA ɛ AL ʔ AC
နောက်ပြီး	n AG a AL ʊ AM ʔ AC p AH i AL
နောက်ရုံး	n AG a AL ʊ AM ʔ AC j AB o AM ʊ AM ɴ AG
နောင်	n AG a AL ʊ AM ɴ AG
နော်	n AG ɔ AM
နော်ရထာ	n AG ɔ AM j AB ə AL tʰ AD a AL
နော်ဝေ	n AG ɔ AM w AK e AL
နေ့	n AG ḛ
နေ့စဉ်	n AG ḛ z AJ ɪ AL ɴ AG
နေ့စွဲ	n AG ḛ z AJ w AK ɛ AL
နေ့လည်	n AG ḛ l AE ɛ AL
နေ့လယ်	n AG ḛ l AE ɛ AL
နေ့လယ်စာ	n AG ḛ l AE ɛ AL z AJ a AL
နဲ့	n AG ɛ̰ AL
နံကထိုင်	n AG a AL ɴ AG k AC ə AL tʰ AD a AL ɪ AL ɴ AG
နံနက်	n AG a AL ɴ AG n AG ɛ AL ʔ AC
နံနက်စာ	n AG a AL ɴ AG n AG ɛ AL ʔ AC s AJ a AL
နံနံ	n AG a AL ɴ AG n AG a AL ɴ AG
နံပါတ်	n AG a AL ɴ AG b AH a AL ʔ AC
နံပြား	n AG a AL ɴ AG b AH j AB a AL
နံရိုး	n AG a AL ɴ AG j AB o AM
နျူကလိယ	n AG j AB u AM k AC ə AL l AE ḭ j AB a̰ AL
နွယ်တာ	n AG w AK ɛ AL t AC a AL
နွား	n AG w AK a AL
နွားထီး	n AG ə AL tʰ AD i AL
နွားနို့	n AG w AK a AL n AG o̰ AM
နွားနို့ခေါက်ဆွဲ	n AG w AK a AL n AG o̰ AM kʰ AD a AL ʊ AM ʔ AC sʰ BA w AK ɛ AL
နွားမ	n AG ə AL m AF a̰ AL
နွေ	n AG w AK e AL
နွေရာသီ	n AG w AK e AL j AB a AL ð AJ i AL
နွေဦး	n AG w AK e AL ʔ AC u AM
နွေဦးပေါက်	n AG w AK e AL ʔ AC u AM b AH a AL ʊ AM ʔ AC
နွေဦးရာသီ	n AG w AK e AL ʔ AC u AM j AB a AL ð AJ i AL
နွေး	n AG w AK e AL
နှင့်	n̥ AG ɪ̰ AL ɴ AG
နှင့်တကွ	n̥ AG ɪ̰ AL ɴ AG d AC ə AL ɡ AC w AK a̰ AL
နှင်း	n̥ AG ɪ AL ɴ AG
နှင်းခဲ	n̥ AG ɪ AL ɴ AG ɡ AC ɛ AL
နှင်းပွင့်	n̥ AG ɪ AL ɴ AG b AH w AK ɪ̰ AL ɴ AG
နှင်းသီး	n̥ AG ɪ AL ɴ AG ð AJ i AL
နှစ်	n̥ AG ɪ AL ʔ AC
နှစ်ချုပ်	n̥ AG ɪ AL ʔ AC d AC ʑ AJ o AM ʊ AM ʔ AC
နှစ်ချောင်းပုဒ်	n̥ AG ə AL t AC ɕʰ BA a AL ʊ AM ɴ AG p AH o AM ʊ AM ʔ AC
နှစ်စဉ်	n̥ AG ɪ AL ʔ AC z AJ ɪ AL ɴ AG
နှစ်ဆန်းတစ်ရက်	n̥ AG ɪ AL ʔ AC sʰ BA a AL ɴ AG t AC ə AL j AB ɛ AL ʔ AC
နှစ်ဆန်းတစ်ရက်နေ့	n̥ AG ɪ AL ʔ AC sʰ BA a AL ɴ AG t AC ə AL j AB ɛ AL ʔ AC n AG ḛ
နှစ်ဆယ့်တစ်	n̥ AG ɪ AL ʔ AC sʰ BA ɛ̰ AL t AC ɪ AL ʔ AC
နှစ်ဆယ်	n̥ AG ɪ AL ʔ AC sʰ BA ɛ AL
နှစ်ရာ	n̥ AG ə AL j AB a AL
နှစ်လ	n̥ AG ə AL l AE a̰ AL
နှပ်	n̥ AG a AL ʔ AC
နှမ	n̥ AG ə AL m AF a̰ AL
နှမ်း	n̥ AG a AL ɴ AG
နှမ်းစေ့	n̥ AG a AL ɴ AG z AJ ḛ
နှမ်းဆီ	n̥ AG a AL ɴ AG z AJ i AL
နှလုံး	n̥ AG ə AL l AE o AM ʊ AM ɴ AG
နှလုံးရောဂါ	n̥ AG ə AL l AE o AM ʊ AM ɴ AG j AB ɔ AM ɡ AC a AL
နှာ	n̥ AG a AL
နှာခေါင်း	n̥ AG ə AL kʰ AD a AL ʊ AM ɴ AG
နှာခေါင်းပေါက်	n̥ AG ə AL kʰ AD a AL ʊ AM ɴ AG b AH a AL ʊ AM ʔ AC
နှာဘူး	n̥ AG a AL b AH u AM
နှာမောင်း	n̥ AG ə AL m AF a AL ʊ AM ɴ AG
နှိပ်ကြယ်သီး	n̥ AG e AL ɪ AL ʔ AC t AC ɕ AJ ɛ AL ð AJ i AL
နှုတ်	n̥ AG o AM ʊ AM ʔ AC
နှုတ်ခမ်း	n̥ AG o AM ʊ AM ʔ AC kʰ AD a AL ɴ AG
နှုတ်ဆက်	n̥ AG o AM ʊ AM ʔ AC sʰ BA ɛ AL ʔ AC
နှုတ်သီး	n̥ AG o AM ʊ AM ʔ AC θ AJ i AL
နှော	n̥ AG ɔ AM
နှောက်	n̥ AG a AL ʊ AM ʔ AC
နှောင်း	n̥ AG a AL ʊ AM ɴ AG
နှေး	n̥ AG e AL
နှံကောင်	n̥ AG a AL ɴ AG ɡ AC a AL ʊ AM ɴ AG
ပကတိ	b AH ə AL ɡ AC ə AL d AC ḭ
ပကောဋိ	p AH ə AL k AC ɔ AM d AC ḭ
ပက်ကျိ	p AH ɛ AL ʔ AC t AC ɕ AJ ḭ
ပခုက္ကူ	p AH ə AL kʰ AD u AM k AC k AC u AM
ပခုံး	p AH ə AL kʰ AD o AM ʊ AM ɴ AG
ပင့်	p AH ɪ̰ AL ɴ AG
ပင့်ကူ	p AH ɪ̰ AL ɴ AG ɡ AC u AM
ပင့်ကူအိမ်	p AH ɪ̰ AL ɴ AG ɡ AC u AM ʔ AC e AL ɪ AL ɴ AG
ပင်ဂွင်	p AH ɪ AL ɴ AG ɡ AC w AK ɪ AL ɴ AG
ပင်စင်	p AH ɪ AL ɴ AG s AJ ɪ AL ɴ AG
ပင်စင်စား	p AH ɪ AL ɴ AG s AJ ɪ AL ɴ AG s AJ a AL
ပင်စည်	p AH ɪ AL ɴ AG z AJ i AL
ပင်စိမ်း	p AH ɪ AL ɴ AG z AJ e AL ɪ AL ɴ AG
ပင်စိမ်းမွှေး	p AH ɪ AL ɴ AG z AJ e AL ɪ AL ɴ AG m̥ AF w AK e AL
ပင်ပေါင်	p AH ɪ AL ɴ AG p AH a AL ʊ AM ɴ AG
ပင်မှည့်	p AH ɪ AL ɴ AG m̥ AF ɛ̰ AL
ပင်လယ်	p AH ɪ AL ɴ AG l AE ɛ AL
ပင်လယ်ဆား	p AH ɪ AL ɴ AG l AE ɛ AL z AJ a AL
ပင်လယ်ဓားပြ	p AH ɪ AL ɴ AG l AE ɛ AL d AC ə AL m AF j AB a̰ AL
ပင်လယ်အော်	p AH ɪ AL ɴ AG l AE ɛ AL ʔ AC ɔ AM
ပစောက်	p AH a̰ AL z AJ a AL ʊ AM ʔ AC
ပစ္စက္ခ	p AH ɪ AL ʔ AC s AJ ɛ AL ʔ AC kʰ AD a̰ AL
ပစ္စည်း	p AH ɪ AL ʔ AC s AJ i AL
ပစ္စည်းလေးပါး	p AH j AB ɪ AL ʔ AC s AJ i AL l AE e AL b AH a AL
ပစ္စယာ	p AH j AB ɪ AL ʔ AC s AJ ə AL j AB a AL
ပစ္စုပ္ပန်	p AH j AB ɪ AL ʔ AC s AJ o AM ʊ AM ʔ AC p AH a AL ɴ AG
ပစ္ဆိမ	p AH j AB ɪ AL ʔ AC sʰ BA e AL ɪ AL ʔ AC m AF a̰ AL
ပစ်	p AH j AB ɪ AL ʔ AC
ပဇာ	b AH ə AL z AJ a AL
ပဉ္စကလျာဏီ	p AH j AB ɪ AL ɴ AG s AJ a̰ AL k AC ə AL l AE ə AL j AB a AL n AG i AL
ပဉ္စင်တူရိယာ	p AH j AB ɪ AL ʔ AC s AJ ɪ AL ɴ AG t AC u AM ɹ AB ḭ j AB a AL
ပဉ္စင်း	b AH ə AL z AJ ɪ AL ɴ AG
ပဉ္စမ	p AH j AB ɪ AL ɴ AG s AJ ə AL m AF a̰ AL
ပဉ္စရူပ	p AH j AB ɪ AL ɴ AG s AJ a̰ AL ɹ AB u AM p AH a̰ AL
ပဉ္စလက်	p AH ɪ AL ɴ AG s AJ ə AL l AE ɛ AL ʔ AC
ပညတ်	p AH j AB ɪ̰ AL ɴ AG n AG a AL ʔ AC
ပညတ်တော်	p AH j AB ɪ̰ AL ɴ AG n AG a AL ʔ AC t AC ɔ AM
ပညာ	p AH j AB ɪ AL ɴ AG ɲ AG a AL
ပညာကျော်	p AH j AB ɪ AL ɴ AG ɲ AG a AL d AC ʑ AJ ɔ AM
ပညာပေး	p AH j AB ɪ AL ɴ AG ɲ AG a AL p AH e AL
ပညာဗလ	p AH j AB ɪ AL ɴ AG ɲ AG a AL b AH ə AL l AE a̰ AL
ပညာရေး	p AH j AB ɪ AL ɴ AG ɲ AG a AL j AB e AL
ပညာရှင်	p AH j AB ɪ AL ɴ AG ɲ AG a AL ʃ AJ ɪ AL ɴ AG
ပဋိဇီဝဆေး	p AH a̰ AL d AC ḭ z AJ i AL w AK a̰ AL sʰ BA e AL
ပဋိပက္ခ	p AH ə AL t AC ḭ p AH ɛ AL ʔ AC kʰ AD a̰ AL
ပဋိပက္ခဒေသ	p AH ə AL d AC ḭ p AH ɛ AL ʔ AC kʰ AD a̰ AL d AC e AL θ AJ a̰ AL
ပဋိသန္ဓေ	p AH ə AL d AC ḭ θ AJ a AL ɴ AG d AC e AL
ပဌမ	p AH a̰ AL tʰ AD a̰ AL m AF a̰ AL
ပဏ္ဍိတ	p AH a AL n AG d AC ḭ t AC a̰ AL
ပဏ္ဏာ	p AH ə AL n AG a AL
ပတ္တမြား	b AH ə AL d AC ə AL m AF j AB a AL
ပတ္တလား	p AH a AL ʔ AC t AC a̰ AL l AE a AL
ပတ္ထနာ	p AH ə AL tʰ AD ə AL n AG a AL
ပတ်	p AH a AL ʔ AC
ပတ်စပို့	p AH a AL ʔ AC s AJ ə AL p AH o̰ AM
ပတ်တီး	p AH a AL ʔ AC t AC i AL
ပတ်ဝန်းကျင်	p AH a AL ʔ AC w AK ʊ AM ɴ AG t AC ɕ AJ ɪ AL ɴ AG
ပထမ	p AH a̰ AL tʰ AD a̰ AL m AF a̰ AL
ပထမဘွဲ့	p AH a̰ AL tʰ AD ə AL m AF a̰ AL b AH w AK ɛ̰ AL
ပထဝီဝင်	p AH ə AL tʰ AD ə AL w AK i AL w AK ɪ AL ɴ AG
ပထွေး	p AH ə AL tʰ AD w AK e AL
ပဒုမ	p AH ə AL d AC ṵ m AF a̰ AL
ပဒုမဘုရား	p AH ə AL d AC ṵ m AF a̰ AL pʰ AI ə AL j AB a AL
ပဒုမုတ္တရ	p AH ə AL d AC ṵ m AF o AM ʊ AM ʔ AC t AC ə AL ɹ AB a̰ AL
ပဒုမုတ္တရဘုရား	p AH ə AL d AC ṵ m AF o AM ʊ AM ʔ AC t AC ə AL ɹ AB a̰ AL pʰ AI ə AL j AB a AL
ပဒေသရာဇ်	b AH ə AL d AC e AL θ AJ ə AL ɹ AB ɪ AL ʔ AC
ပဒေသာ	b AH ə AL d AC e AL ð AJ a AL
ပဒေသာပင်	b AH ə AL d AC e AL ð AJ a AL b AH ɪ AL ɴ AG
ပနားမား	p AH a̰ AL n AG a AL m AF a AL
ပန်	p AH a AL ɴ AG
ပန်ကာ	p AH a AL ɴ AG k AC a AL
ပန်တျာ	p AH a AL ɴ AG t AC ə AL j AB a AL
ပန်း	p AH a AL ɴ AG
ပန်းကန်	b AH ə AL ɡ AC a AL ɴ AG
ပန်းခုနစ်မည်	p AH a AL ɴ AG kʰ AD ə AL n AG ə AL m AF j AB i AL
ပန်းချီ	b AH ə AL d AC ʑ AJ i AL
ပန်းချီဆရာ	b AH ə AL d AC ʑ AJ i AL sʰ BA ə AL j AB a AL
ပန်းခြံ	p AH a AL ɴ AG d AC ʑ AJ a AL ɴ AG
ပန်းဂေါ်ဖီ	p AH a AL ɴ AG ɡ AC ɔ AM b AH i AL
ပန်းစည်း	p AH a AL ɴ AG z AJ i AL
ပန်းဆယ်မျိုး	p AH a AL ɴ AG sʰ BA ɛ AL m AF j AB o AM
ပန်းတဉ်း	b AH ə AL d AC ɪ AL ɴ AG
ပန်းတမော့	p AH a AL ɴ AG d AC ə AL m AF ɔ̰ AM
ပန်းတော့	p AH a AL ɴ AG d AC ɔ̰ AM
ပန်းထိမ်	b AH ə AL d AC e AL ɪ AL ɴ AG
ပန်းနာ	p AH a AL ɴ AG n AG a AL
ပန်းနာရင်ကျပ်	p AH a AL ɴ AG n AG a AL j AB ɪ AL ɴ AG t AC ɕ AJ a AL ʔ AC
ပန်းပု	b AH ə AL b AH ṵ
ပန်းပဲ	b AH ə AL b AH ɛ AL
ပန်းပွတ်	b AH ə AL b AH ʊ AM ʔ AC
ပန်းမုန်လာ	p AH a AL ɴ AG m AF o AM ʊ AM ɴ AG l AE a AL
ပန်းမုန်လာစိမ်း	p AH a AL ɴ AG m AF o AM ʊ AM ɴ AG l AE a AL z AJ e AL ɪ AL ɴ AG
ပန်းမုန်လာဖြူ	p AH a AL ɴ AG m AF o AM ʊ AM ɴ AG l AE a AL b AH j AB u AM
ပန်းယွန်း	p AH a AL ɴ AG j AB ʊ AM ɴ AG
ပန်းရန်	b AH ə AL j AB a AL ɴ AG
ပန်းရွဲ	p AH a AL ɴ AG j AB w AK ɛ AL
ပန်းသီး	p AH a AL ɴ AG ð AJ i AL
ပန်းသေရောဂါ	p AH a AL ɴ AG θ AJ e AL j AB ɔ AM ɡ AC a AL
ပန်းသေး	p AH a AL ɴ AG ð AJ e AL
ပန်းသေးခေါက်ဆွဲ	p AH a AL ɴ AG θ AJ e AL kʰ AD a AL ʊ AM ʔ AC sʰ BA w AK ɛ AL
ပန်းအိ	p AH a AL ɴ AG ʔ AC ḭ
ပန်းအိုး	p AH a AL ɴ AG ʔ AC o AM
ပမာဏ	p AH ə AL m AF a AL n AG a̰ AL
ပယောဂ	p AH ə AL j AB ɔ AM ɡ AC a̰ AL
ပယ်ရှား	p AH ɛ AL ʃ AJ a AL
ပရဟိတ	p AH ə AL ɹ AB a̰ AL h AA ḭ t AC a̰ AL
ပရိက္ခရာ	p AH ə AL ɹ AB e AL ɪ AL ʔ AC kʰ AD ə AL j AB a AL
ပရိဒေဝ	p AH ə AL ɹ AB ḭ d AC e AL w AK a̰ AL
ပရိဘောဂ	p AH ə AL ɹ AB ḭ b AH ɔ AM ɡ AC a̰ AL
ပရိယာယ်	p AH ə AL ɹ AB ḭ j AB e AL
ပရိသတ်	p AH ə AL j AB e AL ɪ AL ʔ AC θ AJ a AL ʔ AC
ပရိုဂရမ်	p AH ə AL ɹ AB o AM ɡ AC ə AL ɹ AB a AL ɴ AG
ပရိုဂျက်	p AH ə AL ɹ AB o AM d AC ʑ AJ ɛ AL ʔ AC
ပရုတ်	p AH ə AL j AB o AM ʊ AM ʔ AC
ပလတ်	p AH ə AL l AE a AL ʔ AC
ပလတ်စတစ်	p AH ə AL l AE a AL ʔ AC s AJ ə AL t AC ɪ AL ʔ AC
ပလပ်ကြွတ်	p AH a̰ AL l AE a AL ʔ AC t AC ɕ AJ ʊ AM ʔ AC
ပလပ်စတစ်	p AH ə AL l AE a AL ʔ AC s AJ ə AL t AC ɪ AL ʔ AC
ပလာတာ	p AH ə AL l AE a AL t AC a AL
ပလိပ်	p AH ə AL l AE e AL ɪ AL ʔ AC
ပလူတိုနီယမ်	p AH ə AL l AE u AM t AC o AM n AG i AL j AB a AL ɴ AG
ပလောင်	p AH ə AL l AE a AL ʊ AM ɴ AG
ပလ္လင်	p AH ə AL l AE ɪ AL ɴ AG
ပလွေ	p AH a̰ AL l AE w AK e AL
ပဝရ	p AH ə AL w AK ə AL ɹ AB a̰ AL
ပဝါ	p AH a̰ AL w AK a AL
ပဝေဏီ	p AH ə AL w AK e AL n AG i AL
ပသီ	p AH ə AL θ AJ i AL
ပသျှူး	p AH ə AL ʃ AJ u AM
ပသျှူးရာမ	p AH ə AL ʃ AJ u AM j AB a AL m AF a̰ AL
ပအို့ဝ်	p AH ə AL ʔ AC o̰ AM
ပါ	p AH a AL
ပါကစ္စတန်	p AH a AL k AC ɪ AL ʔ AC s AJ ə AL t AC a AL ɴ AG
ပါဆယ်	p AH a AL sʰ BA ɛ AL
ပါတာနီ	p AH a AL t AC a AL n AG i AL
ပါတိတ်	p AH a AL t AC e AL ɪ AL ʔ AC
ပါတီ	p AH a AL t AC i AL
ပါပူအာနယူးဂီနီ	p AH a AL p AH u AM ʔ AC a AL n AG ə AL j AB u AM ɡ AC i AL n AG i AL
ပါမောက္ခ	p AH a AL m AF a AL ʊ AM ʔ AC kʰ AD a̰ AL
ပါရဂူဘွဲ့	p AH a AL j AB ə AL ɡ AC u AM b AH w AK ɛ̰ AL
ပါရမီ	p AH a AL ɹ AB ə AL m AF i AL
ပါရရာ	p AH a AL ɹ AB ə AL j AB a AL
ပါရာဂွေး	p AH a AL ɹ AB a AL ɡ AC w AK e AL
ပါရီ	p AH a AL ɹ AB i AL
ပါရှား	p AH a AL ʃ AJ a AL
ပါလက်စတိုင်း	p AH a AL l AE ɛ AL ʔ AC s AJ ə AL t AC a AL ɪ AL ɴ AG
ပါလီမန်	p AH a AL l AE i AL m AF a AL ɴ AG
ပါဝါ	p AH a AL w AK a AL
ပါဠိ	p AH a AL l AE ḭ
ပါး	p AH a AL
ပါးစပ်	p AH ə AL z AJ a AL ʔ AC
ပါးဟက်	p AH ə AL h AA ɛ AL ʔ AC
ပိ	p AH ḭ
ပိဋကတ်	b AH ḭ t AC ə AL ɡ AC a AL ʔ AC
ပိဋကတ်တိုက်	b AH ḭ d AC ə AL ɡ AC a AL ʔ AC d AC a AL ɪ AL ʔ AC
ပိတ်	p AH e AL ɪ AL ʔ AC
ပိန္နဲ	p AH e AL ɪ AL ɴ AG n AG ɛ AL
ပိန်းဥ	p AH e AL ɪ AL ɴ AG ʔ AC ṵ
ပိရမစ်	p AH ḭ ɹ AB ə AL m AF ɪ AL ʔ AC
ပို	p AH o AM
ပိုက်	p AH a AL ɪ AL ʔ AC
ပိုက်ဆံ	p AH a AL ɪ AL ʔ AC sʰ BA a AL ɴ AG
ပိုက်ဆံအိတ်	p AH a AL ɪ AL ʔ AC sʰ BA a AL ɴ AG ʔ AC e AL ɪ AL ʔ AC
ပိုက်သမား	p AH a AL ɪ AL ʔ AC θ AJ ə AL m AF a AL
ပိုင်ရှင်	p AH a AL ɪ AL ɴ AG ʃ AJ ɪ AL ɴ AG
ပိုင်း	p AH a AL ɪ AL ɴ AG
ပိုစတာ	p AH o AM s AJ ə AL t AC a AL
ပိုတက်ဆီယမ်	p AH o AM t AC ɛ AL ʔ AC sʰ BA i AL j AB a AL ɴ AG
ပိုဒ်	p AH a AL ɪ AL ʔ AC
ပိုလန်	p AH o AM l AE a AL ɴ AG
ပို့	p AH o̰ AM
ပို့စကတ်	p AH o̰ AM s AJ ə AL k AC a AL ʔ AC
ပိုး	p AH o AM
ပိုးကြာချည်	p AH o AM t AC ɕ AJ a AL t AC ɕʰ BA i AL
ပိုးတောင်မာ	p AH o AM d AC a AL ʊ AM ɴ AG m AF a AL
ပိုးလောင်း	p AH o AM l AE a AL ʊ AM ɴ AG
ပိုးဟပ်	p AH o AM h AA a AL ʔ AC
ပိုးဟပ်ဖြူ	p AH o AM h AA a AL ʔ AC pʰ AI j AB u AM
ပိဿာ	p AH e AL ɪ AL ʔ AC θ AJ a AL
ပီကင်း	p AH i AL k AC ɪ AL ɴ AG
ပီကေ	p AH i AL k AC e AL
ပီစီ	p AH i AL s AJ i AL
ပီဇာ	p AH i AL z AJ a AL
ပီတိ	p AH i AL t AC ḭ
ပီပီ	p AH i AL b AH i AL
ပီယဒဿီ	p AH i AL j AB a̰ AL d AC a AL ʔ AC θ AJ i AL
ပီယဒဿီဘုရား	p AH i AL j AB a̰ AL d AC a AL ʔ AC θ AJ i AL pʰ AI ə AL j AB a AL
ပီရူး	p AH i AL ɹ AB u AM
ပီလောပီနံ	p AH i AL l AE ɔ AM p AH i AL n AG a AL ɴ AG
ပု	p AH ṵ
ပုခက်	p AH ə AL kʰ AD ɛ AL ʔ AC
ပုဂံ	b AH ə AL ɡ AC a AL ɴ AG
ပုဂ္ဂလိက	p AH o AM ʊ AM ʔ AC ɡ AC ə AL l AE ḭ ɡ AC a̰ AL
ပုဂ္ဂိုလ်	p AH o AM ʊ AM ʔ AC ɡ AC o AM
ပုစဉ်း	b AH ə AL z AJ ɪ AL ɴ AG
ပုစ္ဆာ	p AH o AM ʊ AM ʔ AC sʰ BA a AL
ပုစွန်	b AH ə AL z AJ ʊ AM ɴ AG
ပုဆိန်	p AH ə AL sʰ BA e AL ɪ AL ɴ AG
ပုဆိုး	p AH ə AL sʰ BA o AM
ပုဏ္ဏမာ	p AH o AM ʊ AM ɴ AG n AG ə AL m AF a AL
ပုဏ္ဏား	p AH o AM ʊ AM ɴ AG n AG a AL
ပုဏ္ဏားကျွန်း	p AH o AM ʊ AM ɴ AG n AG a AL d AC ʑ AJ ʊ AM ɴ AG
ပုတ်သင်ညို	p AH o AM ʊ AM ʔ AC θ AJ ɪ AL ɴ AG ɲ AG o AM
ပုထိုး	p AH ə AL tʰ AD o AM
ပုဒ်	p AH o AM ʊ AM ʔ AC
ပုဒ်ကလေး	p AH o AM ʊ AM ʔ AC k AC ə AL l AE e AL
ပုဒ်ကြီး	p AH o AM ʊ AM ʔ AC d AC ʑ AJ i AL
ပုဒ်ထီး	p AH o AM ʊ AM ʔ AC k AC ə AL l AE e AL
ပုဒ်ဖြတ်	p AH o AM ʊ AM ʔ AC pʰ AI j AB a AL ʔ AC
ပုဒ်မ	p AH o AM ʊ AM ʔ AC m AF a̰ AL
ပုန်ကန်	p AH o AM ʊ AM ɴ AG k AC a AL ɴ AG
ပုန်းရည်ကြီး	p AH o AM ʊ AM ɴ AG j AB e AL d AC ʑ AJ i AL
ပုပ်	p AH o AM ʊ AM ʔ AC
ပုဗ္ဗ	p AH o AM ʊ AM ʔ AC b AH a̰ AL
ပုရစ်	p AH ə AL j AB ɪ AL ʔ AC
ပုရပိုက်	p AH ə AL ɹ AB ə AL b AH a AL ɪ AL ʔ AC
ပုရွက်	p AH ə AL j AB w AK ɛ AL ʔ AC
ပုရွက်ဆိတ်	p AH ə AL j AB w AK ɛ AL ʔ AC sʰ BA e AL ɪ AL ʔ AC
ပုလင်း	p AH ə AL l AE ɪ AL ɴ AG
ပုလိပ်	p AH ə AL l AE e AL ɪ AL ʔ AC
ပုလဲ	p AH ə AL l AE ɛ AL
ပုသိမ်	p AH ə AL θ AJ e AL ɪ AL ɴ AG
ပုံ	p AH o AM ʊ AM ɴ AG
ပုံဆွဲ	p AH o AM ʊ AM ɴ AG sʰ BA w AK ɛ AL
ပုံတူ	p AH o AM ʊ AM ɴ AG d AC u AM
ပုံတူကား	p AH o AM ʊ AM ɴ AG d AC u AM k AC a AL
ပုံနှိပ်စက်	p AH o AM ʊ AM ɴ AG n̥ AG e AL ɪ AL ʔ AC s AJ ɛ AL ʔ AC
ပုံသေနည်း	p AH o AM ʊ AM ɴ AG ð AJ e AL n AG i AL
ပုံး	p AH o AM ʊ AM ɴ AG
ပူ	p AH u AM
ပူဇော်	p AH u AM z AJ ɔ AM
ပူတင်း	p AH u AM t AC ɪ AL ɴ AG
ပူဒီနာ	p AH u AM s AJ i AL n AG a AL
ပူရ	p AH u AM ɹ AB a̰ AL
ပူရီ	p AH u AM j AB i AL
ပေကျင်း	p AH e AL t AC ɕ AJ ɪ AL ɴ AG
ပေါက်စီ	p AH a AL ʊ AM ʔ AC s AJ i AL
ပေါက်တူး	p AH a AL ʊ AM ʔ AC t AC u AM
ပေါက်ဖော်	p AH a AL ʊ AM ʔ AC pʰ AI ɔ AM
ပေါင်	p AH a AL ʊ AM ɴ AG
ပေါင်မုန့်	p AH a AL ʊ AM ɴ AG m AF o̰ AM ʊ AM ɴ AG
ပေါင်းတင်း	p AH a AL ʊ AM ɴ AG d AC ɪ AL ɴ AG
ပေါင်းဖို	p AH a AL ʊ AM ɴ AG b AH o AM
ပေါ့	p AH ɔ̰ AM
ပေါ်	p AH ɔ AM
ပေါ်ဆန်းမွှေး	p AH ɔ AM sʰ BA a AL ɴ AG m̥ AF w AK e AL
ပေါ်တူဂီ	p AH ɔ AM t AC u AM ɡ AC i AL
ပေါ်လစီ	p AH ɔ AM l AE ə AL s AJ i AL
ပေး	p AH e AL
ပဲ	p AH ɛ AL
ပဲကြီး	p AH ɛ AL d AC ʑ AJ i AL
ပဲခူး	b AH ə AL ɡ AC o AM
ပဲငံပြာရည်	p AH ɛ AL ŋ AG a AL ɴ AG b AH j AB a AL j AB e AL
ပဲဆီ	p AH ɛ AL z AJ i AL
ပဲနံ့သာ	p AH ɛ AL n AG a̰ AL ɴ AG θ AJ a AL
ပဲပင်ပေါက်	p AH ɛ AL b AH ɪ AL ɴ AG b AH a AL ʊ AM ʔ AC
ပဲပိုးတီ	p AH ɛ AL p AH o AM d AC i AL
ပဲမှုန့်	p AH ɛ AL m̥ AF o̰ AM ʊ AM ɴ AG
ပဲ့တင်သံ	p AH ɛ̰ AL t AC ɪ AL ɴ AG ð AJ a AL ɴ AG
ပျစ်	p AH j AB ɪ AL ʔ AC
ပျဉ်	p AH j AB ɪ AL ɴ AG
ပျဉ်းကတိုး	p AH j AB ɪ AL ɴ AG ɡ AC ə AL d AC o AM
ပျဉ်းတော်သိမ်	p AH j AB ɪ AL ɴ AG d AC ɔ AM θ AJ e AL ɪ AL ɴ AG
ပျဉ်းမ	p AH j AB ɪ AL ɴ AG m AF a̰ AL
ပျပျ	p AH j AB a̰ AL b AH j AB a̰ AL
ပျား	p AH j AB a AL
ပျားတူ	b AH a̰ AL d AC u AM
ပျားထီး	p AH j AB a AL d AC i AL
ပျားရည်	p AH j AB a AL j AB e AL
ပျိုး	p AH j AB o AM
ပျူ	p AH j AB u AM
ပျော့	p AH j AB ɔ̰ AM
ပျော်	p AH j AB ɔ AM
ပျော်ပျော်	p AH j AB ɔ AM b AH j AB ɔ AM
ပျံ	p AH j AB a AL ɴ AG
ပျံတော်မူ	p AH j AB a AL ɴ AG t AC ɔ AM m AF u AM
ပြ	p AH j AB a̰ AL
ပြက္ခဒိန်	p AH j AB ɛ AL ʔ AC ɡ AC ə AL d AC e AL ɪ AL ɴ AG
ပြင်	p AH j AB ɪ AL ɴ AG
ပြင်ပြင်	p AH j AB ɪ AL ɴ AG b AH j AB ɪ AL ɴ AG
ပြင်သစ်	p AH j AB ɪ AL ɴ AG θ AJ ɪ AL ʔ AC
ပြင်သည်	p AH j AB ɪ AL ɴ AG θ AJ i AL
ပြင်း	p AH j AB ɪ AL ɴ AG
ပြင်းဟုပ်	p AH j AB ɪ AL ɴ AG h AA o AM ʊ AM ʔ AC
ပြစ်မှု	p AH j AB ɪ AL ʔ AC m̥ AF ṵ
ပြည့်	p AH j AB ḛ
ပြည့်တန်ဆာ	p AH j AB ḭ d AC ə AL z AJ a AL
ပြည်	p AH j AB i AL
ပြည်ကြီးငါး	p AH j AB i AL d AC ʑ AJ i AL ŋ AG a AL
ပြည်ကြီးမွန်	p AH j AB i AL d AC ʑ AJ i AL m AF ʊ AM ɴ AG
ပြည်တွင်း	p AH j AB i AL d AC w AK ɪ AL ɴ AG
ပြည်ထောင်စု	p AH j AB i AL d AC a AL ʊ AM ɴ AG z AJ ṵ
ပြည်ထောင်စုတော်လှန်ရေးကောင်စီအဖွဲ့	p AH j AB i AL d AC a AL ʊ AM ɴ AG z AJ ṵ t AC ɔ AM l̥ AE a AL ɴ AG j AB e AL k AC a AL ʊ AM ɴ AG s AJ i AL ʔ AC ə AL pʰ AI w AK ɛ̰ AL
ပြည်ထောင်စုနေ့	p AH j AB i AL d AC a AL ʊ AM ɴ AG z AJ ṵ n AG ḛ
ပြည်ထောင်စုလွှတ်တော်	p AH j AB i AL d AC a AL ʊ AM ɴ AG z AJ ṵ l̥ AE ʊ AM ʔ AC t AC ɔ AM
ပြည်နယ်	p AH j AB i AL n AG ɛ AL
ပြည်သူ	p AH j AB i AL ð AJ u AM
ပြည်သူပိုင်	p AH j AB i AL ð AJ u AM b AH a AL ɪ AL ɴ AG
ပြည်သူပိုင်သိမ်း	p AH j AB i AL ð AJ u AM b AH a AL ɪ AL ɴ AG ð AJ e AL ɪ AL ɴ AG
ပြည်သူပြည်သား	p AH j AB i AL ð AJ u AM p AH j AB i AL ð AJ a AL
ပြည်သူ့ဆိုင်	p AH j AB i AL ð AJ ṵ sʰ BA a AL ɪ AL ɴ AG
ပြည်သူ့လွှတ်တော်	p AH j AB i AL ð AJ ṵ l̥ AE ʊ AM ʔ AC t AC ɔ AM
ပြဌာန်း	p AH j AB a̰ AL tʰ AD a AL ɴ AG
ပြတင်းပေါက်	b AH ə AL d AC ɪ AL ɴ AG b AH a AL ʊ AM ʔ AC
ပြတိုက်	p AH j AB a̰ AL d AC a AL ɪ AL ʔ AC
ပြဒါး	b AH ə AL d AC a AL
ပြဒါးချိန်	b AH ə AL d AC a AL d AC ʑ AJ e AL ɪ AL ɴ AG
ပြန်	p AH j AB a AL ɴ AG
ပြန်ကြား	p AH j AB a AL ɴ AG t AC ɕ AJ a AL
ပြန်ကြားရေး	p AH j AB a AL ɴ AG t AC ɕ AJ a AL j AB e AL
ပြန်လှန်	p AH j AB a AL ɴ AG l̥ AE a AL ɴ AG
ပြပွဲ	p AH j AB a̰ AL b AH w AK ɛ AL
ပြယုဂ်	p AH j AB a̰ AL j AB o AM ʊ AM ʔ AC
ပြသ	p AH j AB a̰ AL θ AJ a̰ AL
ပြာ	p AH j AB a AL
ပြာခွက်	p AH j AB a AL ɡ AC w AK ɛ AL ʔ AC
ပြာဋိဟာ	p AH j AB a AL d AC ḭ h AA a AL
ပြာတာ	p AH j AB a AL t AC a AL
ပြာသာဒ်	p AH j AB a AL ʔ AC θ AJ a AL ʔ AC
ပြာသို	p AH j AB a AL ð AJ o AM
ပြား	p AH j AB a AL
ပြိတ္တာ	p AH j AB e AL ɪ AL ʔ AC t AC a AL
ပြိုင်ပွဲ	p AH j AB a AL ɪ AL ɴ AG b AH w AK e AL
ပြီ	p AH j AB i AL
ပြီး	p AH i AL
ပြီးတော့	p AH i AL d AC ɔ̰ AM
ပြီးပြီ	p AH i AL b AH i AL
ပြု	p AH j AB ṵ
ပြုတ်	p AH j AB o AM ʊ AM ʔ AC
ပြုပြင်	p AH j AB ṵ b AH j AB ɪ AL ɴ AG
ပြုံယမ်း	p AH j AB o AM ʊ AM ɴ AG j AB a AL ɴ AG
ပြုံး	p AH j AB o AM ʊ AM ɴ AG
ပြော	p AH j AB ɔ AM
ပြောင်း	p AH j AB a AL ʊ AM ɴ AG
ပြောင်းဖူး	p AH j AB a AL ʊ AM ɴ AG b AH u AM
ပြောင်းလဲ	p AH j AB a AL ʊ AM ɴ AG l AE ɛ AL
ပြေး	p AH j AB e AL
ပြွတ်	p AH j AB ʊ AM ʔ AC
ပြွန်	p AH j AB ʊ AM ɴ AG
ပြွမ်း	p AH j AB ʊ AM ɴ AG
ပြဿဒါး	p AH j AB a AL ʔ AC ð AJ ə AL d AC a AL
ပြဿနာ	p AH j AB a AL ʔ AC θ AJ ə AL n AG a AL
ပွတ်	p AH ʊ AM ʔ AC
ပွား	p AH w AK a AL
ပွိုင့်	p AH w AK a̰ AL ɪ AL ɴ AG
ပွေး	p AH w AK e AL
ပွဲ	p AH w AK ɛ AL
ပွဲတော်	p AH w AK ɛ AL d AC ɔ AM
ဖက်	pʰ AI ɛ AL ʔ AC
ဖက်ဆစ်ဝါဒ	pʰ AI ɛ AL ʔ AC sʰ BA ɪ AL ʔ AC w AK a AL d AC a̰ AL
ဖက်ရှင်	pʰ AI ɛ AL ʔ AC ʃ AJ ɪ AL ɴ AG
ဖက်ဝန်း	pʰ AI ɛ AL ʔ AC w AK ʊ AM ɴ AG
ဖခင်	pʰ AI a̰ AL ɡ AC ɪ AL ɴ AG
ဖငယ်	pʰ AI a̰ AL ŋ AG ɛ AL
ဖင်	pʰ AI ɪ AL ɴ AG
ဖင်လန်	pʰ AI ɪ AL ɴ AG l AE a AL ɴ AG
ဖင်လျက်	pʰ AI ɪ AL ɴ AG j AB ɛ AL ʔ AC
ဖတ်	pʰ AI a AL ʔ AC
ဖတ်တီး	pʰ AI a AL ʔ AC t AC i AL
ဖန်ခါး	pʰ AI a AL ɴ AG ɡ AC a AL
ဖန်ခါးသီး	pʰ AI a AL ɴ AG ɡ AC a AL ð AJ i AL
ဖန်တီး	pʰ AI a AL ɴ AG d AC i AL
ဖမ်း	pʰ AI a AL ɴ AG
ဖယောင်း	pʰ AI ə AL j AB a AL ʊ AM ɴ AG
ဖယောင်းတိုင်	pʰ AI ə AL j AB a AL ʊ AM ɴ AG d AC a AL ɪ AL ɴ AG
ဖယ်ဒရေးရှင်း	pʰ AI ɛ AL d AC ə AL ɹ AB e AL ʃ AJ ɪ AL ɴ AG
ဖရန့်	pʰ AI ə AL ɹ AB a̰ AL ɴ AG
ဖရုံ	pʰ AI ə AL j AB o AM ʊ AM ɴ AG
ဖရုံဆွဲ	pʰ AI ə AL j AB o AM ʊ AM ɴ AG z AJ w AK ɛ AL
ဖရဲ	pʰ AI ə AL j AB ɛ AL
ဖလား	pʰ AI ə AL l AE a AL
ဖဝါး	pʰ AI ə AL w AK a AL
ဖဦးထုပ်	pʰ AI a̰ AL ʔ AC u AM tʰ AD o AM ʊ AM ʔ AC
ဖာခေါင်း	pʰ AI a AL ɡ AC a AL ʊ AM ɴ AG
ဖာမ	pʰ AI a AL m AF a̰ AL
ဖာလာ	pʰ AI a AL l AE a AL
ဖာလာစေ့	pʰ AI a AL l AE a AL s AJ ḛ
ဖာလူဒါ	pʰ AI a AL l AE u AM d AC a AL
ဖာသည်မ	pʰ AI a AL θ AJ ɛ AL m AF a̰ AL
ဖား	pʰ AI a AL
ဖားပြုပ်	pʰ AI ə AL b AH j AB o AM ʊ AM ʔ AC
ဖားလောင်း	pʰ AI ə AL l AE a AL ʊ AM ɴ AG
ဖိတ်	pʰ AI e AL ɪ AL ʔ AC
ဖိနပ်	pʰ AI ə AL n AG a AL ʔ AC
ဖိလစ်ပိုင်	pʰ AI ḭ l AE ɪ AL ʔ AC p AH a AL ɪ AL ɴ AG
ဖိအား	pʰ AI ḭ ʔ AC a AL
ဖိုင်	pʰ AI a AL ɪ AL ɴ AG
ဖို့	pʰ AI o̰ AM
ဖိုးသူတော်	pʰ AI o AM θ AJ u AM d AC ɔ AM
ဖီဂျီ	pʰ AI i AL d AC ʑ AJ i AL
ဖုတ်	pʰ AI o AM ʊ AM ʔ AC
ဖုန်	pʰ AI o AM ʊ AM ɴ AG
ဖုန်စုပ်စက်	pʰ AI o AM ʊ AM ɴ AG s AJ o AM ʊ AM ʔ AC s AJ ɛ AL ʔ AC
ဖုန်းနံပါတ်	pʰ AI o AM ʊ AM ɴ AG n AG a AL ɴ AG b AH a AL ʔ AC
ဖုံး	pʰ AI o AM ʊ AM ɴ AG
ဖုဿ	pʰ AI o AM ʊ AM ʔ AC θ AJ a̰ AL
ဖုဿဘုရား	pʰ AI o AM ʊ AM ʔ AC θ AJ a̰ AL pʰ AI ə AL j AB a AL
ဖူး	b AH u AM
ဖေဖော်ဝါရီ	pʰ AI e AL pʰ AI ɔ AM w AK a AL ɹ AB i AL
ဖေါ်ပြချက်	pʰ AI ɔ AM p AH j AB a̰ AL t AC ɕʰ BA ɛ AL ʔ AC
ဖောက်	pʰ AI a AL ʊ AM ʔ AC
ဖောက်သည်	pʰ AI a AL ʊ AM ʔ AC θ AJ e AL
ဖောင်	pʰ AI a AL ʊ AM ɴ AG
ဖော့ဖျက်	pʰ AI ɔ̰ AM b AH j AB ɛ AL ʔ AC
ဖော့လုံး	pʰ AI ɔ̰ AM l AE o AM ʊ AM ɴ AG
ဖော်	pʰ AI ɔ AM
ဖော်ပြ	pʰ AI ɔ AM p AH j AB a̰ AL
ဖဲ	pʰ AI ɛ AL
ဖဲကြိုး	pʰ AI ɛ AL d AC ʑ AJ o AM
ဖျင်ဖျင်	pʰ AI j AB ɪ AL ɴ AG b AH j AB ɪ AL ɴ AG
ဖျာ	pʰ AI j AB a AL
ဖျား	pʰ AI j AB a AL
ဖျောက်ဆိပ်	pʰ AI j AB a AL ʊ AM ʔ AC sʰ BA e AL ɪ AL ʔ AC
ဖျံ	pʰ AI j AB a AL ɴ AG
ဖြစ်	pʰ AI j AB ɪ AL ʔ AC
ဖြည့်	pʰ AI j AB ḛ
ဖြည်းဖြည်း	pʰ AI j AB e AL b AH j AB e AL
ဖြည်းဖြည်းချင်း	pʰ AI j AB i AL pʰ AI j AB i AL t AC ɕʰ BA ɪ AL ɴ AG
ဖြားယောင်း	pʰ AI j AB a AL j AB a AL ʊ AM ɴ AG
ဖြီး	pʰ AI i AL
ဖြူ	pʰ AI j AB u AM
ဖြူး	pʰ AI j AB u AM
ဖြေ	pʰ AI j AB e AL
ဖြေဖျောက်	pʰ AI j AB e AL b AH j AB a AL ʊ AM ʔ AC
ဖြေရှင်း	pʰ AI j AB e AL ʃ AJ ɪ AL ɴ AG
ဖြောင့်	pʰ AI j AB a̰ AL ʊ AM ɴ AG
ဖြောဖြော	pʰ AI j AB ɔ AM b AH j AB ɔ AM
ဖြော်ဖြော်	pʰ AI j AB ɔ AM b AH j AB ɔ AM
ဖွင့်	pʰ AI w AK ɪ̰ AL ɴ AG
ဖွား	pʰ AI w AK a AL
ဖွဲ့စည်းပုံ	pʰ AI w AK ɛ̰ AL z AJ i AL b AH o AM ʊ AM ɴ AG
ဖွဲ့စည်းပုံအခြေခံဥပဒေ	pʰ AI w AK ɛ̰ AL z AJ i AL b AH o AM ʊ AM ɴ AG ʔ AC ə AL t AC ɕʰ BA e AL ɡ AC a AL ɴ AG ʔ AC ṵ b AH ə AL d AC e AL
ဗက်တီးရီးယား	b AH ɛ AL ʔ AC t AC i AL ɹ AB i AL j AB a AL
ဗင်နီဇွဲလား	b AH ɪ AL ɴ AG n AG i AL z AJ w AK ɛ AL l AE a AL
ဗညား	b AH ə AL ɲ AG a AL
ဗထက်ခြိုက်	b AH a̰ AL tʰ AD ɛ AL ʔ AC t AC ɕʰ BA a AL ɪ AL ʔ AC
ဗန်တို	b AH a AL ɴ AG d AC o AM
ဗန်ရှည်	b AH a AL ɴ AG ʃ AJ e AL
ဗန်းမော်	b AH a AL ɴ AG m AF ɔ AM
ဗမာ	b AH ə AL m AF a AL
ဗမာ့	b AH ə AL m AF a̰ AL
ဗလ	b AH ə AL l AE a̰ AL
ဗလဝ	b AH ə AL l AE ə AL w AK a̰ AL
ဗလာစာအုပ်	b AH ə AL l AE a AL s AJ a AL ʔ AC o AM ʊ AM ʔ AC
ဗလီ	b AH ə AL l AE i AL
ဗဟို	b AH ə AL h AA o AM
ဗဟုသုတ	b AH ə AL h AA ṵ θ AJ ṵ t AC a̰ AL
ဗာတီကန်	b AH a AL t AC i AL k AC a AL ɴ AG
ဗာတီကန်မြို့ပြနိုင်ငံ	b AH a AL t AC i AL k AC a AL ɴ AG m AF j AB o̰ AM p AH j AB a̰ AL n AG a AL ɪ AL ɴ AG ŋ AG a AL ɴ AG
ဗာဒံ	b AH a AL d AC a AL ɴ AG
ဗာလ	b AH a AL l AE a̰ AL
ဗာလချောင်	b AH a AL l AE a̰ AL t AC ɕʰ BA a AL ʊ AM ɴ AG
ဗားနစ်	b AH a AL n AG ɪ AL ʔ AC
ဗိန္ဒု	b AH e AL ɪ AL ɴ AG d AC ṵ
ဗိမာန်	b AH e AL ɪ AL ʔ AC m AF a AL ɴ AG
ဗိသုကာ	b AH ḭ ð AJ ə AL ɡ AC a AL
ဗိုက်	b AH a AL ɪ AL ʔ AC
ဗိုက်ကြီး	b AH a AL ɪ AL ʔ AC t AC ɕ AJ i AL
ဗိုက်ဆာတယ်	b AH a AL ɪ AL ʔ AC sʰ BA a AL t AC ɛ AL
ဗိုင်း	b AH a AL ɪ AL ɴ AG
ဗိုင်းရပ်စ်	b AH a AL ɪ AL ɴ AG ɹ AB a AL ʔ AC s AJ
ဗိုလ်	b AH o AM
ဗိုလ်ကျ	b AH o AM t AC ɕ AJ a̰ AL
ဗိုလ်ကြီး	b AH o AM d AC ʑ AJ i AL
ဗိုလ်ချုပ်	b AH o AM d AC ʑ AJ o AM ʊ AM ʔ AC
ဗိုလ်ချုပ်ကြီး	b AH o AM d AC ʑ AJ o AM ʊ AM ʔ AC d AC ʑ AJ i AL
ဗိုလ်ချုပ်မှူးကြီး	b AH o AM d AC ʑ AJ o AM ʊ AM ʔ AC m̥ AF u AM d AC ʑ AJ i AL
ဗိုလ်မှူး	b AH o AM m̥ AF u AM
ဗိုလ်မှူးကြီး	b AH o AM m̥ AF u AM d AC ʑ AJ i AL
ဗိုလ်မှူးချုပ်	b AH o AM m̥ AF u AM d AC ʑ AJ o AM ʊ AM ʔ AC
ဗိုလ်လောင်း	b AH o AM l AE a AL ʊ AM ɴ AG
ဗို့	b AH o̰ AM
ဗို့အား	b AH o̰ AM ʔ AC a AL
ဗိဿနိုး	b AH e AL ɪ AL ʔ AC θ AJ ə AL n AG o AM
ဗီဇ	b AH i AL z AJ a̰ AL
ဗီဇာ	b AH i AL z AJ a AL
ဗီတာမင်	b AH i AL t AC a AL m AF ɪ AL ɴ AG
ဗီဒီယို	b AH i AL d AC i AL j AB o AM
ဗီယက်နမ်	b AH i AL j AB ɛ AL ʔ AC n AG a AL ɴ AG
ဗီယင်ကျန်း	b AH i AL j AB ɪ AL ɴ AG t AC ɕ AJ a AL ɴ AG
ဗီရို	b AH i AL j AB o AM
ဗုဒ္ဓ	b AH o AM ʊ AM ʔ AC d AC a̰ AL
ဗုဒ္ဓဘာသာ	b AH o AM ʊ AM ʔ AC d AC a̰ AL b AH a AL θ AJ a AL
ဗုဒ္ဓသာသနာ	θ AJ a AL ð AJ ə AL n AG a AL
ဗုဒ္ဓဟူး	b AH o AM ʊ AM ʔ AC d AC a̰ AL h AA u AM
ဗုန်း	b AH o AM ʊ AM ɴ AG
ဗုံး	b AH o AM ʊ AM ɴ AG
ဗေဒ	b AH e AL d AC a̰ AL
ဗောဓိညောင်	b AH ɔ AM d AC ḭ ɲ AG a AL ʊ AM ɴ AG
ဗောဓိသတ်	b AH ɔ AM d AC ḭ θ AJ a AL ʔ AC
ဗော့ဒ်ကာ	b AH ɔ̰ AM d AC k AC a AL
ဗေ့စဘော	b AH ḛ s AJ ə AL b AH ɔ AM
ဗျစ်	b AH j AB ɪ AL ʔ AC
ဗျည်း	b AH j AB i AL
ဗျာဓိ	b AH j AB a AL d AC ḭ
ဗျိုင်း	b AH j AB a AL ɪ AL ɴ AG
ဗျုပ္ပတ်	b AH j AB o AM ʊ AM ʔ AC p AH a AL ʔ AC
ဗျူရို	b AH j AB u AM ɹ AB o AM
ဗြဟ္မစိုရ်တရား	b AH j AB ə AL m AF ə AL z AJ o AM j AB t AC ə AL j AB a AL
ဗြဟ္မာ	b AH j AB ə AL m AF a AL
ဗြာဟ္မဏ	b AH j AB a AL h AA m AF a̰ AL n AG a̰ AL
ဗြိစ္ဆာ	b AH j AB e AL ɪ AL ʔ AC sʰ BA a AL
ဗြိတိန်	b AH j AB ḭ t AC e AL ɪ AL ɴ AG
ဗြိတိသျှ	b AH ə AL ɹ AB ḭ t AC ḭ ʃ AJ a̰ AL
ဗြဲတိုက်	b AH j AB ɛ AL d AC a AL ɪ AL ʔ AC
ဗွေ	b AH w AK e AL
ဘ	b AH a̰ AL
ဘကကျောင်း	b AH a̰ AL k AC a̰ AL t AC ɕ AJ a AL ʊ AM ɴ AG
ဘကုန်း	b AH a̰ AL k AC o AM ʊ AM ɴ AG
ဘက္ကဒီးအစ်	b AH ɛ AL ʔ AC k AC ə AL d AC i AL ʔ AC ɪ AL ʔ AC
ဘက်	b AH ɛ AL ʔ AC
ဘက်ထရီ	b AH ɛ AL ʔ AC tʰ AD a̰ AL ɹ AB i AL
ဘကြီး	b AH a̰ AL d AC ʑ AJ i AL
ဘင်	b AH ɪ AL ɴ AG
ဘင်နာ	b AH ɪ AL ɴ AG n AG a AL
ဘင်း	b AH ɪ AL ɴ AG
ဘင်္ဂလားဒေ့ရှ်	b AH ɪ AL ɴ AG l AE a AL d AC ḛ ʃ AJ
ဘင်္ဂါလီ	b AH ɪ AL ɴ AG ɡ AC a AL l AE i AL
ဘဏ္ဍာ	b AH a AL n AG d AC a AL
ဘဏ္ဍာရေး	b AH a AL n AG d AC a AL j AB e AL
ဘဏ်	b AH a AL ɴ AG
ဘဏ်တိုက်	b AH a AL ɴ AG d AC a AL ɪ AL ʔ AC
ဘတ်	pʰ AI a AL ʔ AC
ဘတ်ဂျက်	b AH a AL ʔ AC d AC ʑ AJ ɛ AL ʔ AC
ဘတ်စ်ကား	b AH a AL ʔ AC s AJ ə AL k AC a AL
ဘထွေး	b AH a̰ AL tʰ AD w AK e AL
ဘဒ္ဒန္တ	b AH a AL ʔ AC d AC a AL ɴ AG t AC a̰ AL
ဘန်ကောက်	b AH a AL ɴ AG k AC a AL ʊ AM ʔ AC
ဘယာ	b AH ə AL j AB a AL
ဘယ်	b AH ɛ AL
ဘယ်တုန်းက	b AH ɛ AL d AC o AM ʊ AM ɴ AG ɡ AC a̰ AL
ဘယ်တော့	b AH ɛ AL d AC ɔ̰ AM
ဘယ်နှ	b AH ɛ AL n̥ AG a̰ AL
ဘယ်နှစ်	b AH ɛ AL n̥ AG ə AL
ဘယ်မှ	b AH ɛ AL m̥ AF a̰ AL
ဘယ်ရီလီယမ်	b AH ɛ AL ɹ AB i AL l AE i AL j AB a AL ɴ AG
ဘယ်လို	b AH ɛ AL l AE o AM
ဘယ်လောက်	b AH ɛ AL l AE a AL ʊ AM ʔ AC
ဘယ်လ်ဂျီယမ်	b AH ɛ AL l AE d AC ʑ AJ i AL j AB a AL ɴ AG
ဘယ်သူ	b AH ə AL θ AJ u AM
ဘယ်သူ့	b AH ə AL θ AJ ṵ
ဘရင်ဂျီ	b AH ə AL j AB ɪ AL ɴ AG d AC ʑ AJ i AL
ဘရဏီ	b AH a̰ AL j AB ə AL n AG i AL
ဘရာစီယာ	b AH ə AL ɹ AB a AL s AJ i AL j AB a AL
ဘရာဇီး	b AH ə AL ɹ AB a AL z AJ i AL
ဘရိတ်	b AH ə AL ɹ AB e AL ɪ AL ʔ AC
ဘရူနိုင်း	b AH ə AL ɹ AB u AM n AG a AL ɪ AL ɴ AG
ဘလိဇ်	b AH ə AL l AE i AL z AJ
ဘလောက်	b AH a̰ AL l AE a AL ʊ AM ʔ AC
ဘလော့ဂ်	b AH ə AL l AE o AM ʊ AM ʔ AC
ဘလေး	b AH a̰ AL l AE e AL
ဘဝ	b AH a̰ AL w AK a̰ AL
ဘဝဲ	b AH ə AL w AK ɛ AL
ဘဟားမား	b AH a̰ AL h AA a AL m AF a AL
ဘာ	b AH a AL
ဘာကီးနားဖားဆို	b AH a AL k AC i AL n AG a AL pʰ AI a AL sʰ BA o AM
ဘာရိန်း	b AH a AL ɹ AB e AL ɪ AL ɴ AG
ဘာလင်	b AH a AL l AE ɪ AL ɴ AG
ဘာလိ	b AH a AL l AE ḭ
ဘာသာ	b AH a AL ð AJ a AL
ဘာသာစကား	b AH a AL θ AJ a AL z AJ ə AL ɡ AC a AL
ဘာသာပြန်	b AH a AL ð AJ a AL p AH j AB a AL ɴ AG
ဘာသာဗေဒ	b AH a AL θ AJ a AL b AH e AL d AC a̰ AL
ဘား	pʰ AI a AL
ဘိက္ခု	b AH e AL ɪ AL ʔ AC kʰ AD ṵ
ဘိက္ခုနီ	b AH i AL k AC kʰ AD ṵ n AG i AL
ဘိန်း	b AH e AL ɪ AL ɴ AG
ဘိန်းမုန့်	b AH e AL ɪ AL ɴ AG m AF o̰ AM ʊ AM ɴ AG
ဘိဘိသန	b AH ḭ b AH ḭ θ AJ ə AL n AG a̰ AL
ဘိလပ်	b AH ḭ l AE a AL ʔ AC
ဘိသိက်	b AH e AL ɪ AL ʔ AC θ AJ e AL ɪ AL ʔ AC
ဘိုကလေး	b AH o AM ɡ AC ə AL l AE e AL
ဘိုက်	b AH a AL ɪ AL ʔ AC
ဘိုင်	b AH a AL ɪ AL ɴ AG
ဘိုင်စကယ်	b AH a AL ɪ AL ɴ AG s AJ ə AL k AC ɛ AL
ဘိုင်စကုတ်	b AH a AL ɪ AL ɴ AG s AJ ə AL k AC o AM ʊ AM ʔ AC
ဘိုရွန်	b AH o AM ɹ AB ʊ AM ɴ AG
ဘိုလီးဗီးယား	b AH o AM l AE i AL b AH i AL j AB a AL
ဘိုးဘိုး	pʰ AI o AM pʰ AI o AM
ဘီ	b AH i AL
ဘီစကွတ်	b AH i AL s AJ ə AL k AC ʊ AM ʔ AC
ဘီနင်	b AH i AL n AG ɪ AL ɴ AG
ဘီယာ	b AH i AL j AB a AL
ဘီလာရုဇ်	b AH i AL l AE a AL ɹ AB u AM z AJ
ဘီလူး	b AH ə AL l AE u AM
ဘီး	b AH i AL
ဘီးကြယ်	b AH i AL t AC ɕ AJ ɛ AL
ဘု	b AH ṵ
ဘုဉ်းပေး	b AH o AM ʊ AM ɴ AG p AH e AL
ဘုတ်	b AH o AM ʊ AM ʔ AC
ဘုန်း	pʰ AI o AM ʊ AM ɴ AG
ဘုန်းကြီး	pʰ AI o AM ʊ AM ɴ AG d AC ʑ AJ i AL
ဘုန်းကြီးကျောင်း	pʰ AI o AM ʊ AM ɴ AG d AC ʑ AJ i AL t AC ɕ AJ a AL ʊ AM ɴ AG
ဘုန်းကြီးပျံ	pʰ AI o AM ʊ AM ɴ AG d AC ʑ AJ i AL b AH j AB a AL ɴ AG
ဘုန်းတော်ကြီးဘုရား	pʰ AI o AM ʊ AM ɴ AG d AC ɔ AM d AC ʑ AJ i AL pʰ AI ə AL j AB a AL
ဘုန်းဘုန်း	pʰ AI o AM ʊ AM ɴ AG pʰ AI o AM ʊ AM ɴ AG
ဘုမ္မစိုး	b AH o AM ʊ AM ɴ AG m AF ə AL z AJ o AM
ဘုရင်	b AH ə AL j AB ɪ AL ɴ AG
ဘုရင်ခံ	b AH ə AL j AB ɪ AL ɴ AG ɡ AC a AL ɴ AG
ဘုရင်မ	b AH a̰ AL j AB ɪ AL ɴ AG m AF a̰ AL
ဘုရား	pʰ AI ə AL j AB a AL
ဘုရားကိုးဆူ	pʰ AI ə AL j AB a AL k AC o AM sʰ BA u AM
ဘုရားကျောင်း	pʰ AI ə AL j AB a AL d AC ʑ AJ a AL ʊ AM ɴ AG
ဘုရားရှိခိုးကျောင်း	pʰ AI ə AL j AB a AL ʃ AJ ḭ kʰ AD o AM d AC ʑ AJ a AL ʊ AM ɴ AG
ဘုရားလောင်း	pʰ AI ə AL j AB a AL l AE a AL ʊ AM ɴ AG
ဘုရားအလောင်း	pʰ AI ə AL j AB a AL ʔ AC ə AL l AE a AL ʊ AM ɴ AG
ဘုံကျောင်း	b AH o AM ʊ AM ɴ AG d AC ʑ AJ a AL ʊ AM ɴ AG
ဘုံပိုင်	b AH o AM ʊ AM ɴ AG b AH a AL ɪ AL ɴ AG
ဘူ	b AH u AM
ဘူဂေးရီးယား	b AH u AM ɡ AC e AL ɹ AB i AL j AB a AL
ဘူတန်	b AH u AM t AC a AL ɴ AG
ဘူတာရုံ	b AH u AM d AC a AL j AB o AM ʊ AM ɴ AG
ဘူမိဗေဒ	b AH u AM m AF ḭ b AH e AL d AC a̰ AL
ဘူမိရူပဗေဒ	b AH u AM m AF ḭ j AB u AM p AH a̰ AL b AH e AL d AC a̰ AL
ဘူရွန်ဒီ	b AH u AM ɹ AB ʊ AM ɴ AG d AC i AL
ဘူး	b AH u AM
ဘူးသီး	b AH u AM θ AJ i AL
ဘူးသီးတောင်	b AH u AM ð AJ i AL d AC a AL ʊ AM ɴ AG
ဘော	b AH ɔ AM
ဘောက်ဆူး	b AH a AL ʊ AM ʔ AC sʰ BA u AM
ဘောဂဗေဒ	b AH ɔ AM ɡ AC a̰ AL t AC a̰ AL b AH e AL d AC a̰ AL
ဘောင်းဘီ	b AH a AL ʊ AM ɴ AG b AH i AL
ဘောပင်	b AH ɔ AM p AH ɪ AL ɴ AG
ဘောပွဲ	b AH ɔ AM p AH w AK ɛ AL
ဘောလုံး	b AH ɔ AM l AE o AM ʊ AM ɴ AG
ဘော့ဆွာနာ	b AH ɔ̰ AM sʰ BA w AK a AL n AG a AL
ဘော်ဒါ	b AH ɔ AM d AC a AL
ဘော်ဒါကြေး	b AH ɔ AM d AC a AL t AC ɕ AJ e AL
ဘော်လီဘော	b AH ɔ AM l AE i AL b AH ɔ AM
ဘေ့စ်ဘော	b AH ḛ s AJ b AH ɔ AM
ဘေး	b AH e AL
ဘေးဆိုး	b AH e AL z AJ o AM
ဘေးဆီးရန်ကာ	b AH e AL z AJ i AL j AB a AL ɴ AG ɡ AC a AL
ဘဲ	b AH ɛ AL
ဘဲလေး	b AH ɛ AL l AE e AL
ဘွား	b AH w AK a AL
ဘွားဘွား	pʰ AI w AK a AL pʰ AI w AK a AL
ဘွဲ့	b AH w AK ɛ̰ AL
ဘွဲ့ချဉ်	b AH w AK ɛ̰ AL d AC ʑ AJ ɪ AL ɴ AG
မ	m AF ə AL
မကန်း	m AF ə AL ɡ AC a AL ɴ AG
မကိုဋ်	m AF ə AL ɡ AC a AL ɪ AL ʔ AC
မကုဋ	m AF ə AL k AC ṵ t AC a̰ AL
မက္ကဆီကို	m AF ɛ AL ʔ AC k AC ə AL sʰ BA i AL k AC o AM
မက်	m AF ɛ AL ʔ AC
မက်စီဒိုးနီးယား	m AF ɛ AL ʔ AC s AJ i AL d AC o AM n AG i AL j AB a AL
မက်မွန်	m AF ɛ AL ʔ AC m AF ʊ AM ɴ AG
မကြာမတင်	m AF ə AL t AC ɕ AJ a AL m AF ə AL t AC ɪ AL ɴ AG
မကွေး	m AF ə AL ɡ AC w AK e AL
မဂ္ဂင်ရှစ်ပါး	m AF ɛ AL ʔ AC ɡ AC ɪ AL ɴ AG ʃ AJ ɪ AL ʔ AC b AH a AL
မဂ္ဂဇင်း	m AF ɛ AL ʔ AC ɡ AC a̰ AL z AJ ɪ AL ɴ AG
မင့်စ်	m AF ɪ̰ AL ɴ AG s AJ
မင်	m̥ AF ɪ AL ɴ AG
မင်း	m AF ɪ AL ɴ AG
မင်းကြီး	m AF ɪ AL ɴ AG d AC ʑ AJ i AL
မင်းကွတ်	m AF ɪ AL ɴ AG ɡ AC ʊ AM ʔ AC
မင်းတရား	m AF ɪ AL ɴ AG t AC ə AL j AB a AL
မင်းဘူး	m AF ɪ AL ɴ AG b AH u AM
မင်းမြောက်တန်ဆာ	m AF ɪ AL ɴ AG m AF j AB a AL ʊ AM ʔ AC d AC ə AL z AJ a AL
မင်းသမီး	m AF ɪ AL ɴ AG ð AJ ə AL m AF i AL
မင်းသား	m AF ɪ AL ɴ AG ð AJ a AL
မင်္ဂလ	m AF ɪ AL ɴ AG ɡ AC ə AL l AE a̰ AL
မင်္ဂလဘုရား	m AF ɪ AL ɴ AG ɡ AC ə AL l AE a̰ AL pʰ AI ə AL j AB a AL
မင်္ဂလသုတ်	m AF ɪ AL ɴ AG ɡ AC ə AL l AE a̰ AL θ AJ o AM ʊ AM ʔ AC
မင်္ဂလာ	m AF ɪ AL ɴ AG ɡ AC ə AL l AE a AL
မင်္ဂလာဆောင်	m AF ɪ AL ɴ AG ɡ AC ə AL l AE a AL sʰ BA a AL ʊ AM ɴ AG
မင်္ဂလာပါ	m AF ɪ AL ɴ AG ɡ AC ə AL l AE a AL b AH a AL
မစင်	m AF a̰ AL s AJ ɪ AL ɴ AG
မဆလာ	m AF a̰ AL sʰ BA ə AL l AE a AL
မဇ္ဈဒေသ	m AF ɪ AL ʔ AC z AJ a̰ AL d AC e AL θ AJ a̰ AL
မဉ္ဇူ	m AF j AB ɪ AL ɴ AG z AJ u AM
မည်	m AF j AB i AL
မည်စည်	m AF ɛ AL z AJ ɛ AL
မည်သည်	m AF i AL ð AJ i AL
မည်သူ	m AF i AL ð AJ u AM
မည်း	m AF ɛ AL
မဏိ	m AF ə AL n AG ḭ
မဏိတော်	m AF ə AL n AG ḭ d AC ɔ AM
မဏိပူရ	m AF ə AL n AG ḭ p AH u AM j AB a̰ AL
မဏိမေခလာ	m AF ə AL n AG ḭ m AF e AL kʰ AD ə AL l AE a AL
မဏိဩဂ	m AF ə AL n AG ḭ ʔ AC ɔ AM ɡ AC a̰ AL
မဏ္ဍပ်	m AF a AL ɴ AG d AC a AL ʔ AC
မဏ္ဍိုင်	m AF a AL ɴ AG d AC a AL ɪ AL ɴ AG
မတော်တဆ	m AF ə AL t AC ɔ AM t AC ə AL sʰ BA a̰ AL
မတော်တဆမှု	m AF ə AL t AC ɔ AM t AC ə AL sʰ BA a̰ AL m̥ AF ṵ
မတ်	m AF a AL ʔ AC
မတ်ခွက်	m AF a AL ʔ AC kʰ AD w AK ɛ AL ʔ AC
မတ်စေ့	m AF a AL ʔ AC s AJ ḭ
မတ်ပဲ	m AF a AL ʔ AC p AH ɛ AL
မတ်မတ်	m AF a AL ʔ AC m AF a AL ʔ AC
မဒါဂတ်စကား	m AF a̰ AL d AC a AL ɡ AC a AL ʔ AC s AJ ə AL k AC a AL
မနက်	m AF ə AL n AG ɛ AL ʔ AC
မနက်ဖြန်	m AF ə AL n AG ɛ AL ʔ AC pʰ AI j AB a AL ɴ AG
မနုပ်တာနီ	m AF ə AL n AG o AM ʊ AM ʔ AC t AC a AL n AG i AL
မနုဿ	m AF a̰ AL n AG o AM ʊ AM ʔ AC θ AJ a AL
မနုဿဗေဒ	m AF ə AL n AG o AM ʊ AM ʔ AC θ AJ a̰ AL b AH e AL d AC a̰ AL
မနုဿီဟ	m AF ə AL n AG o AM ʊ AM ʔ AC θ AJ i AL h AA a̰ AL
မနော	m AF ə AL n AG ɔ AM
မနောကံ	m AF ə AL n AG ɔ AM ɡ AC a AL ɴ AG
မနေ့က	m AF ə AL n AG ḛ ɡ AC a̰ AL
မန္တန်	m AF a AL ɴ AG d AC a AL ɴ AG
မန္တလေး	m AF a AL ɴ AG d AC ə AL l AE e AL
မန်ကျည်း	m AF ə AL d AC ʑ AJ i AL
မန်နေဂျာ	m AF a AL ɴ AG n AG e AL d AC ʑ AJ a AL
မန်း	m AF a AL ɴ AG
မနှစ်	m AF ə AL n̥ AG ɪ AL ʔ AC
မယား	m AF ə AL j AB a AL
မယ်	m AF ɛ AL
မယ်ဇယ်	m AF ɛ AL z AJ ɛ AL
မယ်ဇလီ	m AF ɛ AL z AJ ə AL l AE i AL
မယ်တော်	m AF ɛ AL d AC ɔ AM
မယ်သီတာ	m AF ɛ AL θ AJ i AL d AC a AL
မယ်သီလ	m AF ɛ AL ð AJ i AL l AE a̰ AL
မရဏ	m AF ə AL ɹ AB ə AL n AG a̰ AL
မရန်း	m AF ə AL j AB a AL ɴ AG
မရမာ	m AF ə AL ɹ AB ə AL m AF a AL
မရမာကြီး	m AF ə AL ɹ AB ə AL m AF a AL d AC ʑ AJ i AL
မရီး	m AF ə AL j AB i AL
မလိုင်	m AF a̰ AL l AE a AL ɪ AL ɴ AG
မလုပ်တာနီ	m AF ə AL l AE o AM ʊ AM ʔ AC t AC a AL n AG i AL
မလေး	m AF ə AL l AE e AL
မလေးရှား	m AF ə AL l AE e AL ʃ AJ a AL
မလ္လိကာ	m AF a AL ɴ AG l AE ḭ k AC a AL
မသာ	m AF ə AL θ AJ a AL
မသိပါဘူး	m AF a̰ AL θ AJ ḭ b AH a AL b AH u AM
မသိဘူး	m AF a̰ AL θ AJ ḭ b AH u AM
မဟာ	m AF a̰ AL h AA a AL
မဟာကဿပ	m AF ə AL h AA a AL k AC a AL ʔ AC θ AJ ə AL p AH a̰ AL
မဟာဂီတ	m AF ə AL h AA a AL ɡ AC i AL t AC a̰ AL
မဟာပညာဗလ	m AF ə AL h AA a AL p AH j AB ɪ AL ɴ AG ɲ AG a AL b AH ə AL l AE a̰ AL
မဟာပိန္နဲ	m AF ə AL h AA a AL p AH e AL ɪ AL ɴ AG n AG ɛ AL
မဟာဘာရတ	m AF ə AL h AA a AL b AH a AL ɹ AB ə AL t AC a̰ AL
မဟာဘွဲ့	m AF ə AL h AA a AL b AH w AK ɛ̰ AL
မဟာမိတ်	m AF ə AL h AA a AL m AF e AL ɪ AL ʔ AC
မဟာမောဂ္ဂလာန်	m AF ə AL h AA a AL m AF a AL ʊ AM ʔ AC ɡ AC ə AL l AE a AL ɴ AG
မဟာယာန	m AF ə AL h AA a AL j AB a AL n AG a̰ AL
မဟာရဋ္ဌ	m AF ə AL h AA a AL j AB ə AL tʰ AD a̰ AL
မဟာလတာ	m AF ə AL h AA a AL l AE ə AL t AC a AL
မဟာဝင်	m AF ə AL h AA a AL w AK ɪ AL ɴ AG
မဟာဝိဇ္ဇာဘွဲ့	m AF ə AL h AA a AL w AK e AL ɪ AL ʔ AC z AJ a AL b AH w AK ɛ̰ AL
မဟာသာဝက	m AF ə AL h AA a AL θ AJ a AL w AK ə AL k AC a̰ AL
မဟာသိပ္ပံဘွဲ့	m AF ə AL h AA a AL θ AJ e AL ɪ AL ʔ AC p AH a AL ɴ AG b AH w AK ɛ̰ AL
မဟေ	m AF ə AL h AA e AL
မဟေသီ	m AF ə AL h AA e AL θ AJ i AL
မအေလိုး	m AF ə AL ʔ AC e AL l AE o AM
မာ	m AF a AL
မာကျောက်	m AF a AL t AC ɕ AJ a AL ʊ AM ʔ AC
မာစကတ်	m AF a AL s AJ ə AL k AC a AL ʔ AC
မာတိကာ	m AF a AL t AC ḭ k AC a AL
မာန်	m AF a AL ɴ AG
မာန်အောင်	m AF a AL n AG ʔ AC a AL ʊ AM ɴ AG
မာရ်	m AF a AL
မာရ်နတ်	m AF a AL n AG a AL ʔ AC
မာလကာ	m AF a AL l AE ə AL k AC a AL
မာလကာသီး	m AF a AL l AE ə AL k AC a AL θ AJ i AL
မာလဝီ	m AF a AL l AE a̰ AL w AK i AL
မာလာ	m AF a AL l AE a AL
မာလာရှမ်းကော	m AF a AL l AE a AL ʃ AJ a AL ɴ AG k AC ɔ AM
မာလာဟင်း	m AF a AL l AE a AL h AA ɪ AL ɴ AG
မာလီ	m AF a AL l AE i AL
မိ	m AF ḭ
မိကျောင်း	m AF ḭ d AC ʑ AJ a AL ʊ AM ɴ AG
မိခင်	m AF ḭ ɡ AC ɪ AL ɴ AG
မိငယ်	m AF ḭ ŋ AG ɛ AL
မိတ္တူ	m AF e AL ɪ AL ʔ AC t AC u AM
မိတ္ထီလာ	m AF e AL ɪ AL ʔ AC tʰ AD i AL l AE a AL
မိတ်	m AF e AL ɪ AL ʔ AC
မိတ်ကပ်	m AF e AL ɪ AL ʔ AC k AC a AL ʔ AC
မိတ်ဆွေ	m AF e AL ɪ AL ʔ AC sʰ BA w AK e AL
မိထွေး	m AF ḭ d AC w AK e AL
မိနစ်	m AF ḭ n AG ɪ AL ʔ AC
မိန်းကလေး	m AF e AL ɪ AL ɴ AG ɡ AC ə AL l AE e AL
မိန်းမ	m AF e AL ɪ AL ɴ AG m AF a̰ AL
မိန်းမလျာ	m AF e AL ɪ AL ɴ AG m AF ə AL ʃ AJ a AL
မိဖုရား	m AF ḭ b AH ə AL j AB a AL
မိဘ	m AF ḭ b AH a̰ AL
မိဘမဲ့	m AF ḭ b AH a̰ AL m AF ɛ̰ AL
မိသားစု	m AF ḭ ð AJ a AL z AJ ṵ
မိုက်	m AF a AL ɪ AL ʔ AC
မိုက်ကယ်	m AF a AL ɪ AL ʔ AC k AC ɛ AL
မိုင်	m AF a AL ɪ AL ɴ AG
မိုင်လို	m AF a AL ɪ AL ɴ AG l AE o AM
မိုင်း	m AF a AL ɪ AL ɴ AG
မိုဇမ်ဘစ်	m AF o AM z AJ a AL ɴ AG b AH ɪ AL ʔ AC
မိုတယ်	m AF o AM t AC ɛ AL
မိုနာကို	m AF o AM n AG a AL k AC o AM
မိုဘိုင်းလ်ဖုန်း	m AF o AM b AH a AL ɪ AL ɴ AG pʰ AI o AM ʊ AM ɴ AG
မိုး	m AF o AM
မိုးကာအင်္ကျီ	m AF o AM ɡ AC a AL ʔ AC ɪ AL ɴ AG d AC ʑ AJ i AL
မိုးကုတ်	m AF o AM ɡ AC o AM ʊ AM ʔ AC
မိုးကုပ်စက်ဝိုင်း	m AF o AM ɡ AC o AM ʊ AM ʔ AC s AJ ɛ AL ʔ AC w AK a AL ɪ AL ɴ AG
မိုးကြိုး	m AF o AM d AC ʑ AJ o AM
မိုးခေါ်	m AF o AM kʰ AD ɔ AM
မိုးရာသီ	m AF o AM j AB a AL ð AJ i AL
မိုးလေဝသ	m AF o AM l AE e AL w AK ə AL θ AJ a̰ AL
မီတာ	m AF i AL t AC a AL
မီနူး	m AF i AL n AG u AM
မီး	m AF i AL
မီးခတ်	m AF i AL ɡ AC a AL ʔ AC
မီးခိုး	m AF i AL ɡ AC o AM
မီးခိုးရောင်	m AF i AL ɡ AC o AM j AB a AL ʊ AM ɴ AG
မီးခေါင်း	m AF i AL ɡ AC a AL ʊ AM ɴ AG
မီးခံသေတ္တာ	m AF i AL ɡ AC a AL ɴ AG θ AJ ɪ AL ʔ AC t AC a AL
မီးခြစ်	m AF i AL d AC ʑ AJ ɪ AL ʔ AC
မီးခွက်	m AF i AL ɡ AC w AK ɛ AL ʔ AC
မီးတောင်	m AF i AL d AC a AL ʊ AM ɴ AG
မီးပန်း	m AF i AL b AH a AL ɴ AG
မီးပူ	m AF i AL b AH u AM
မီးပြတိုက်	m AF i AL b AH j AB a̰ AL d AC a AL ɪ AL ʔ AC
မီးပွား	m AF i AL b AH w AK a AL
မီးပွိုင့်	m AF i AL p AH w AK a̰ AL ɪ AL ɴ AG
မီးဖို	m AF i AL pʰ AI o AM
မီးဖိုချောင်	m AF i AL b AH o AM d AC ʑ AJ a AL ʊ AM ɴ AG
မီးယပ်	m AF i AL j AB a AL ʔ AC
မီးယပ်ပညာ	m AF i AL j AB a AL ʔ AC p AH j AB ɪ AL ɴ AG ɲ AG a AL
မီးယပ်ရောဂါ	m AF i AL j AB a AL ʔ AC j AB ɔ AM ɡ AC a AL
မီးရထား	m AF i AL j AB ə AL tʰ AD a AL
မီးရထားတွဲ	m AF i AL j AB ə AL tʰ AD a AL d AC w AK ɛ AL
မီးရှူးမီးပန်း	m AF i AL ʃ AJ u AM m AF i AL b AH a AL ɴ AG
မီးလင်းဖို	m AF i AL l AE ɪ AL ɴ AG b AH o AM
မီးသင်္ဘော	m AF i AL θ AJ ɪ AL ɴ AG b AH ɔ AM
မီးသီး	m AF i AL θ AJ i AL
မီးသုံးပါး	m AF i AL θ AJ o AM ʊ AM ɴ AG b AH a AL
မီးသွေး	m AF i AL ð AJ w AK e AL
မီးအိမ်	m AF i AL ʔ AC e AL ɪ AL ɴ AG
မုခ်	m AF o AM ʊ AM ʔ AC
မုစလိန္ဒ	m AF ṵ s AJ ə AL l AE e AL ɪ AL ɴ AG d AC a̰ AL
မုဆိုး	m AF o AM ʊ AM ʔ AC sʰ BA o AM
မုဆိုးဖို	m AF ṵ sʰ BA o AM b AH o AM
မုဆိုးမ	m AF ṵ sʰ BA o AM m AF a̰ AL
မုတ္ထမ	m AF o AM ʊ AM ʔ AC t AC ə AL m AF a̰ AL
မုတ်ခွံ	m AF o AM ʊ AM ʔ AC kʰ AD ʊ AM ɴ AG
မုတ်ဆိတ်	m AF o AM ʊ AM ʔ AC sʰ BA e AL ɪ AL ʔ AC
မုဒိမ်း	m AF ṵ d AC e AL ɪ AL ɴ AG
မုဒ္ဓဇ	m AF u AM d AC d AC ə AL z AJ a̰ AL
မုဒြာ	m AF ṵ d AC ɹ AB a AL
မုနိ	m AF ṵ n AG ḭ
မုန့်	m AF o̰ AM ʊ AM ɴ AG
မုန့်ကျွဲသည်း	m AF o̰ AM ʊ AM ɴ AG t AC ɕ AJ w AK ɛ AL ð AJ ɛ AL
မုန့်ကွမ်းယာ	m AF o̰ AM ʊ AM ɴ AG k AC ʊ AM ɴ AG j AB a AL
မုန့်ညက်	m AF o̰ AM ʊ AM ɴ AG ɲ AG ɛ AL ʔ AC
မုန့်တီ	m AF o̰ AM ʊ AM ɴ AG t AC i AL
မုန့်လက်ကောက်	m AF o̰ AM ʊ AM ɴ AG l AE ɛ AL ʔ AC k AC a AL ʊ AM ʔ AC
မုန့်လက်ဆောင်း	m AF o̰ AM ʊ AM ɴ AG l AE ɛ AL ʔ AC sʰ BA a AL ʊ AM ɴ AG
မုန့်လင်မယား	m AF o̰ AM ʊ AM ɴ AG l AE ɪ AL ɴ AG m AF ə AL j AB a AL
မုန့်လုံးရေပေါ်	m AF o̰ AM ʊ AM ɴ AG l AE o AM ʊ AM ɴ AG j AB e AL b AH ɔ AM
မုန့်ဟင်းခါး	m AF o̰ AM ʊ AM ɴ AG h AA ɪ AL ɴ AG ɡ AC a AL
မုန့်အုပ်ကလေး	m AF o̰ AM ʊ AM ɴ AG ʔ AC o AM ʊ AM ʔ AC ɡ AC ə AL l AE e AL
မုန့်ဦးနှောက်	m AF o̰ AM ʊ AM ɴ AG ʔ AC o AM ʊ AM ɴ AG ð AJ i AL
မုန်ညင်း	m AF o AM ʊ AM ɴ AG ɲ AG ɪ AL ɴ AG
မုန်ညင်းဆီ	m AF o AM ʊ AM ɴ AG ɲ AG ɪ AL ɴ AG sʰ BA i AL
မုန်ညင်းဖြူ	m AF o AM ʊ AM ɴ AG ɲ AG ɪ AL ɴ AG pʰ AI j AB u AM
မုန်ညှင်းဖြူ	m AF o AM ʊ AM ɴ AG ɲ̊ AG ɪ AL ɴ AG b AH j AB u AM
မုန်တိုင်း	m AF o AM ʊ AM ɴ AG d AC a AL ɪ AL ɴ AG
မုန်လာ	m AF o AM ʊ AM ɴ AG l AE a AL
မုန်လာထုပ်	m AF o AM ʊ AM ɴ AG l AE a AL d AC o AM ʊ AM ʔ AC
မုန်လာဥ	m AF o AM ʊ AM ɴ AG l AE a AL ʔ AC ṵ
မုန်လာဥနီ	m AF o AM ʊ AM ɴ AG l AE a AL ʔ AC ṵ n AG i AL
မုန်လာဥဝါ	m AF o AM ʊ AM ɴ AG l AE a AL ʔ AC ṵ w AK a AL
မုန်း	m AF o AM ʊ AM ɴ AG
မုရား	m AF ə AL j AB a AL
မုသား	m AF ṵ ð AJ a AL
မုံ	m AF o AM ʊ AM ɴ AG
မုံရွာ	m AF o AM ʊ AM ɴ AG j AB w AK a AL
မူကြို	m AF u AM d AC ʑ AJ o AM
မူကြိုကျောင်း	m AF u AM d AC ʑ AJ o AM d AC ʑ AJ a AL ʊ AM ɴ AG
မူလ	m AF u AM l AE a̰ AL
မူလတန်း	m AF u AM l AE a̰ AL t AC a AL ɴ AG
မူလတန်းကြိုကျောင်း	m AF u AM l AE a̰ AL d AC a AL ɴ AG d AC ʑ AJ o AM d AC ʑ AJ a AL ʊ AM ɴ AG
မူလီ	m AF u AM l AE i AL
မူး	m AF u AM
မေ	m AF e AL
မေဃာလယ	m AF e AL ɡ AC a AL l AE ə AL j AB a̰ AL
မေတ္တာ	m AF j AB ɪ AL ʔ AC t AC a AL
မေတ္တေယျ	m AF j AB ɪ AL ʔ AC t AC e AL j AB a̰ AL
မေဓင်္ကရာ	m AF e AL d AC ɪ AL ɴ AG k AC ə AL ɹ AB a AL
မေဓင်္ကရာဘုရား	m AF e AL d AC ɪ AL ɴ AG k AC ə AL ɹ AB a AL pʰ AI ə AL j AB a AL
မေမေ	m AF e AL m AF e AL
မော	m AF ɔ AM
မောက်ချ	m AF a AL ʊ AM ʔ AC t AC ɕʰ BA a̰ AL
မောင်	m AF a AL ʊ AM ɴ AG
မောင်တော	m AF a AL ʊ AM ɴ AG t AC ɔ AM
မောင်နှမ	m AF a AL ʊ AM ɴ AG n̥ AG ə AL m AF a̰ AL
မောင်း	m AF a AL ʊ AM ɴ AG
မောင်းမမိဿံ	m AF a AL ʊ AM ɴ AG m AF a̰ AL m AF e AL ɪ AL ʔ AC θ AJ a AL ɴ AG
မောရစ်ရှ	m AF ɔ AM ɹ AB ɪ AL ʔ AC ʃ AJ a̰ AL
မော်စကို	m AF ɔ AM s AJ ə AL k AC o AM
မော်ဇာ	m AF ɔ AM z AJ a AL
မော်တော်ဆိုင်ကယ်	m AF ɔ AM t AC ɔ AM sʰ BA a AL ɪ AL ɴ AG k AC ɛ AL
မော်ရိုကို	m AF ɔ AM ɹ AB o AM k AC o AM
မော်ရီတေးနီးယား	m AF ɔ AM ɹ AB i AL t AC e AL n AG i AL j AB a AL
မော်လတာ	m AF ɔ AM l AE ə AL t AC a AL
မော်လဒိုက်	m AF ɔ AM l AE ə AL d AC a AL ɪ AL ʔ AC
မော်လမြိုင်	m AF ɔ AM l AE ə AL m AF j AB a AL ɪ AL ɴ AG
မော်လီကျူး	m AF ɔ AM l AE i AL t AC ɕ AJ u AM
မော်လ်ဒိုဗာ	m AF ɔ AM l AE d AC o AM b AH a AL
မေ့	m AF ḛ
မေး	m AF e AL
မေးခိုင်ရောဂါ	m AF e AL kʰ AD a AL ɪ AL ɴ AG j AB ɔ AM ɡ AC a AL
မေးခွန်း	m AF e AL ɡ AC ʊ AM ɴ AG
မေးစေ့	m AF e AL z AJ ḭ
မဲ	m AF ɛ AL
မဲခေါင်မြစ်	m AF ɛ AL kʰ AD a AL ʊ AM ɴ AG m AF j AB ɪ AL ʔ AC
မဲဆန္ဒ	m AF ɛ AL sʰ BA a AL ɴ AG d AC a̰ AL
မဲဆန္ဒနယ်	m AF ɛ AL sʰ BA a AL ɴ AG d AC a̰ AL n AG ɛ AL
မဲဆန္ဒရှင်	m AF ɛ AL sʰ BA a AL ɴ AG d AC a̰ AL ʃ AJ ɪ AL ɴ AG
မဲဆောက်	m AF ɛ AL sʰ BA a AL ʊ AM ʔ AC
မဲဇလီ	m AF ɛ AL z AJ ə AL l AE i AL
မဲပေး	m AF ɛ AL p AH e AL
မံ	m AF a AL ɴ AG
မံသ	m AF a AL ɴ AG θ AJ a̰ AL
မျက်ခုံး	m AF j AB ɛ AL ʔ AC kʰ AD o AM ʊ AM ɴ AG
မျက်ခွံ	m AF j AB ɛ AL ʔ AC kʰ AD ʊ AM ɴ AG
မျက်စိ	m AF j AB ɛ AL ʔ AC s AJ ḭ
မျက်တောင်	m AF j AB ɛ AL ʔ AC t AC a AL ʊ AM ɴ AG
မျက်နှာ	m AF j AB ɛ AL ʔ AC n̥ AG a AL
မျက်နှာကြက်	m AF j AB ɛ AL ʔ AC n̥ AG a AL d AC ʑ AJ ɛ AL ʔ AC
မျက်နှာဖုံး	m AF j AB ɛ AL ʔ AC n̥ AG ə AL pʰ AI o AM ʊ AM ɴ AG
မျက်နှာသုတ်ပဝါ	m AF j AB ɛ AL ʔ AC n̥ AG a AL θ AJ o AM ʊ AM ʔ AC p AH a̰ AL w AK a AL
မျက်ပါး	m AF j AB ɛ AL ʔ AC p AH a AL
မျက်မှန်	m AF j AB ɛ AL ʔ AC m̥ AF a AL ɴ AG
မျက်ရည်	m AF j AB ɛ AL ʔ AC j AB e AL
မျက်လုံး	m AF j AB ɛ AL ʔ AC l AE o AM ʊ AM ɴ AG
မျက်လွှာ	m AF j AB ɛ AL ʔ AC l̥ AE w AK a AL
မျက်လှည့်	m AF j AB ɛ AL ʔ AC l̥ AE ɛ̰ AL
မျည်းတံ	m AF j AB i AL d AC a AL ɴ AG
များ	m AF j AB a AL
များများ	m AF j AB a AL m AF j AB a AL
မျို	m AF j AB o AM
မျိုး	m AF j AB o AM
မျိုးချစ်စိတ်	m AF j AB o AM t AC ɕʰ BA ɪ AL ʔ AC s AJ e AL ɪ AL ʔ AC
မျိုးစိတ်	m AF j AB o AM z AJ e AL ɪ AL ʔ AC
မျိုးစု	m AF j AB o AM z AJ ṵ
မျိုးဆက်	m AF j AB o AM z AJ ɛ AL ʔ AC
မျိုးဥအိမ်	m AF j AB o AM ʔ AC ṵ ʔ AC e AL ɪ AL ɴ AG
မျော	m AF j AB ɔ AM
မျောက်	m AF j AB a AL ʊ AM ʔ AC
မျောက်ချော	m AF j AB a AL ʊ AM ʔ AC t AC ɕʰ BA ɔ AM
မျောက်လုတ်	m AF j AB a AL ʊ AM ʔ AC l AE o AM ʊ AM ʔ AC
မျောက်လောင်း	m AF j AB a AL ʊ AM ʔ AC l AE a AL ʊ AM ɴ AG
မျှင်	m̥ AF j AB ɪ AL ɴ AG
မျှစ်	m̥ AF j AB ɪ AL ʔ AC
မျှို့	m̥ AF j AB o̰ AM
မျှော်	m̥ AF j AB ɔ AM
မျှော်လင့်	m̥ AF j AB ɔ AM l AE ɪ̰ AL ɴ AG
မျှော်လင့်ချက်	m̥ AF j AB ɔ AM l AE ɪ̰ AL ɴ AG d AC ʑ AJ ɛ AL ʔ AC
မြ	m AF j AB a̰ AL
မြက်	m AF j AB ɛ AL ʔ AC
မြက်ခင်း	m AF j AB ɛ AL ʔ AC kʰ AD ɪ AL ɴ AG
မြက်ခုတ်ဓား	m AF j AB ɛ AL ʔ AC kʰ AD o AM ʊ AM ʔ AC d AC a AL
မြက်ခြောက်	m AF j AB ɛ AL ʔ AC t AC ɕʰ BA a AL ʊ AM ʔ AC
မြင့်	m AF j AB ɪ̰ AL ɴ AG
မြင်	m AF j AB ɪ AL ɴ AG
မြင်း	m AF j AB ɪ AL ɴ AG
မြင်းကလေး	m AF j AB ɪ AL ɴ AG ɡ AC ə AL l AE e AL
မြင်းကျား	m AF j AB ɪ AL ɴ AG d AC ʑ AJ a AL
မြင်းခြံ	m AF j AB ɪ AL ɴ AG d AC ʑ AJ a AL ɴ AG
မြင်းခွာ	m AF j AB ɪ AL ɴ AG kʰ AD w AK a AL
မြင်းခွာရွက်သုပ်	m AF j AB ɪ AL ɴ AG kʰ AD w AK a AL j AB w AK ɛ AL ʔ AC θ AJ o AM ʊ AM ʔ AC
မြင်းစားဂျုံ	m AF j AB ɪ AL ɴ AG z AJ a AL d AC ʑ AJ o AM ʊ AM ɴ AG
မြင်းဆေး	m AF j AB ɪ AL ɴ AG z AJ e AL
မြင်းမ	m AF j AB ɪ AL ɴ AG m AF a̰ AL
မြင်းမကလေး	m AF j AB ɪ AL ɴ AG m AF a̰ AL ɡ AC ə AL l AE e AL
မြင်းမိုရ်	m AF j AB ɪ AL ɴ AG m AF o AM
မြင်းမိုရ်တောင်	m AF j AB ɪ AL ɴ AG m AF o AM t AC a AL ʊ AM ɴ AG
မြင်းလှည်း	m AF j AB ɪ AL ɴ AG l̥ AE ɛ AL
မြင်းသံခွာ	m AF j AB ɪ AL ɴ AG θ AJ a AL ɴ AG kʰ AD w AK a AL
မြစ်	m AF j AB ɪ AL ʔ AC
မြစ်ကြီးနား	m AF j AB ɪ AL ʔ AC t AC ɕ AJ i AL n AG a AL
မြည်း	m AF j AB i AL
မြတ်လေး	m AF j AB a AL ʔ AC l AE e AL
မြန်	m AF j AB a AL ɴ AG
မြန်နှုန်းပြကိရိယာ	m AF j AB a AL ɴ AG n̥ AG o AM ʊ AM ɴ AG p AH j AB a̰ AL k AC ḭ j AB ḭ j AB a AL
မြန်မာ	m AF j AB a AL ɴ AG m AF a AL
မြန်မာ့	m AF j AB a AL ɴ AG m AF a̰ AL
မြန်မြန်	m AF j AB a AL ɴ AG m AF j AB a AL ɴ AG
မြမ္မာ	m AF j AB a AL ɴ AG m AF a AL
မြဝတီ	m AF j AB a̰ AL w AK ə AL d AC i AL
မြား	m̥ AF j AB a AL
မြိတ်	b AH e AL ɪ AL ʔ AC
မြို့	m AF j AB o̰ AM
မြို့စား	m AF j AB o̰ AM z AJ a AL
မြို့တော်	m AF j AB o̰ AM d AC ɔ AM
မြို့တော်ဝန်	m AF j AB o̰ AM d AC ɔ AM w AK ʊ AM ɴ AG
မြို့နယ်	m AF j AB o̰ AM n AG ɛ AL
မြို့ပြနိုင်ငံ	m AF j AB o̰ AM p AH j AB a̰ AL n AG a AL ɪ AL ɴ AG ŋ AG a AL ɴ AG
မြို့ဝန်	m AF j AB o̰ AM w AK ʊ AM ɴ AG
မြီ	m AF j AB i AL
မြီးရှေ	m AF j AB i AL ʃ AJ e AL
မြုံ	m AF j AB o AM ʊ AM ɴ AG
မြူ	m AF j AB u AM
မြူစွမ်	m AF j AB u AM s AJ w AK a AL ɴ AG
မြေ	m AF j AB e AL
မြေကွက်	m AF j AB e AL ɡ AC w AK ɛ AL ʔ AC
မြေခွေး	m AF j AB e AL ɡ AC w AK e AL
မြေစာ	m AF j AB e AL z AJ a AL
မြေနင်းခွာစိုက်	m AF j AB e AL n AG ɪ AL ɴ AG kʰ AD w AK a AL z AJ a AL ɪ AL ʔ AC
မြေနုကျွန်းပေါ်	m AF j AB e AL n AG ṵ t AC ɕ AJ ʊ AM ɴ AG b AH ɔ AM
မြေပုံ	m AF j AB e AL b AH o AM ʊ AM ɴ AG
မြေပုံသီး	m AF j AB e AL b AH o AM ʊ AM ɴ AG ð AJ i AL
မြေပဲ	m AF j AB e AL b AH ɛ AL
မြေပြင်	m AF j AB e AL b AH j AB ɪ AL ɴ AG
မြေပြန့်	m AF j AB e AL b AH j AB a̰ AL ɴ AG
မြေဖြူခဲ	m AF j AB e AL b AH j AB u AM ɡ AC ɛ AL
မြေရိုင်း	m AF j AB e AL j AB a AL ɪ AL ɴ AG
မြေရှင်	m AF j AB e AL ʃ AJ ɪ AL ɴ AG
မြေအောက်	m AF j AB e AL ʔ AC a AL ʊ AM ʔ AC
မြေအောက်မီးရထား	m AF j AB e AL ʔ AC a AL ʊ AM ʔ AC m AF i AL j AB ə AL tʰ AD a AL
မြေဩဇာ	m AF j AB e AL ʔ AC ɔ AM z AJ a AL
မြောက်	m AF j AB a AL ʊ AM ʔ AC
မြောက်ကိုရီးယား	m AF j AB a AL ʊ AM ʔ AC k AC o AM ɹ AB i AL j AB a AL
မြောင်း	m AF j AB a AL ʊ AM ɴ AG
မြေး	m AF j AB e AL
မြေးမ	m AF j AB e AL m AF a̰ AL
မြံမာ	m AF j AB a AL ɴ AG m AF a AL
မြွက်	m AF j AB w AK ɛ AL ʔ AC
မြွေ	m AF w AK e AL
မြွေပါ	m AF w AK e AL b AH a AL
မြွေဟောက်	m AF j AB w AK e AL h AA a AL ʊ AM ʔ AC
မြှား	m̥ AF j AB a AL
မြှောက်	m̥ AF j AB a AL ʊ AM ʔ AC
မြှောက်ရကိန်း	m̥ AF j AB a AL ʊ AM ʔ AC j AB a̰ AL k AC e AL ɪ AL ɴ AG
မွတ်	m AF ʊ AM ʔ AC
မွတ်စလင်	m AF ʊ AM ʔ AC s AJ ə AL l AE ɪ AL ɴ AG
မွန်	m AF ʊ AM ɴ AG
မွန်ဂိုးလီးယား	m AF ʊ AM ɴ AG ɡ AC o AM l AE i AL j AB a AL
မွန်တီနီဂရိုး	m AF ʊ AM ɴ AG t AC i AL n AG i AL ɡ AC ə AL ɹ AB o AM
မွာချီး	m AF w AK a AL t AC ɕʰ BA i AL
မွေး	m AF w AK e AL
မွေးနေ့	m AF w AK e AL n AG ḛ
မွေးနေ့မင်္ဂလာပါ	m AF w AK e AL n AG ḛ m AF ɪ AL ɴ AG ɡ AC ə AL l AE a AL b AH a AL
မွဲ	m AF w AK ɛ AL
မွှား	m̥ AF w AK a AL
မွှေး	m̥ AF w AK e AL
မှ	m̥ AF a̰ AL
မှတ်ကျောက်	m̥ AF a AL ʔ AC t AC ɕ AJ a AL ʊ AM ʔ AC
မှတ်စု	m̥ AF a AL ʔ AC s AJ ṵ
မှတ်စုစာအုပ်	m̥ AF a AL ʔ AC s AJ ṵ s AJ a AL ʔ AC o AM ʊ AM ʔ AC
မှတ်ဉာဏ်	m̥ AF a AL ʔ AC ɲ AG a AL n AG
မှတ်တိုင်	m̥ AF a AL ʔ AC t AC a AL ɪ AL ɴ AG
မှတ်မိ	m̥ AF a AL ʔ AC m AF ḭ
မှန်	m̥ AF a AL ɴ AG
မှန်စာ	m̥ AF a AL ɴ AG z AJ a AL
မှန်စီရွှေချ	m̥ AF a AL ɴ AG z AJ i AL ʃ AJ w AK e AL t AC ɕʰ BA a̰ AL
မှန်တော့	m̥ AF a AL ɴ AG d AC ɔ̰ AM
မှန်ပါ့ဘုရား	m̥ AF a AL ɴ AG b AH a̰ AL pʰ AI ə AL j AB a AL
မှန်ပြောင်း	m̥ AF a AL ɴ AG b AH j AB a AL ʊ AM ɴ AG
မှန်ဖြူ	m̥ AF a AL ɴ AG b AH j AB u AM
မှန်ဘီလူး	m̥ AF a AL ɴ AG b AH ə AL l AE u AM
မှန်မှန်	m̥ AF a AL ɴ AG m̥ AF a AL ɴ AG
မှန်လာ	m̥ AF a AL ɴ AG l AE a AL
မှာ	m̥ AF a AL
မှား	m̥ AF a AL
မှို	m̥ AF o AM
မှု	m̥ AF ṵ
မှုတ်	m̥ AF o AM ʊ AM ʔ AC
မှုန့်	m̥ AF o̰ AM ʊ AM ɴ AG
မှုန်	m̥ AF o AM ʊ AM ɴ AG
မှဲ့	m̥ AF ɛ̰ AL
ယက်	j AB ɛ AL ʔ AC
ယခု	j AB ə AL kʰ AD ṵ
ယင်	j AB ɪ AL ɴ AG
ယင်ကောင်	j AB ɪ AL ɴ AG ɡ AC a AL ʊ AM ɴ AG
ယင်းမာ	j AB ɪ AL ɴ AG m AF a AL
ယစ်ထုတ်	j AB ɪ AL ʔ AC tʰ AD o AM ʊ AM ʔ AC
ယဉ်	j AB ɪ AL ɴ AG
ယဉ်ကျေးမှု	j AB ɪ AL ɴ AG t AC ɕ AJ e AL m̥ AF ṵ
ယတြာ	j AB ə AL d AC ə AL j AB a AL
ယနေ့	j AB a̰ AL n AG ḛ
ယန္တရား	j AB a AL ɴ AG d AC ə AL j AB a AL
ယပက်လက်	j AB a̰ AL p AH ɛ AL ʔ AC l AE ɛ AL ʔ AC
ယပင့်	j AB a̰ AL p AH ɪ̰ AL ɴ AG
ယပ်	j AB a AL ʔ AC
ယမက	j AB ə AL m AF ə AL k AC a̰ AL
ယမင်း	j AB ə AL m AF ɪ AL ɴ AG
ယမနေ	j AB ə AL m AF ə AL n AG e AL
ယမန်နှစ်	j AB ə AL m AF a AL ɴ AG n̥ AG ɪ AL ʔ AC
ယမမင်း	j AB ə AL m AF a̰ AL m AF ɪ AL ɴ AG
ယမုန်နာ	j AB ə AL m AF o AM ʊ AM ɴ AG n AG a AL
ယမ်း	j AB a AL ɴ AG
ယမ်းတောင့်	j AB a AL ɴ AG d AC a̰ AL ʊ AM ɴ AG
ယမ်းမှုန့်	j AB a AL ɴ AG m̥ AF o̰ AM ʊ AM ɴ AG
ယဝဒီပ	j AB a̰ AL w AK a̰ AL d AC i AL p AH a̰ AL
ယသောဓရာ	j AB a̰ AL θ AJ ɔ AM d AC ə AL j AB a AL
ယာဉ်	j AB ɪ AL ɴ AG
ယာဉ်မောင်း	j AB ɪ AL ɴ AG m AF a AL ʊ AM ɴ AG
ယာဉ်ရပ်	j AB ɪ AL ɴ AG j AB a AL ʔ AC
ယာဘ	j AB a AL b AH a̰ AL
ယာမာ	j AB a AL m AF a AL
ယာယီ	j AB a AL j AB i AL
ယို	j AB o AM
ယိုးဒယား	j AB o AM d AC ə AL j AB a AL
ယီမင်	j AB i AL m AF ɪ AL ɴ AG
ယုဂ်	j AB o AM ʊ AM ʔ AC
ယုဇန	j AB ṵ z AJ a̰ AL n AG a̰ AL
ယုတ္တိ	j AB o AM ʊ AM ʔ AC t AC ḭ
ယုတ္တိဗေဒ	j AB o AM ʊ AM ʔ AC t AC ḭ b AH e AL d AC a̰ AL
ယုန်	j AB o AM ʊ AM ɴ AG
ယုံ	j AB o AM ʊ AM ɴ AG
ယုံကြည်	j AB o AM ʊ AM ɴ AG t AC ɕ AJ i AL
ယူ	j AB u AM
ယူကရိန်း	j AB u AM k AC ə AL ɹ AB e AL ɪ AL ɴ AG
ယူဂန်းဒါး	j AB u AM ɡ AC a AL ɴ AG d AC a AL
ယူနိုက်တက်ကင်းဒမ်း	j AB u AM n AG a AL ɪ AL ʔ AC t AC ɛ AL ʔ AC k AC ɪ AL ɴ AG d AC a AL ɴ AG
ယူနီယန်	j AB u AM n AG i AL j AB a AL ɴ AG
ယူရို	j AB u AM ɹ AB o AM
ယူရေးရှား	j AB u AM ɹ AB e AL ʃ AJ a AL
ယေရှု	j AB e AL ʃ AJ ṵ
ယောက္ခထီး	j AB a AL ʊ AM ʔ AC kʰ AD ə AL tʰ AD i AL
ယောက္ခမ	j AB a AL ʊ AM ʔ AC kʰ AD ə AL m AF a̰ AL
ယောက်	j AB a AL ʊ AM ʔ AC
ယောက်ဖ	j AB a AL ʊ AM ʔ AC pʰ AI a̰ AL
ယောက်မ	j AB a AL ʊ AM ɴ AG m AF a̰ AL
ယောက်ျား	j AB a AL ʊ AM ʔ AC t AC ɕ AJ a AL
ယောက်ျားလျာ	j AB a AL ʊ AM ʔ AC k AC ə AL ʃ AJ a AL
ယောဂ	j AB ɔ AM ɡ AC a̰ AL
ယောဇနာ	j AB ɔ AM z AJ ə AL n AG a AL
ယောနိ	j AB ɔ AM n AG ḭ
ယဲ့ယဲ့	j AB ɛ̰ AL j AB ɛ̰ AL
ယွန်း	j AB ʊ AM ɴ AG
ယွန်းထည်	j AB ʊ AM ɴ AG tʰ AD ɛ AL
ယွန်းယွန်း	j AB ʊ AM ɴ AG j AB ʊ AM ɴ AG
ယှဉ်ဖက်	ʃ AJ ɪ AL ɴ AG pʰ AI ɛ AL ʔ AC
ယှဉ်း	ʃ AJ ɪ AL ɴ AG
ရ	ɹ AB a̰ AL
ရကောက်	j AB a̰ AL k AC a AL ʊ AM ʔ AC
ရက်	j AB ɛ AL ʔ AC
ရက်ကန်း	j AB ɛ AL ʔ AC k AC a AL ɴ AG
ရက်ကန်းစင်	j AB ɛ AL ʔ AC k AC a AL ɴ AG z AJ ɪ AL ɴ AG
ရက်စွဲ	j AB ɛ AL ʔ AC s AJ w AK ɛ AL
ရက်ရာဇာ	j AB ɛ AL ʔ AC j AB a AL z AJ a AL
ရက်သတ္တပတ်	j AB ɛ AL ʔ AC θ AJ a AL ʔ AC d AC ə AL b AH a AL ʔ AC
ရခိုင်	j AB ə AL kʰ AD a AL ɪ AL ɴ AG
ရင်	j AB ɪ AL ɴ AG
ရင်ခံ	j AB ɪ AL ɴ AG kʰ AD a AL ɴ AG
ရင်ထိုးတံဆိပ်	j AB ɪ AL ɴ AG d AC o AM d AC ə AL z AJ e AL ɪ AL ʔ AC
ရင်ပတ်	j AB ɪ AL ɴ AG b AH a AL ʔ AC
ရင်ပြင်	j AB ɪ AL ɴ AG b AH j AB ɪ AL ɴ AG
ရင်ဘတ်	j AB ɪ AL ɴ AG b AH a AL ʔ AC
ရင်းရဲ	j AB ɪ AL ɴ AG j AB ɛ AL
ရည်	j AB i AL
ရည်းစား	j AB i AL z AJ a AL
ရတနာ	j AB ɛ AL d AC ə AL n AG a AL
ရတနာပုံ	j AB ɛ AL d AC ə AL n AG a AL b AH o AM ʊ AM ɴ AG
ရတနာပူရ	j AB ɛ AL d AC ə AL n AG a AL p AH u AM ɹ AB a̰ AL
ရတနာသိင်္ဃ	j AB ə AL d AC ə AL n AG a AL θ AJ e AL ɪ AL ɴ AG ɡ AC a̰ AL
ရတနာသုံးပါး	j AB ɛ AL d AC ə AL n AG a AL θ AJ o AM ʊ AM ɴ AG b AH a AL
ရတီ	j AB ə AL t AC i AL
ရတု	j AB a̰ AL t AC ṵ
ရထား	j AB ə AL tʰ AD a AL
ရနံ့	j AB ə AL n AG a̰ AL ɴ AG
ရန်	j AB a AL ɴ AG
ရန်ကုန်	j AB a AL ɴ AG ɡ AC o AM ʊ AM ɴ AG
ရန်ပြု	j AB a AL ɴ AG p AH j AB ṵ
ရန်ဖြစ်	j AB a AL ɴ AG pʰ AI j AB ɪ AL ʔ AC
ရန်သူ	j AB a AL ɴ AG ð AJ u AM
ရန်သူမျိုးငါးပါး	j AB a AL ɴ AG ð AJ u AM m AF j AB o AM ŋ AG a AL b AH a AL
ရပါတယ်	j AB a̰ AL b AH a AL d AC ɛ AL
ရပ်	j AB a AL ʔ AC
ရပ်ကွက်	j AB a AL ʔ AC k AC w AK ɛ AL ʔ AC
ရမ္မက်	j AB ə AL m AF ɛ AL ʔ AC
ရမ်	ɹ AB a AL ɴ AG
ရမ်းရမ်း	j AB a AL ɴ AG j AB a AL ɴ AG
ရယ်	j AB i AL
ရရစ်	j AB a̰ AL j AB ɪ AL ʔ AC
ရဝမ်ဒါ	ɹ AB ə AL w AK a AL ɴ AG d AC a AL
ရဝိန်	j AB ə AL w AK e AL ɪ AL ɴ AG
ရဝေ	j AB ə AL w AK e AL
ရသ	j AB a̰ AL ð AJ a AL
ရဟတ်	j AB ə AL h AA a AL ʔ AC
ရဟန်း	j AB ə AL h AA a AL ɴ AG
ရာ	j AB a AL
ရာခိုင်နှုန်း	j AB a AL kʰ AD a AL ɪ AL ɴ AG n̥ AG o AM ʊ AM ɴ AG
ရာဂ	j AB a AL ɡ AC a̰ AL
ရာစု	j AB a AL z AJ ṵ
ရာစုနှစ်	j AB a AL z AJ ṵ n̥ AG ɪ AL ʔ AC
ရာဇ	j AB a AL z AJ a̰ AL
ရာဇဂုရု	j AB a AL z AJ a̰ AL ɡ AC ṵ ɹ AB ṵ
ရာဇဌာန်	ɹ AB a AL z AJ ə AL tʰ AD a AL n AG
ရာဇဝင်	j AB a AL z AJ ə AL w AK ɪ AL ɴ AG
ရာဇဝတ်	j AB a AL z AJ ə AL w AK ʊ AM ʔ AC
ရာဇဝတ်ကောင်	j AB a AL z AJ ə AL w AK ʊ AM ʔ AC k AC a AL ʊ AM ɴ AG
ရာဇသတ်	j AB a AL z AJ ə AL θ AJ a AL ʔ AC
ရာဇာ	j AB a AL z AJ a AL
ရာဇာဓိရာဇဂုရု	j AB a AL z AJ a̰ AL d AC ḭ j AB a AL z AJ a̰ AL ɡ AC ṵ ɹ AB ṵ
ရာဘ	j AB a AL b AH a̰ AL
ရာဘာ	j AB a AL b AH a AL
ရာမ	j AB a AL m AF a̰ AL
ရာမည	ɹ AB a AL m AF ə AL ɲ AG a̰ AL
ရာဝဏ	ɹ AB a AL w AK ə AL n AG a̰ AL
ရာသီ	j AB a AL ð AJ i AL
ရာသီဥတု	j AB a AL ð AJ i AL ʔ AC ṵ d AC ṵ
ရာဟုလာ	j AB a AL h AA ṵ l AE a AL
ရိက္ခါ	j AB e AL ɪ AL ʔ AC kʰ AD a AL
ရိက္ခာ	j AB e AL ɪ AL ʔ AC kʰ AD a AL
ရိတ်	j AB e AL ɪ AL ʔ AC
ရိတ်သိမ်း	j AB e AL ɪ AL ʔ AC θ AJ e AL ɪ AL ɴ AG
ရိပ်ရိပ်	j AB e AL ɪ AL ʔ AC j AB e AL ɪ AL ʔ AC
ရိုက်	j AB a AL ɪ AL ʔ AC
ရိုင်ဖယ်	ɹ AB a AL ɪ AL ɴ AG pʰ AI ɛ AL
ရိုင်ရိုင်	j AB a AL ɪ AL ɴ AG j AB a AL ɪ AL ɴ AG
ရိုဟင်ဂျာ	ɹ AB o AM h AA ɪ AL ɴ AG d AC ʑ AJ a AL
ရိုး	j AB o AM
ရိုးရာအမည်	j AB o AM j AB a AL ʔ AC ə AL m AF j AB i AL
ရိုးရိုး	j AB o AM j AB o AM
ရုက္ခစိုး	j AB o AM ʊ AM ʔ AC ɡ AC ə AL z AJ o AM
ရုက္ခဗေဒ	j AB o AM ʊ AM ʔ AC kʰ AD a̰ AL b AH e AL d AC a̰ AL
ရုပ်	j AB o AM ʊ AM ʔ AC
ရုပ်ကလာပ်	j AB o AM ʊ AM ʔ AC k AC ə AL l AE a AL ʔ AC
ရုပ်တု	j AB o AM ʊ AM ʔ AC t AC ṵ
ရုပ်ပုံ	j AB o AM ʊ AM ʔ AC p AH o AM ʊ AM ɴ AG
ရုပ်မြင်သံကြား	j AB o AM ʊ AM ʔ AC m AF j AB ɪ AL ɴ AG θ AJ a AL ɴ AG d AC ʑ AJ a AL
ရုပ်ရှင်	j AB o AM ʊ AM ʔ AC ʃ AJ ɪ AL ɴ AG
ရုပ်ရှင်ရုံ	j AB o AM ʊ AM ʔ AC ʃ AJ ɪ AL ɴ AG j AB o AM ʊ AM ɴ AG
ရုပ်သေး	j AB o AM ʊ AM ʔ AC θ AJ e AL
ရုပ်သေးအစိုးရ	j AB o AM ʊ AM ʔ AC θ AJ e AL ʔ AC ə AL s AJ o AM j AB a̰ AL
ရုရု	j AB ṵ j AB ṵ
ရုရှား	ɹ AB ṵ ʃ AJ a AL
ရုံ	j AB o AM ʊ AM ɴ AG
ရုံး	j AB o AM ʊ AM ɴ AG
ရုံးပတီ	j AB o AM ʊ AM ɴ AG b AH ə AL t AC i AL
ရူပ	j AB u AM p AH a̰ AL
ရူပကအလင်္ကာ	j AB u AM p AH ə AL k AC a̰ AL ʔ AC ə AL l AE i AL ɡ AC a AL
ရူပနက္ခတ္တဗေဒ	j AB u AM p AH a̰ AL n AG ɛ AL ʔ AC kʰ AD a AL ʔ AC t AC a̰ AL b AH e AL d AC a̰ AL
ရူပဗေဒ	j AB u AM p AH a̰ AL b AH e AL d AC a̰ AL
ရူမေးနီးယား	ɹ AB u AM m AF e AL n AG i AL j AB a AL
ရေ	j AB e AL
ရေကတော့	j AB e AL ɡ AC ə AL d AC ɔ̰ AM
ရေကာတာ	j AB e AL ɡ AC a AL d AC a AL
ရေကူး	j AB e AL k AC u AM
ရေကူးကန်	j AB e AL k AC u AM ɡ AC a AL ɴ AG
ရေကြီး	j AB e AL t AC ɕ AJ i AL
ရေကြီးခြင်း	j AB e AL t AC ɕ AJ i AL d AC ʑ AJ ɪ AL ɴ AG
ရေခဲ	j AB e AL ɡ AC ɛ AL
ရေခဲမုန့်	j AB e AL ɡ AC ɛ AL m AF o̰ AM ʊ AM ɴ AG
ရေခဲသေတ္တာ	j AB e AL ɡ AC ɛ AL θ AJ ɪ AL ʔ AC t AC a AL
ရေချိုး	j AB e AL t AC ɕʰ BA o AM
ရေခွက်	j AB e AL ɡ AC w AK ɛ AL ʔ AC
ရေငတ်တယ်	j AB e AL ŋ AG a AL ʔ AC t AC ɛ AL
ရေငွေ့	j AB e AL ŋ AG w AK ḛ
ရေစစ္စရီ	j AB e AL s AJ ɪ AL ʔ AC s AJ ə AL ɹ AB i AL
ရေညှိ	j AB e AL ɲ̊ AG ḭ
ရေတပ်	j AB e AL d AC a AL ʔ AC
ရေတံခွန်	j AB e AL d AC a AL ɡ AC ʊ AM ɴ AG
ရေတွက်	j AB e AL t AC w AK ɛ AL ʔ AC
ရေတွင်း	j AB e AL d AC w AK ɪ AL ɴ AG
ရေဒီယို	ɹ AB e AL d AC i AL j AB o AM
ရေနဂါး	j AB e AL n AG ə AL ɡ AC a AL
ရေနံ	j AB e AL n AG a AL ɴ AG
ရေနံချောင်း	j AB e AL n AG a AL ɴ AG t AC ɕʰ BA a AL ʊ AM ɴ AG
ရေနံဆီ	j AB e AL n AG a AL ɴ AG z AJ i AL
ရေပန်း	j AB e AL b AH a AL ɴ AG
ရေပိုက်	j AB e AL p AH a AL ɪ AL ʔ AC
ရေမိုင်	j AB e AL m AF a AL ɪ AL ɴ AG
ရေမြင်း	j AB e AL m AF j AB ɪ AL ɴ AG
ရေမွှေး	j AB e AL m̥ AF w AK e AL
ရေမှုတ်	j AB e AL m̥ AF o AM ʊ AM ʔ AC
ရေယုန်	j AB e AL j AB o AM ʊ AM ɴ AG
ရေလက်ဝါး	j AB e AL l AE ɛ AL ʔ AC w AK a AL
ရေလုပ်သား	j AB e AL l AE o AM ʊ AM ʔ AC θ AJ a AL
ရေဝတ	ɹ AB e AL w AK ə AL t AC a̰ AL
ရေဝတဘုရား	j AB e AL w AK ə AL t AC a̰ AL pʰ AI ə AL j AB a AL
ရေသူ	j AB e AL ð AJ u AM
ရေသူမ	j AB e AL ð AJ u AM m AF a̰ AL
ရောက်	j AB a AL ʊ AM ʔ AC
ရောဂန္တရကပ်	j AB ɔ AM ɡ AC a AL ɴ AG t AC ə AL ɹ AB a̰ AL k AC a AL ʔ AC
ရောဂါ	j AB ɔ AM ɡ AC a AL
ရောဂါဗေဒ	j AB ɔ AM ɡ AC a AL b AH e AL d AC a̰ AL
ရောင်	j AB a AL ʊ AM ɴ AG
ရောင်ခြည်	j AB a AL ʊ AM ɴ AG d AC ʑ AJ i AL
ရောင်း	j AB a AL ʊ AM ɴ AG
ရောမ	ɹ AB ɔ AM m AF a̰ AL
ရော်ဘာ	ɹ AB ɔ AM b AH a AL
ရေး	j AB e AL
ရေးချ	j AB e AL t AC ɕʰ BA a̰ AL
ရေးရေး	j AB e AL j AB e AL
ရဲ	j AB ɛ AL
ရဲစခန်း	j AB ɛ AL s AJ ə AL kʰ AD a AL ɴ AG
ရဲတိုက်	j AB ɛ AL d AC a AL ɪ AL ʔ AC
ရဲဘော်	j AB ɛ AL b AH ɔ AM
ရဲရင့်	j AB ɛ AL j AB ɪ̰ AL ɴ AG
ရဲရဲ	j AB ɛ AL j AB ɛ AL
ရဲသား	j AB ɛ AL ð AJ a AL
ရဲ့	j AB ɛ̰ AL
ရွတ်ရွတ်	j AB ʊ AM ʔ AC j AB ʊ AM ʔ AC
ရွပ်ရွပ်	j AB ʊ AM ʔ AC j AB ʊ AM ʔ AC
ရွရွ	j AB w AK a̰ AL j AB w AK a̰ AL
ရွာ	j AB w AK a AL
ရွာစား	j AB w AK a AL z AJ a AL
ရွာသူ	j AB w AK a AL ð AJ u AM
ရွေး	j AB w AK e AL
ရွေးကောက်ပွဲ	j AB w AK e AL k AC a AL ʊ AM ʔ AC p AH w AK ɛ AL
ရွှေ	ʃ AJ w AK e AL
ရွှေကြည်	ʃ AJ w AK e AL d AC ʑ AJ i AL
ရွှေချည်ထိုး	ʃ AJ w AK e AL d AC ʑ AJ i AL d AC o AM
ရွှေချီ	ʃ AJ w AK e AL d AC ʑ AJ i AL
ရွှေတိုက်	ʃ AJ w AK e AL d AC a AL ɪ AL ʔ AC
ရွှေတောင်	ʃ AJ w AK e AL d AC a AL ʊ AM ɴ AG
ရွှေတောင်ခေါက်ဆွဲ	ʃ AJ w AK e AL d AC a AL ʊ AM ɴ AG kʰ AD a AL ʊ AM ʔ AC sʰ BA w AK ɛ AL
ရွှေထမင်း	ʃ AJ w AK e AL tʰ AD ə AL m AF ɪ AL ɴ AG
ရွှေနန်းရွှေပြာသာဒ်သခင်	ʃ AJ w AK e AL n AG a AL ɴ AG ʃ AJ w AK e AL p AH j AB a AL ʔ AC θ AJ a AL ʔ AC θ AJ ə AL kʰ AD ɪ AL ɴ AG
ရွှေနန်းရှင်ဘုရား	ʃ AJ w AK e AL n AG a AL ɴ AG ʃ AJ ɪ AL ɴ AG pʰ AI ə AL j AB a AL
ရွှေပြည်စိုး	ʃ AJ w AK e AL p AH j AB i AL s AJ o AM
ရွှေဖရုံသီး	ʃ AJ w AK e AL pʰ AI ə AL j AB o AM ʊ AM ɴ AG ð AJ i AL
ရွှေဖြူ	ʃ AJ w AK e AL b AH j AB u AM
ရွှေဘို	ʃ AJ w AK e AL b AH o AM
ရွှေမျက်ပါး	ʃ AJ w AK e AL m AF j AB ɛ AL ʔ AC p AH a AL
ရွှေရင်အေး	ʃ AJ w AK e AL j AB ɪ AL ɴ AG ʔ AC e AL
ရွှေ့	ʃ AJ w AK ḛ
ရွှဲ	ʃ AJ w AK ɛ AL
ရွှံ့	ʃ AJ ʊ̰ AM ɴ AG
ရွှံ့ပွက်	ʃ AJ ʊ̰ AM ɴ AG b AH w AK ɛ AL ʔ AC
ရှက်	ʃ AJ ɛ AL ʔ AC
ရှင့်	ʃ AJ ɪ̰ AL ɴ AG
ရှင်	ʃ AJ ɪ AL ɴ AG
ရှင်တို့	ʃ AJ ɪ AL ɴ AG d AC o̰ AM
ရှင်ပြု	ʃ AJ ɪ AL ɴ AG p AH j AB ṵ
ရှင်ဘုရင်	ʃ AJ ɪ AL ɴ AG b AH ə AL j AB ɪ AL ɴ AG
ရှင်ရှင်	ʃ AJ ɪ AL ɴ AG ʃ AJ ɪ AL ɴ AG
ရှင်းရှင်း	ʃ AJ ɪ AL ɴ AG ʃ AJ ɪ AL ɴ AG
ရှစ်	ʃ AJ ɪ AL ʔ AC
ရှစ်လ	ʃ AJ ɪ AL ʔ AC l AE a̰ AL
ရှဉ့်	ʃ AJ ɪ̰ AL ɴ AG
ရှည်	ʃ AJ e AL
ရှည်မျော	ʃ AJ e AL m AF j AB ɔ AM
ရှမ်း	ʃ AJ a AL ɴ AG
ရှမ်းခေါက်ဆွဲ	ʃ AJ a AL ɴ AG kʰ AD a AL ʊ AM ʔ AC sʰ BA w AK ɛ AL
ရှယ်	ʃ AJ ɛ AL
ရှလကာရည်	ʃ AJ a AL l AE ə AL k AC a AL j AB e AL
ရှလပတ်ရည်	ʃ AJ a̰ AL l AE ə AL p AH a AL ʔ AC j AB e AL
ရှာ	ʃ AJ a AL
ရှား	ʃ AJ a AL
ရှိ	ʃ AJ ḭ
ရှိန်းခို	ʃ AJ e AL ɪ AL ɴ AG ɡ AC o AM
ရှိုက်	ʃ AJ a AL ɪ AL ʔ AC
ရှို့	ʃ AJ o̰ AM
ရှိုး	ʃ AJ o AM
ရှူ	ʃ AJ u AM
ရှူတင်	ʃ AJ u AM t AC ɪ AL ɴ AG
ရှူရှိုက်	ʃ AJ u AM ʃ AJ a AL ɪ AL ʔ AC
ရှူးဖိနပ်	ʃ AJ u AM pʰ AI ə AL n AG a AL ʔ AC
ရှောက်	ʃ AJ a AL ʊ AM ʔ AC
ရှောက်နု	ʃ AJ a AL ʊ AM ʔ AC n AG ṵ
ရှေ့	ʃ AJ ḛ
ရှေ့ဆက်	ʃ AJ ḛ z AJ ɛ AL ʔ AC
ရှေ့နေ	ʃ AJ ḛ n AG e AL
ရှေ့ရုံး	ʃ AJ ḛ j AB o AM ʊ AM ɴ AG
ရှေး	ʃ AJ e AL
ရဿ	ɹ AB a AL ʔ AC θ AJ a̰ AL
လ	l AE a̰ AL
လက္ခဏ	l AE ɛ AL ʔ AC kʰ AD ə AL n AG a̰ AL
လက္ခဏာ	l AE ɛ AL ʔ AC kʰ AD ə AL n AG a AL
လက္ခဏာရေးသုံးပါး	l AE ɛ AL ʔ AC kʰ AD ə AL n AG a AL j AB e AL θ AJ o AM ʊ AM ɴ AG b AH a AL
လက်	l AE ɛ AL ʔ AC
လက်ကိုင်ပဝါ	l AE ɛ AL ʔ AC k AC a AL ɪ AL ɴ AG p AH a̰ AL w AK a AL
လက်ကောက်	l AE ɛ AL ʔ AC k AC a AL ʊ AM ʔ AC
လက်ကွက်	l AE ɛ AL ʔ AC k AC w AK ɛ AL ʔ AC
လက်ခံ	l AE ɛ AL ʔ AC kʰ AD a AL ɴ AG
လက်ချောင်း	l AE ɛ AL ʔ AC t AC ɕʰ BA a AL ʊ AM ɴ AG
လက်စွပ်	l AE ɛ AL ʔ AC s AJ ʊ AM ʔ AC
လက်ဆောင်	l AE ɛ AL ʔ AC sʰ BA a AL ʊ AM ɴ AG
လက်ဆွဲသေတ္တာ	l AE ɛ AL ʔ AC sʰ BA w AK ɛ AL θ AJ ɪ AL ʔ AC t AC a AL
လက်တင်	l AE ɛ AL ʔ AC t AC ɪ AL ɴ AG
လက်တင်အမေရိက	l AE ɛ AL ʔ AC t AC ɪ AL ɴ AG ʔ AC ə AL m AF e AL ɹ AB ḭ k AC a̰ AL
လက်တန်း	l AE ɛ AL ʔ AC t AC a AL ɴ AG
လက်ထပ်	l AE ɛ AL ʔ AC tʰ AD a AL ʔ AC
လက်နက်	l AE ɛ AL ʔ AC n AG ɛ AL ʔ AC
လက်နှိပ်စက်	l AE ɛ AL ʔ AC n̥ AG e AL ɪ AL ʔ AC s AJ ɛ AL ʔ AC
လက်ပတ်နာရီ	l AE ɛ AL ʔ AC p AH a AL ʔ AC n AG a AL j AB i AL
လက်ပံ	l AE ɛ AL ʔ AC p AH a AL ɴ AG
လက်ပံခါး	l AE ɛ AL ʔ AC p AH a AL ɴ AG ɡ AC a AL
လက်ဖက်	l AE ɛ AL ʔ AC pʰ AI ɛ AL ʔ AC
လက်ဖက်ထုပ်	l AE ə AL pʰ AI ɛ AL ʔ AC tʰ AD o AM ʊ AM ʔ AC
လက်ဖက်ရည်	l AE ə AL pʰ AI ɛ AL ʔ AC j AB e AL
လက်ဖက်ရည်ဆိုင်	l AE ə AL pʰ AI ɛ AL ʔ AC j AB e AL z AJ a AL ɪ AL ɴ AG
လက်ဖက်သုပ်	l AE ə AL pʰ AI ɛ AL ʔ AC θ AJ o AM ʊ AM ʔ AC
လက်ဘနွန်	l AE ɛ AL ʔ AC b AH ə AL n AG ʊ AM ɴ AG
လက်မှတ်	l AE ɛ AL ʔ AC m̥ AF a AL ʔ AC
လက်ရန်း	l AE ɛ AL ʔ AC j AB a AL ɴ AG
လက်ဝါး	l AE ɛ AL ʔ AC w AK a AL
လက်ဝါးကပ်တိုင်	l AE ɛ AL ʔ AC w AK ə AL ɡ AC a AL ʔ AC t AC a AL ɪ AL ɴ AG
လက်ဝှေ့	l AE ɛ AL ʔ AC ʍ AN ḛ
လက်သည်	l AE ɛ AL ʔ AC θ AJ ɛ AL
လက်သည်း	l AE ɛ AL ʔ AC θ AJ ɛ AL
လက်သည်းကွင်း	l AE ɛ AL ʔ AC θ AJ e AL ɡ AC w AK ɪ AL ɴ AG
လက်သမား	l AE ɛ AL ʔ AC θ AJ a̰ AL m AF a AL
လက်သီး	l AE ɛ AL ʔ AC θ AJ i AL
လက်သုတ်ပဝါ	l AE ɛ AL ʔ AC θ AJ o AM ʊ AM ʔ AC p AH a̰ AL w AK a AL
လက်သုပ်စုံ	l AE ɛ AL ʔ AC θ AJ o AM ʊ AM ʔ AC s AJ o AM ʊ AM ɴ AG
လက်အိတ်	l AE ɛ AL ʔ AC ʔ AC e AL ɪ AL ʔ AC
လကွယ်	l AE a̰ AL ɡ AC w AK ɛ AL
လခြမ်း	l AE a̰ AL d AC ʑ AJ a AL ɴ AG
လခြမ်းဆိုင်း	l AE a̰ AL d AC ʑ AJ a AL ɴ AG sʰ BA a AL ɪ AL ɴ AG
လငယ်	l AE a̰ AL ŋ AG ɛ AL
လင်	l AE ɪ AL ɴ AG
လင်ကောင်ပိုး	l AE ɪ AL ɴ AG ɡ AC a AL ʊ AM ɴ AG b AH o AM
လင်ပန်း	l AE ɪ AL ɴ AG b AH a AL ɴ AG
လင်မယား	l AE ɪ AL ɴ AG m AF ə AL j AB a AL
လင်း	l AE ɪ AL ɴ AG
လင်းဆွဲ	l AE ɪ AL ɴ AG z AJ w AK ɛ AL
လင်းဇင်း	l AE ɪ AL ɴ AG z AJ ɪ AL ɴ AG
လင်းတ	l AE ɪ AL ɴ AG d AC a̰ AL
လင်းနို့	l AE ɪ AL ɴ AG n AG o̰ AM
လင်းပိုင်	l AE ɪ AL ɴ AG b AH a AL ɪ AL ɴ AG
လင်းယဉ်	l AE ɪ AL ɴ AG j AB ɪ AL ɴ AG
လင်းယုန်	l AE ɪ AL ɴ AG j AB o AM ʊ AM ɴ AG
လစဉ်	l AE a̰ AL z AJ ɪ AL ɴ AG
လစ်	l AE ɪ AL ʔ AC
လစ်တန်စတိန်း	l AE ɪ AL ʔ AC t AC a AL ɴ AG s AJ ə AL t AC e AL ɪ AL ɴ AG
လစ်ဗျား	l AE ɪ AL ʔ AC b AH j AB a AL
လစ်သူယေးနီးယား	l AE ɪ AL ʔ AC θ AJ u AM j AB e AL n AG i AL j AB a AL
လဆန်း	l AE a̰ AL z AJ a AL ɴ AG
လဆုတ်	l AE a̰ AL z AJ o AM ʊ AM ʔ AC
လဆွဲ	l AE a̰ AL sʰ BA w AK ɛ AL
လည်	l AE ɛ AL
လည်ချောင်း	l AE ɛ AL d AC ʑ AJ a AL ʊ AM ɴ AG
လည်စည်း	l AE e AL z AJ i AL
လည်ပင်း	l AE ɛ AL b AH ɪ AL ɴ AG
လည်ပင်းကြီးရောဂါ	l AE i AL b AH ɪ AL ɴ AG d AC ʑ AJ i AL j AB ɔ AM ɡ AC a AL
လည်း	l AE ɛ AL
လတ်	l AE a AL ʔ AC
လတ်ဗီယာ	l AE a AL ʔ AC b AH i AL j AB a AL
လန်ဒန်	l AE a AL ɴ AG d AC a AL ɴ AG
လပို့	l AE ə AL b AH o̰ AM
လပ်	l AE a AL ʔ AC
လပြည့်	l AE a̰ AL p AH j AB ḛ
လပြည့်နေ့	l AE a̰ AL p AH j AB ḭ n AG ḛ
လပြည့်ဝန်း	l AE a̰ AL b AH j AB ḛ w AK ʊ AM ɴ AG
လမု	l AE ə AL m AF ṵ
လမုန့်	l AE a̰ AL m AF o̰ AM ʊ AM ɴ AG
လမ်း	l AE a AL ɴ AG
လမ်းကြား	l AE a AL ɴ AG d AC ʑ AJ a AL
လမ်းဆုံ	l AE a AL ɴ AG z AJ o AM ʊ AM ɴ AG
လမ်းပြ	l AE a AL ɴ AG p AH j AB a̰ AL
လမ်းဘေးဆိုင်	l AE a AL ɴ AG b AH e AL z AJ a AL ɪ AL ɴ AG
လမ်းလျှောက်	l AE a AL ɴ AG ʃ AJ a AL ʊ AM ʔ AC
လမ်းသရဲ	l AE a AL ɴ AG θ AJ ə AL j AB ɛ AL
လယ်	l AE ɛ AL
လယ်ထွန်	l AE ɛ AL tʰ AD ʊ AM ɴ AG
လယ်ထွန်မင်္ဂလာ	l AE ɛ AL tʰ AD ʊ AM ɴ AG m AF ɪ AL ɴ AG ɡ AC ə AL l AE a AL
လယ်ပြင်	l AE ɛ AL b AH j AB ɪ AL ɴ AG
လယ်ယာ	l AE ɛ AL j AB a AL
လယ်သမား	l AE ɛ AL ð AJ ə AL m AF a AL
လဟု	l AE ə AL h AA ṵ
လာ	l AE a AL
လာဘ်	l AE a AL ʔ AC
လာအို	l AE a AL ʔ AC o AM
လား	l AE a AL
လိင်	l AE e AL ɪ AL ɴ AG
လိင်ဆက်ဆံ	l AE e AL ɪ AL ɴ AG sʰ BA ɛ AL ʔ AC sʰ BA a AL ɴ AG
လိင်တံ	l AE e AL ɪ AL ɴ AG d AC a AL ɴ AG
လိင်ပညာ	l AE e AL ɪ AL ɴ AG p AH j AB ɪ AL ɴ AG ɲ AG a AL
လိပ်	l AE e AL ɪ AL ʔ AC
လိပ်ကျောက်	l AE e AL ɪ AL ʔ AC t AC ɕ AJ a AL ʊ AM ʔ AC
လိပ်ခေါင်း	l AE e AL ɪ AL ʔ AC ɡ AC a AL ʊ AM ɴ AG j AB ɔ AM ɡ AC a AL
လိပ်ခေါင်းရောဂါ	l AE e AL ɪ AL ʔ AC ɡ AC a AL ʊ AM ɴ AG j AB ɔ AM ɡ AC a AL
လိပ်စာ	l AE e AL ɪ AL ʔ AC s AJ a AL
လိပ်ပြာ	l AE e AL ɪ AL ʔ AC p AH j AB a AL
လိမ္မော်	l AE e AL ɪ AL ɴ AG m AF ɔ AM
လိမ်	l AE e AL ɪ AL ɴ AG
လိမ်း	l AE e AL ɪ AL ɴ AG
လိမ်းဆေး	l AE e AL ɪ AL ɴ AG z AJ e AL
လို	l AE o AM
လိုက်	l AE a AL ɪ AL ʔ AC
လိုက်ချီး	l AE a AL ɪ AL ʔ AC t AC ɕʰ BA i AL
လိုက်ပြေး	l AE a AL ɪ AL ʔ AC p AH j AB e AL
လိုက်ဘေးရီးယား	l AE a AL ɪ AL ʔ AC b AH e AL ɹ AB i AL j AB a AL
လိုချင်	l AE o AM d AC ʑ AJ ɪ AL ɴ AG
လိုင်စင်	l AE a AL ɪ AL ɴ AG s AJ ɪ AL ɴ AG
လိုင်း	l AE a AL ɪ AL ɴ AG
လိုဏ်	l̥ AE a AL ɪ AL ɴ AG
လိုဏ်ခေါင်း	l̥ AE a AL ɪ AL ɴ AG ɡ AC a AL ʊ AM ɴ AG
လိုအပ်	l AE o AM ʔ AC a AL ʔ AC
လို့	l AE o̰ AM
လိုး	l AE o AM
လီဆိုသို	l AE i AL sʰ BA o AM θ AJ o AM
လီဆူ	l AE i AL sʰ BA u AM
လီတာ	l AE i AL t AC a AL
လီသီယမ်	l AE i AL θ AJ i AL j AB a AL ɴ AG
လီး	l AE i AL
လုပ်	l AE o AM ʊ AM ʔ AC
လုပ်ခ	l AE o AM ʊ AM ʔ AC kʰ AD a̰ AL
လုပ်ငန်း	l AE o AM ʊ AM ʔ AC ŋ AG a AL ɴ AG
လုပ်ရတ်	l AE o AM ʊ AM ʔ AC j AB a AL ʔ AC
လုပ်သား	l AE o AM ʊ AM ʔ AC θ AJ a AL
လုပ်အား	l AE o AM ʊ AM ʔ AC ʔ AC a AL
လုံချည်	l AE o AM ʊ AM ɴ AG d AC ʑ AJ i AL
လုံခြုံရေး	l AE o AM ʊ AM ɴ AG d AC ʑ AJ o AM ʊ AM ɴ AG j AB e AL
လုံး	l AE o AM ʊ AM ɴ AG
လုံးလုံး	l AE o AM ʊ AM ɴ AG l AE o AM ʊ AM ɴ AG
လူ	l AE u AM
လူကြီး	l AE u AM d AC ʑ AJ i AL
လူငယ်	l AE u AM ŋ AG ɛ AL
လူစုလူဝေး	l AE u AM z AJ ṵ l AE u AM w AK e AL
လူဇင်ဘတ်	l AE u AM z AJ ɪ AL ɴ AG b AH a AL ʔ AC
လူတော	l AE u AM d AC ɔ AM
လူပျို	l AE u AM b AH j AB o AM
လူပျိုနာ	l AE u AM b AH j AB o AM n AG a AL
လူမျိုး	l AE u AM m AF j AB o AM
လူမျိုးစုလွှတ်တော်	l AE u AM m AF j AB o AM z AJ ṵ l̥ AE ʊ AM ʔ AC t AC ɔ AM
လူမျိုးရေးဝါဒ	l AE u AM m AF j AB o AM j AB e AL w AK a AL d AC a̰ AL
လူမှုကွန်ရက်	l AE u AM m̥ AF ṵ k AC ʊ AM ɴ AG j AB ɛ AL ʔ AC
လူဝင်မှုကြီးကြပ်ရေး	l AE u AM w AK ɪ AL ɴ AG m̥ AF ṵ t AC ɕ AJ i AL t AC ɕ AJ a AL ʔ AC j AB e AL
လူဝံ	l AE u AM w AK ʊ AM ɴ AG
လူသတ်မှု	l AE u AM ð AJ a AL ʔ AC m̥ AF ṵ
လူသား	l AE u AM ð AJ a AL
လူဦးရေ	l AE u AM ʔ AC u AM j AB e AL
လူ့ဘောင်	l AE ṵ b AH a AL ʊ AM ɴ AG
လူ့အဖွဲ့အစည်း	l AE ṵ ʔ AC ə AL pʰ AI w AK ɛ̰ AL ʔ AC ə AL s AJ i AL
လေ	l AE e AL
လေကတော့	l AE e AL ɡ AC ə AL d AC ɔ̰ AM
လေချဉ်တက်	l AE e AL d AC ʑ AJ ɪ AL ɴ AG t AC ɛ AL ʔ AC
လေချွန်	l AE e AL t AC ɕʰ BA ʊ AM ɴ AG
လေစုန်	l AE e AL z AJ o AM ʊ AM ɴ AG
လေဆိပ်	l AE e AL z AJ e AL ɪ AL ʔ AC
လေထိုးတံ	l AE e AL tʰ AD o AM d AC a AL ɴ AG
လေထီး	l AE e AL d AC i AL
လေထု	l AE e AL d AC ṵ
လေပွေ	l AE e AL b AH w AK e AL
လေဖိအား	l AE e AL pʰ AI ḭ ʔ AC a AL
လေဖုတ်	l AE e AL pʰ AI o AM ʊ AM ʔ AC
လေဖြတ်ရောဂါ	l AE e AL pʰ AI j AB a AL ʔ AC j AB ɔ AM ɡ AC a AL
လေမုန်တိုင်း	l AE e AL m AF o AM ʊ AM ɴ AG d AC a AL ɪ AL ɴ AG
လေယာဉ်	l AE e AL j AB ɪ AL ɴ AG
လေယာဉ်ပျံ	l AE e AL j AB ɪ AL ɴ AG b AH j AB a AL ɴ AG
လေရဟတ်	l AE e AL j AB ə AL h AA a AL ʔ AC
လေလည်	l AE e AL l AE e AL
လေသာခန်း	l AE e AL ð AJ a AL ɡ AC a AL ɴ AG
လေသာပေါက်	l AE e AL ð AJ a AL b AH a AL ʊ AM ʔ AC
လေသိုက်	l AE e AL θ AJ a AL ɪ AL ʔ AC
လေအေးစက်	l AE e AL ʔ AC e AL z AJ ɛ AL ʔ AC
လောက	l AE ɔ AM k AC a̰ AL
လောကနတ်	l AE ɔ AM k AC a̰ AL n AG a AL ʔ AC
လောကဝတ်	l AE ɔ AM ɡ AC ə AL w AK ʊ AM ʔ AC
လောက်	l AE a AL ʊ AM ʔ AC
လောင်	l AE a AL ʊ AM ɴ AG
လောင်စာ	l AE a AL ʊ AM ɴ AG z AJ a AL
လောင်း	l AE a AL ʊ AM ɴ AG
လောဘ	l AE ɔ AM b AH a̰ AL
လောလော	l AE ɔ AM l AE ɔ AM
လေ့ကျင့်	l AE ḛ t AC ɕ AJ ɪ̰ AL ɴ AG
လေ့ကျင့်ခန်း	l AE ḛ t AC ɕ AJ ɪ̰ AL ɴ AG ɡ AC a AL ɴ AG
လေ့လာ	l AE ḛ l AE a AL
လေး	l AE e AL
လေးကြိုး	l AE e AL d AC ʑ AJ o AM
လေးညှင်း	l AE e AL ɲ̊ AG ɪ AL ɴ AG
လေးညှင်းပွင့်	l AE e AL ɲ̊ AG ɪ AL ɴ AG b AH w AK ɪ̰ AL ɴ AG
လေးထောင့်	l AE e AL d AC a̰ AL ʊ AM ɴ AG
လေးလ	l AE e AL l AE a̰ AL
လေးလံ	l AE e AL l AE a AL ɴ AG
လဲ	l AE ɛ AL
လဲ့လဲ့	l AE ɛ̰ AL l AE ɛ̰ AL
လံဗား	l AE a AL ɴ AG b AH a AL
လျက်	j AB ɛ AL ʔ AC
လျားလျား	j AB a AL j AB a AL
လျောင်း	l AE j AB a AL ʊ AM ɴ AG
လျှင်	l̥ AE j AB ɪ AL ɴ AG
လျှပ်	l̥ AE j AB a AL ʔ AC
လျှပ်စစ်ဓာတ်	l̥ AE j AB a AL ʔ AC s AJ ɪ AL ʔ AC d AC a AL ʔ AC
လျှပ်စီး	l̥ AE j AB a AL ʔ AC s AJ i AL
လျှာ	ʃ AJ a AL
လျှာနာခွာနာ	ʃ AJ a AL n AG a AL kʰ AD w AK a AL n AG a AL
လျှာရည်	ʃ AJ a AL j AB i AL
လျှောက်	ʃ AJ a AL ʊ AM ʔ AC
လွတ်လပ်	l AE ʊ AM ʔ AC l AE a AL ʔ AC
လွတ်လပ်ခွင့်	l AE ʊ AM ʔ AC l AE a AL ʔ AC kʰ AD w AK ɪ̰ AL ɴ AG
လွတ်လပ်ရေးနေ့	l AE ʊ AM ʔ AC l AE a AL ʔ AC j AB e AL n AG ḛ
လွန်	l AE ʊ AM ɴ AG
လွန်ဆွဲ	l AE ʊ AM ɴ AG sʰ BA w AK ɛ AL
လွယ်	l AE w AK ɛ AL
လွိုင်ကော်	l AE w AK a AL ɪ AL ɴ AG k AC ɔ AM
လွှ	l̥ AE w AK a̰ AL
လွှတ်တော်	l̥ AE ʊ AM ʔ AC t AC ɔ AM
လွှတ်ရုံးငါးရပ်	l̥ AE ʊ AM ʔ AC j AB o AM ʊ AM ɴ AG ŋ AG a AL j AB a AL ʔ AC
လှ	l̥ AE a̰ AL
လှည့်	l̥ AE ɛ̰ AL
လှည်း	l̥ AE ɛ AL
လှည်းကူး	l̥ AE i AL k AC u AM
လှပ	l̥ AE a̰ AL p AH a̰ AL
လှပ်လှပ်	l̥ AE a AL ʔ AC l̥ AE a AL ʔ AC
လှလှ	l̥ AE a̰ AL l̥ AE a̰ AL
လှိုင်း	l̥ AE a AL ɪ AL ɴ AG
လှုပ်ရှား	l̥ AE o AM ʊ AM ʔ AC ʃ AJ a AL
လှုပ်လှုပ်	l̥ AE o AM ʊ AM ʔ AC l̥ AE o AM ʊ AM ʔ AC
လှုလှု	l̥ AE ṵ l̥ AE ṵ
လှုံ	l̥ AE o AM ʊ AM ɴ AG
လှေ	l̥ AE e AL
လှေကား	l̥ AE e AL ɡ AC a AL
လှောက်	l̥ AE a AL ʊ AM ʔ AC
လှော်ကား	l̥ AE ɔ AM ɡ AC a AL
လှေး	l̥ AE e AL
လှဲ	l̥ AE ɛ AL
လှံ	l̥ AE a AL ɴ AG
ဝ	w AK a̰ AL
ဝက်	w AK ɛ AL ʔ AC
ဝက်ကြွပ်	w AK ɛ AL ʔ AC t AC ɕ AJ ʊ AM ʔ AC
ဝက်ခြံ	w AK ɛ AL ʔ AC t AC ɕʰ BA a AL ɴ AG
ဝက်ဆီ	w AK ɛ AL ʔ AC sʰ BA i AL
ဝက်ထီး	w AK ɛ AL ʔ AC tʰ AD i AL
ဝက်ဘ်ဆိုဒ်	w AK ɛ AL ʔ AC b AH sʰ BA a AL ɪ AL ʔ AC
ဝက်မ	w AK ɛ AL ʔ AC m AF a̰ AL
ဝက်မှင်ဘီး	w AK ɛ AL ʔ AC m̥ AF ɪ AL ɴ AG b AH i AL
ဝက်ဝံ	w AK ɛ AL ʔ AC w AK ʊ AM ɴ AG
ဝက်သား	w AK ɛ AL ʔ AC θ AJ a AL
ဝက်သားချဉ်	w AK ɛ AL ʔ AC θ AJ a AL t AC ɕʰ BA ɪ AL ɴ AG
ဝက်သားတုတ်ထိုး	w AK ɛ AL ʔ AC θ AJ a AL d AC o AM ʊ AM ʔ AC tʰ AD o AM
ဝက်သားမျှစ်ချဉ်	w AK ɛ AL ʔ AC θ AJ a AL m̥ AF j AB ɪ AL ʔ AC t AC ɕʰ BA ɪ AL ɴ AG
ဝက်အူ	w AK ɛ AL ʔ AC ʔ AC u AM
ဝက်အူချောင်း	w AK ɛ AL ʔ AC ʔ AC u AM d AC ʑ AJ a AL ʊ AM ɴ AG
ဝင်	w AK ɪ AL ɴ AG
ဝင်ရိုး	w AK ɪ AL ɴ AG j AB o AM
ဝင်း	w AK ɪ AL ɴ AG
ဝစီ	w AK ə AL z AJ i AL
ဝစီကံ	w AK ə AL z AJ i AL ɡ AC a AL ɴ AG
ဝစ်ရှင်နရီ	w AK ɪ AL ʔ AC ʃ AJ ɪ AL ɴ AG n AG ə AL ɹ AB i AL
ဝဆွဲ	w AK a̰ AL sʰ BA w AK ɛ AL
ဝဇီရာ	w AK ə AL z AJ i AL j AB a AL
ဝဏ္ဏ	w AK ʊ AM ɴ AG n AG a̰ AL
ဝတီ	w AK ə AL d AC i AL
ဝတ္ထု	w AK ʊ AM ʔ AC tʰ AD ṵ
ဝတ်	w AK ʊ AM ʔ AC
ဝတ်ကျောင်း	w AK ʊ AM ʔ AC t AC ɕ AJ a AL ʊ AM ɴ AG
ဝတ်စုံ	w AK ʊ AM ʔ AC s AJ o AM ʊ AM ɴ AG
ဝတ်လုံ	w AK ʊ AM ʔ AC l AE o AM ʊ AM ɴ AG
ဝနာ	w AK ə AL n AG a AL
ဝန်	w AK ʊ AM ɴ AG
ဝန်ကြီး	w AK ʊ AM ɴ AG d AC ʑ AJ i AL
ဝန်ကြီးချုပ်	w AK ʊ AM ɴ AG d AC ʑ AJ i AL d AC ʑ AJ o AM ʊ AM ʔ AC
ဝန်ကြီးချုပ်ကတော်	w AK ʊ AM ɴ AG d AC ʑ AJ i AL d AC ʑ AJ o AM ʊ AM ʔ AC ɡ AC ə AL d AC ɔ AM
ဝန်ကြီးဌာန	w AK ʊ AM ɴ AG d AC ʑ AJ i AL tʰ AD a AL n AG a̰ AL
ဝန်ခံ	w AK ʊ AM ɴ AG kʰ AD a AL ɴ AG
ဝန်စည်စလယ်	w AK ʊ AM ɴ AG z AJ i AL z AJ ə AL l AE ɛ AL
ဝန်ထောက်	w AK ʊ AM ɴ AG d AC a AL ʊ AM ʔ AC
ဝန်ရှင်တော်	w AK ʊ AM ɴ AG ʃ AJ ɪ AL ɴ AG d AC ɔ AM
ဝပ်	w AK ʊ AM ʔ AC
ဝမ်း	w AK ʊ AM ɴ AG
ဝမ်းကျ	w AK a AL ɴ AG d AC ʑ AJ a̰ AL
ဝမ်းဆက်	w AK ʊ AM ɴ AG sʰ BA ɛ AL ʔ AC
ဝမ်းဆွဲ	w AK ʊ AM ɴ AG z AJ w AK ɛ AL
ဝမ်းတဖိုး	w AK ʊ AM ɴ AG d AC a̰ AL pʰ AI o AM
ဝမ်းနည်း	w AK a AL ɴ AG n AG e AL
ဝမ်းဘဲ	w AK ʊ AM ɴ AG b AH ɛ AL
ဝမ်းရောဂါ	w AK ʊ AM ɴ AG j AB ɔ AM ɡ AC a AL
ဝမ်းသာ	w AK ʊ AM ɴ AG θ AJ a AL
ဝယ်	w AK ɛ AL
ဝရဏဗေဒ	w AK ə AL j AB ə AL n AG a̰ AL d AC a̰ AL b AH e AL d AC a̰ AL
ဝရန်တာ	w AK ə AL ɹ AB a AL ɴ AG d AC a AL
ဝလာဟကမြင်း	w AK ə AL l AE a AL h AA ə AL k AC a̰ AL m AF j AB ɪ AL ɴ AG
ဝသန္တ	w AK a̰ AL θ AJ a AL ɴ AG t AC a̰ AL
ဝသုန္ဓရာ	w AK ə AL θ AJ o AM ʊ AM ɴ AG d AC ə AL ɹ AB a AL
ဝသုန္ဓရေ	w AK ə AL θ AJ o AM ʊ AM ɴ AG d AC ə AL ɹ AB e AL
ဝါ	w AK a AL
ဝါကျ	w AK e AL ɪ AL ʔ AC t AC ɕ AJ a̰ AL
ဝါခေါင်	w AK a AL ɡ AC a AL ʊ AM ɴ AG
ဝါဂွမ်း	w AK a AL ɡ AC w AK a AL ɴ AG
ဝါစင်္ဂ	w AK a AL z AJ ɪ AL ɴ AG ɡ AC a̰ AL
ဝါဆို	w AK a AL sʰ BA o AM
ဝါဆော	w AK a AL sʰ BA ɔ AM
ဝါဏိဇ္ဇ	w AK a AL n AG e AL ɪ AL ʔ AC z AJ a̰ AL
ဝါဏိဇ္ဇပဋိပက္ခ	w AK a AL n AG e AL ɪ AL ʔ AC z AJ a̰ AL p AH ə AL d AC ḭ p AH ɛ AL ʔ AC kʰ AD a̰ AL
ဝါဏိဇ္ဇဗေဒ	w AK a AL n AG e AL ɪ AL ʔ AC z AJ a̰ AL b AH e AL d AC a̰ AL
ဝါဒ	w AK a AL d AC a̰ AL
ဝါရှင်တန်	w AK a AL ʃ AJ ɪ AL ɴ AG t AC a AL ɴ AG
ဝါရှာ	w AK a AL ʃ AJ a AL
ဝါသနာ	w AK a AL ð AJ a̰ AL n AG a AL
ဝါသနာရှင်	w AK a AL ð AJ ə AL n AG a AL ʃ AJ ɪ AL ɴ AG
ဝါး	w AK a AL
ဝိဇယပူရ	w AK ḭ z AJ ə AL j AB a̰ AL p AH u AM ɹ AB a̰ AL
ဝိဇ္ဇာ	w AK e AL ɪ AL ʔ AC z AJ a AL
ဝိဇ္ဇာပညာ	w AK e AL ɪ AL ʔ AC z AJ a AL p AH j AB ɪ AL ɴ AG ɲ AG a AL
ဝိဇ္ဇာဘွဲ့	w AK e AL ɪ AL ʔ AC z AJ a AL b AH w AK ɛ̰ AL
ဝိညာဉ်	w AK e AL ɪ AL ɴ AG ɲ AG ɪ AL ɴ AG
ဝိတိုရိယ	w AK ḭ t AC o AM ɹ AB ḭ j AB a̰ AL
ဝိတ်	w AK e AL ɪ AL ʔ AC
ဝိတ်ချ	w AK e AL ɪ AL ʔ AC t AC ɕʰ BA a̰ AL
ဝိတ်လျှော့	w AK e AL ɪ AL ʔ AC ʃ AJ ɔ̰ AM
ဝိနည်း	w AK ḭ n AG i AL
ဝိနိစ္ဆယ	w AK ḭ n AG e AL ɪ AL ʔ AC s AJ ə AL j AB a̰ AL j AB a̰ AL
ဝိပတ္တိတရားလေးပါး	w AK ḭ p AH a AL ʔ AC t AC ḭ t AC ə AL j AB a AL l AE e AL b AH a AL
ဝိပဿနာ	w AK ḭ p AH a AL ʔ AC θ AJ ə AL n AG a AL
ဝိပဿီ	w AK ḭ p AH ə AL t AC θ AJ i AL
ဝိပဿီဘုရား	w AK ḭ p AH a AL ʔ AC θ AJ i AL pʰ AI ə AL j AB a AL
ဝိဘတ်	w AK ḭ b AH a AL ʔ AC
ဝိသေသ	w AK ḭ θ AJ e AL θ AJ a̰ AL
ဝိသေသလက္ခဏာ	w AK ḭ θ AJ e AL θ AJ a̰ AL l AE ɛ AL ʔ AC kʰ AD ə AL n AG a AL
ဝိဟာရ	w AK ḭ h AA a AL j AB a̰ AL
ဝိုက်ချ	w AK a AL ɪ AL ʔ AC t AC ɕʰ BA a̰ AL
ဝိုင်	w AK a AL ɪ AL ɴ AG
ဝိုင်ယာကြိုး	w AK a AL ɪ AL ɴ AG j AB a AL d AC ʑ AJ o AM
ဝိုင်း	w AK a AL ɪ AL ɴ AG
ဝီကီပိဒိယ	w AK i AL k AC i AL p AH ḭ d AC ḭ j AB a̰ AL
ဝီကီပီးဒီးယား	w AK i AL k AC i AL p AH i AL d AC i AL j AB a AL
ဝီစကီ	w AK i AL s AJ ə AL k AC i AL
ဝီစီ	w AK i AL s AJ i AL
ဝီရ	w AK i AL j AB a̰ AL
ဝီရိယ	w AK ə AL ɹ AB ḭ j AB a̰ AL
ဝေဒနာ	w AK e AL d AC ə AL n AG a AL
ဝေလ	w AK e AL l AE a̰ AL
ဝေလငါး	w AK e AL l AE a̰ AL ŋ AG a AL
ဝေသာလီ	w AK e AL θ AJ a AL l AE i AL
ဝေဟင်	w AK e AL h AA ɪ AL ɴ AG
ဝေါ	w AK ɔ AM
ဝေါဟာရ	w AK ɔ AM h AA a AL ɹ AB a̰ AL
ဝေါဟာရဗေဒ	θ AJ a AL ʔ AC d AC a̰ AL b AH e AL d AC a̰ AL
ဝေး	w AK e AL
ဝေးကွာ	w AK e AL k AC w AK a AL
ဝေဿ	w AK ɪ AL ʔ AC θ AJ a̰ AL
ဝေဿဘူ	w AK e AL t AC θ AJ ə AL b AH u AM
ဝေဿဘူဘုရား	w AK e AL t AC θ AJ a̰ AL b AH u AM pʰ AI ə AL j AB a AL
ဝံ	w AK ʊ AM ɴ AG
ဝံပုလွေ	w AK ʊ AM ɴ AG b AH ə AL l AE w AK e AL
ဝံသ	w AK ʊ AM ɴ AG θ AJ a̰ AL
ဝှက်	ʍ AN ɛ AL ʔ AC
ဝှေးစေ့	ʍ AN e AL z AJ ḭ
သ	θ AJ ə AL
သကာ	ð AJ ə AL ɡ AC a AL
သကုဏဗေဒ	θ AJ a̰ AL k AC ṵ n AG a̰ AL b AH e AL d AC a̰ AL
သက္ကတ	θ AJ ɛ AL ʔ AC k AC ə AL t AC a̰ AL
သက်ဆိုင်	θ AJ ɛ AL ʔ AC sʰ BA a AL ɪ AL ɴ AG
သက်တင်	θ AJ ɛ AL ʔ AC t AC ɪ AL ɴ AG
သက်တံ	θ AJ ɛ AL ʔ AC t AC a AL ɴ AG
သက်သာ	θ AJ ɛ AL ʔ AC θ AJ a AL
သက်သေ	θ AJ ɛ AL ʔ AC θ AJ e AL
သက်ဦးဆံပိုင်	θ AJ ɛ AL ʔ AC ʔ AC u AM sʰ BA a AL ɴ AG b AH a AL ɪ AL ɴ AG
သကြား	ð AJ ə AL d AC ʑ AJ a AL
သကြားလုံး	ð AJ ə AL d AC ʑ AJ a AL l AE o AM ʊ AM ɴ AG
သခွား	θ AJ ə AL kʰ AD w AK a AL
သခွားမသီး	θ AJ ə AL kʰ AD ə AL m AF a̰ AL ð AJ i AL
သင်	θ AJ ɪ AL ɴ AG
သင်ကြား	θ AJ ɪ AL ɴ AG t AC ɕ AJ a AL
သင်ခန်းစာ	θ AJ ɪ AL ɴ AG ɡ AC a AL ɴ AG z AJ a AL
သင်တုန်းဓား	θ AJ ɪ AL ɴ AG d AC o AM ʊ AM ɴ AG d AC a AL
သင်ပန်း	θ AJ ɪ AL ɴ AG b AH a AL ɴ AG
သင်ပေါင်း	θ AJ ɪ AL ɴ AG b AH a AL ʊ AM ɴ AG
သင်း	θ AJ ɪ AL ɴ AG
သင်းဝင်	θ AJ ɪ AL ɴ AG w AK ɪ AL ɴ AG
သင်္ကဒူး	θ AJ ɪ AL ɴ AG ɡ AC ə AL d AC u AM
သင်္ကန်း	θ AJ ɪ AL ɴ AG ɡ AC a AL ɴ AG
သင်္ကေတ	θ AJ ɪ AL ɴ AG k AC e AL t AC a̰ AL
သင်္ကြန်	θ AJ ɪ AL ɴ AG d AC ʑ AJ a AL ɴ AG
သင်္ကြန်ထမင်း	ð AJ ə AL d AC ʑ AJ a AL ɴ AG tʰ AD ə AL m AF ɪ AL ɴ AG
သင်္ကြန်မိုး	θ AJ ɪ AL ɴ AG d AC ʑ AJ a AL ɴ AG m AF o AM
သင်္ချာ	θ AJ ɪ AL ɴ AG t AC ɕʰ BA a AL
သင်္ချိုင်း	θ AJ ɪ AL ɴ AG d AC ʑ AJ a AL ɪ AL ɴ AG
သင်္ဂဟ	θ AJ ɪ̰ AL ɴ AG ɡ AC ə AL h AA a̰ AL
သင်္ဂဟတရားလေးပါး	θ AJ ɪ AL ɴ AG ɡ AC a̰ AL h AA a̰ AL t AC a̰ AL j AB a AL l AE e AL p AH a AL
သင်္ဘော	θ AJ ɪ AL ɴ AG b AH ɔ AM
သင်္ဘောကြမ်း	θ AJ ɪ AL ɴ AG b AH ɔ AM d AC ʑ AJ a AL ɴ AG
သင်္ဘောဆိပ်	θ AJ ɪ AL ɴ AG b AH ɔ AM z AJ e AL ɪ AL ʔ AC
သင်္ဘောမညှိုးပန်း	θ AJ ɪ AL ɴ AG b AH ɔ AM m AF ə AL ɲ̊ AG o AM b AH a AL ɴ AG
သင်္ဘောသီး	θ AJ ɪ AL ɴ AG b AH ɔ AM ð AJ i AL
သင်္ဘောသီးသုပ်	θ AJ ɪ AL ɴ AG b AH ɔ AM θ AJ i AL θ AJ o AM ʊ AM ʔ AC
သင်္သကရိုက်	θ AJ ɪ AL ɴ AG θ AJ ə AL k AC ə AL ɹ AB a AL ɪ AL ʔ AC
သစ္စာ	θ AJ ɪ AL ʔ AC s AJ a AL
သစ္စာဖောက်	θ AJ ɪ AL ʔ AC s AJ a AL pʰ AI a AL ʊ AM ʔ AC
သစ္စာလေးပါး	θ AJ ɪ AL ʔ AC s AJ a AL l AE e AL p AH a AL
သစ်	θ AJ ɪ AL ʔ AC
သစ်ကတိုး	θ AJ ɪ AL ʔ AC ɡ AC ə AL d AC o AM
သစ်ကုလားအုတ်	θ AJ ɪ AL ʔ AC k AC ə AL l AE ə AL ʔ AC o AM ʊ AM ʔ AC
သစ်ကျုတ်	θ AJ ɪ AL ʔ AC t AC ɕ AJ o AM ʊ AM ʔ AC
သစ်ကြံပိုး	θ AJ ɪ AL ʔ AC d AC ʑ AJ ə AL b AH o AM
သစ်စေး	s AJ ɪ AL ʔ AC s AJ i AL
သစ်ဆိမ့်	θ AJ ɪ AL ʔ AC sʰ BA ḛ ɪ AL ɴ AG
သစ်တို	θ AJ ɪ AL ʔ AC t AC o AM
သစ်တော	θ AJ ɪ AL ʔ AC t AC ɔ AM
သစ်ပင်	θ AJ ɪ AL ʔ AC p AH ɪ AL ɴ AG
သစ်ပုပ်	θ AJ ɪ AL ʔ AC p AH o AM ʊ AM ʔ AC
သစ်ဖြူ	θ AJ ɪ AL ʔ AC pʰ AI j AB u AM
သစ်သစ်	θ AJ ɪ AL ʔ AC θ AJ ɪ AL ʔ AC
သစ်သီး	θ AJ ɪ AL ʔ AC θ AJ i AL
သစ်သီးရည်	θ AJ ɪ AL ʔ AC θ AJ i AL j AB e AL
သဇင်	ð AJ ə AL z AJ ɪ AL ɴ AG
သဉ္ဇာ	θ AJ ɪ AL ɴ AG z AJ a AL
သဉ္ဇာလီ	θ AJ ɪ AL ɴ AG z AJ a AL l AE i AL
သည့်	θ AJ ḭ
သည်	θ AJ e AL
သည်မှာ	ð AJ i AL m̥ AF a AL
သည်း	θ AJ i AL
သည်းခြေ	θ AJ i AL d AC ʑ AJ e AL
သဏ္ဍာန်	θ AJ ə AL d AC a AL ɴ AG
သတင်း	ð AJ a̰ AL d AC ɪ AL ɴ AG
သတင်းစာ	ð AJ ə AL d AC ɪ AL ɴ AG z AJ a AL
သတင်းစာဆရာ	ð AJ ə AL d AC ɪ AL ɴ AG z AJ a AL sʰ BA ə AL j AB a AL
သတင်းပို့	ð AJ ə AL d AC ɪ AL ɴ AG p AH o̰ AM
သတို့သမီး	ð AJ ə AL d AC o̰ AM θ AJ ə AL m AF i AL
သတို့သား	ð AJ ə AL d AC o̰ AM θ AJ a AL
သတ္တဗေဒ	θ AJ a AL ʔ AC t AC a̰ AL b AH e AL d AC a̰ AL
သတ္တမ	θ AJ a AL ʔ AC t AC ə AL m AF a̰ AL
သတ္တဝါ	θ AJ a AL ʔ AC t AC ə AL w AK a AL
သတ္တိ	θ AJ a AL ʔ AC t AC ḭ
သတ္တု	θ AJ a AL ʔ AC t AC ṵ
သတ္တုစပ်	θ AJ a AL ʔ AC t AC ṵ z AJ a AL ʔ AC
သတ္တုတွင်း	θ AJ a AL ʔ AC t AC ṵ d AC w AK ɪ AL ɴ AG
သတ္တုဗေဒ	θ AJ a AL ʔ AC t AC ṵ b AH e AL d AC a̰ AL
သတ္တုရိုင်း	θ AJ a AL ʔ AC t AC ṵ j AB a AL ɪ AL ɴ AG
သတ္ထန္တရကပ်	θ AJ a AL ʔ AC tʰ AD a AL ɴ AG t AC ə AL ɹ AB a̰ AL k AC a AL ʔ AC
သတ်	θ AJ a AL ʔ AC
သတ်ဖြတ်	θ AJ a AL ʔ AC pʰ AI j AB a AL ʔ AC
သဒ္ဒဗေဒ	θ AJ a AL ʔ AC d AC a̰ AL b AH e AL d AC a̰ AL
သဒ္ဒါ	ð AJ ə AL d AC a AL
သဒ္ဒါဆယ်ပါး	ð AJ ə AL d AC a AL sʰ BA ɛ AL b AH a AL
သဒ္ဓါ	θ AJ a AL d AC d AC a AL
သဒ္ဓါကြေး	θ AJ ə AL d AC a AL t AC ɕ AJ e AL
သနပ်	θ AJ ə AL n AG a AL ʔ AC
သနပ်ခါး	θ AJ ə AL n AG ə AL kʰ AD a AL
သန္တာ	θ AJ a AL ɴ AG d AC a AL
သန္ဓေ	θ AJ a AL ɴ AG d AC e AL
သန္ဓေဗေဒ	θ AJ a AL ɴ AG d AC e AL b AH e AL d AC a̰ AL
သန္ဓေသား	ð AJ ə AL d AC e AL ð AJ a AL
သန်ကောင်	θ AJ a AL ɴ AG ɡ AC a AL ʊ AM ɴ AG
သန်တူ	θ AJ a AL ɴ AG t AC u AM
သန်လျက်	θ AJ a AL ɴ AG j AB ɛ AL ʔ AC
သန်လျင်	θ AJ ə AL ɲ AG ɪ AL ɴ AG
သန်လျင်း	θ AJ a AL ɴ AG l AE ə AL j AB ɪ AL ɴ AG
သန်လျင်းချိတ်	θ AJ a AL ɴ AG j AB ɪ AL ɴ AG d AC ʑ AJ e AL ɪ AL ʔ AC
သန်း	θ AJ a AL ɴ AG
သန်းခေါင်	ð AJ ə AL ɡ AC a AL ʊ AM ɴ AG
သပိတ်	ð AJ ə AL b AH e AL ɪ AL ʔ AC
သပ်	θ AJ a AL ʔ AC
သပြု	ð AJ ə AL b AH j AB ṵ
သပြေ	ð AJ ə AL b AH j AB e AL
သဘက်ခါ	θ AJ ə AL b AH ɛ AL ʔ AC kʰ AD a AL
သဘာပတိ	θ AJ ə AL b AH a AL p AH ə AL t AC ḭ
သဘာဝ	ð AJ ə AL b AH a AL w AK a̰ AL
သဘာဝတ္ထဗေဒ	θ AJ ə AL b AH a AL w AK ʊ AM ʔ AC tʰ AD a̰ AL b AH e AL d AC a̰ AL
သဘော	ð AJ ə AL b AH ɔ AM
သဘောတူ	ð AJ ə AL b AH ɔ AM t AC u AM
သမက်	θ AJ ə AL m AF ɛ AL ʔ AC
သမဂ္ဂ	θ AJ a̰ AL m AF ɛ AL ʔ AC ɡ AC a̰ AL
သမင်	θ AJ ə AL m AF ɪ AL ɴ AG
သမင်မ	θ AJ ə AL m AF ɪ AL ɴ AG m AF a̰ AL
သမာသမတ်	θ AJ ə AL m AF a AL θ AJ ə AL m AF a AL ʔ AC
သမား	θ AJ ə AL m AF a AL
သမိန်	θ AJ ə AL m AF e AL ɪ AL ɴ AG
သမိုင်း	θ AJ ə AL m AF a AL ɪ AL ɴ AG
သမီး	θ AJ ə AL m AF i AL
သမုဒ္ဒရာ	θ AJ ə AL m AF o AM ʊ AM ʔ AC d AC ə AL j AB a AL
သမ္ဗန္ဓ	θ AJ a AL ɴ AG b AH a AL ɴ AG d AC a̰ AL
သမ္မတ	θ AJ ə AL m AF ə AL d AC a̰ AL
သမ္မတကတော်	θ AJ ə AL m AF a̰ AL d AC a̰ AL ɡ AC ə AL d AC ɔ AM
သမ္မတနိုင်ငံ	θ AJ ə AL m AF ə AL d AC a̰ AL n AG a AL ɪ AL ɴ AG ŋ AG a AL ɴ AG
သမ္မာကျမ်း	θ AJ ə AL m AF a AL t AC ɕ AJ a AL ɴ AG
သမ်း	θ AJ a AL ɴ AG
သယ်	θ AJ ɛ AL
သရ	θ AJ ə AL ɹ AB a̰ AL
သရက်	θ AJ ə AL j AB ɛ AL ʔ AC
သရက်ရွက်	θ AJ ə AL j AB ɛ AL ʔ AC j AB w AK ɛ AL ʔ AC
သရက်သီးသနပ်	θ AJ ə AL j AB ɛ AL ʔ AC θ AJ i AL θ AJ a̰ AL n AG a AL ʔ AC
သရဏဂုံသုံးပါး	θ AJ ə AL j AB ə AL n AG ə AL ɡ AC o AM ʊ AM ɴ AG θ AJ o AM ʊ AM ɴ AG b AH a AL
သရဏင်္ကရာ	θ AJ ə AL ɹ AB ə AL n AG ɪ AL ɴ AG k AC ə AL ɹ AB a AL
သရဏင်္ကရာဘုရား	θ AJ ə AL ɹ AB ə AL n AG ɪ AL ɴ AG k AC ə AL ɹ AB a AL pʰ AI ə AL j AB a AL
သရဖူ	θ AJ ə AL ɹ AB ə AL pʰ AI u AM
သရီရ	θ AJ ə AL ɹ AB i AL ɹ AB a̰ AL
သရုပ်	θ AJ ə AL j AB o AM ʊ AM ʔ AC
သရုပ်ဆောင်	θ AJ ə AL j AB o AM ʊ AM ʔ AC sʰ BA a AL ʊ AM ɴ AG
သရုပ်ဖော်	θ AJ ə AL j AB o AM ʊ AM ʔ AC pʰ AI ɔ AM
သရဲ	θ AJ ə AL j AB ɛ AL
သလား	θ AJ a̰ AL l AE a AL
သလိပ်	θ AJ ə AL l AE e AL ɪ AL ʔ AC
သလုံး	θ AJ ə AL l AE o AM ʊ AM ɴ AG
သလဲသီး	θ AJ ə AL l AE ɛ AL θ AJ i AL
သလွဲ	θ AJ ə AL l AE w AK ɛ AL
သဝဏ်လွှာ	θ AJ ə AL w AK ʊ AM ɴ AG l̥ AE w AK a AL
သာဂူ	θ AJ a AL ɡ AC u AM
သာဂူပြင်	θ AJ a AL ɡ AC u AM b AH j AB ɪ AL ɴ AG
သာဓက	θ AJ a AL d AC a̰ AL k AC a̰ AL
သာဓု	θ AJ a AL d AC ṵ
သာမဏေ	θ AJ a AL m AF ə AL n AG e AL
သာမိုမီတာ	θ AJ a AL m AF o AM m AF i AL t AC a AL
သာယာဝတီ	θ AJ a AL j AB a AL w AK ə AL d AC i AL
သာရိပုတ္တရာ	θ AJ a AL j AB ḭ p AH o AM ʊ AM ʔ AC t AC ə AL j AB a AL
သာဝက	θ AJ a AL w AK ə AL k AC a̰ AL
သာဝတ္ထိ	θ AJ a AL w AK ʊ AM ʔ AC tʰ AD ḭ
သာသနာ	θ AJ a AL ð AJ ə AL n AG a AL
သာသနာ့အာဇာနည်	θ AJ a AL θ AJ ə AL n AG a̰ AL ʔ AC a AL z AJ a AL n AG i AL
သား	θ AJ a AL
သားကြီး	θ AJ a AL d AC ʑ AJ i AL
သားပိုက်ကောင်	θ AJ a AL b AH a AL ɪ AL ʔ AC k AC a AL ʊ AM ɴ AG
သားမြီးယပ်	θ AJ a AL m AF j AB i AL j AB a AL ʔ AC
သားရေ	θ AJ ə AL j AB e AL
သားလောင်း	θ AJ a AL l AE a AL ʊ AM ɴ AG
သားလှောင်	θ AJ a AL l̥ AE a AL ʊ AM ɴ AG
သားသတ်ရုံ	θ AJ a AL ð AJ a AL ʔ AC j AB o AM ʊ AM ɴ AG
သားအိမ်	θ AJ ə AL ʔ AC e AL ɪ AL ɴ AG
သားအိမ်ခေါင်း	θ AJ ə AL ʔ AC e AL ɪ AL ɴ AG ɡ AC a AL ʊ AM ɴ AG
သားအိမ်လမ်းကြောင်း	θ AJ ə AL ʔ AC e AL ɪ AL ɴ AG l AE a AL ɴ AG d AC ʑ AJ a AL ʊ AM ɴ AG
သားဥ	θ AJ a AL ʔ AC ṵ
သားဥအိမ်	θ AJ a AL ʔ AC ṵ ʔ AC e AL ɪ AL ɴ AG
သိ	θ AJ ḭ
သိက္ခါ	θ AJ e AL ɪ AL ʔ AC kʰ AD a AL
သိကြား	ð AJ ə AL d AC ʑ AJ a AL
သိခီဘုရား	θ AJ ḭ kʰ AD i AL pʰ AI ə AL j AB a AL
သိင်္ဂီ	θ AJ e AL ɪ AL ɴ AG ɡ AC i AL
သိထိလ	θ AJ ḭ tʰ AD ḭ l AE a̰ AL
သိဒ္ဓတ္ထ	θ AJ e AL ɪ AL ʔ AC d AC a AL ʔ AC tʰ AD a̰ AL
သိဒ္ဓတ္ထဘုရား	θ AJ i AL d AC d AC a AL ʔ AC tʰ AD a̰ AL pʰ AI ə AL j AB a AL
သိဒ္ဓတ်မင်း	θ AJ e AL ɪ AL ʔ AC d AC a AL ʔ AC m AF ɪ AL ɴ AG
သိဒ္ဓိ	θ AJ e AL ɪ AL ʔ AC d AC ḭ
သိန်း	θ AJ e AL ɪ AL ɴ AG
သိပ္ပံ	θ AJ e AL ɪ AL ʔ AC p AH a AL ɴ AG
သိပ္ပံဘွဲ့	θ AJ e AL ɪ AL ʔ AC p AH a AL ɴ AG b AH w AK ɛ̰ AL
သိပ်	θ AJ e AL ɪ AL ʔ AC
သိမ်	θ AJ e AL ɪ AL ɴ AG
သိရှိ	θ AJ ḭ ʃ AJ ḭ
သိဝ	θ AJ ḭ w AK a̰ AL
သိုက်	θ AJ a AL ɪ AL ʔ AC
သို့ပေမဲ့	ð AJ o̰ AM b AH e AL m AF ɛ̰ AL
သို့မဟုတ်	ð AJ o̰ AM m AF ə AL h AA o AM ʊ AM ʔ AC
သို့ရာတွင်	ð AJ o̰ AM j AB a AL d AC w AK ɪ AL ɴ AG
သို့သော်	ð AJ o̰ AM ð AJ ɔ AM
သိုး	θ AJ o AM
သိုးဆောင်း	θ AJ o AM sʰ BA a AL ʊ AM ɴ AG
သိုးထိန်း	θ AJ o AM d AC e AL ɪ AL ɴ AG
သိုးထီး	θ AJ o AM d AC i AL
သိုးမ	θ AJ o AM m AF a̰ AL
သိုးမွေး	θ AJ o AM m AF w AK e AL
သိုးအုပ်	θ AJ o AM ʔ AC o AM ʊ AM ʔ AC
သီချင်း	θ AJ ə AL t AC ɕʰ BA ɪ AL ɴ AG
သီဂိရိယ	θ AJ i AL ɡ AC ḭ ɹ AB ḭ j AB a̰ AL
သီတဂူ	θ AJ i AL d AC ə AL ɡ AC u AM
သီတင်း	ð AJ ə AL d AC ɪ AL ɴ AG
သီတင်းကျွတ်	ð AJ ə AL d AC ɪ AL ɴ AG d AC ʑ AJ ʊ AM ʔ AC
သီတင်းသီလ	ð AJ ə AL d AC ɪ AL ɴ AG θ AJ i AL l AE a̰ AL
သီတာ	θ AJ i AL d AC a AL
သီတာဒေဝီ	θ AJ i AL d AC a AL d AC e AL w AK i AL
သီရိ	θ AJ i AL ɹ AB ḭ
သီရိလင်္ကာ	θ AJ i AL ɹ AB ḭ l AE ɪ AL ɴ AG k AC a AL
သီလ	θ AJ i AL l AE a̰ AL
သီလရှင်	θ AJ i AL l AE a̰ AL ʃ AJ ɪ AL ɴ AG
သီဟ	θ AJ i AL h AA a̰ AL
သီဟိုဠ်	θ AJ i AL h AA o AM
သီဟိုဠ်သရက်	θ AJ i AL h AA o AM θ AJ ə AL j AB ɛ AL ʔ AC
သီအိုရီ	θ AJ i AL ʔ AC o AM ɹ AB i AL
သီး	θ AJ i AL
သီးစုံချဉ်ရည်	θ AJ i AL z AJ o AM ʊ AM ɴ AG t AC ɕʰ BA ɪ AL ɴ AG j AB i AL
သီးပင်	θ AJ i AL b AH ɪ AL ɴ AG
သီးသီး	θ AJ i AL ð AJ i AL
သု	θ AJ ṵ
သုက်	θ AJ o AM ʊ AM ʔ AC
သုက်ကောင်	θ AJ o AM ʊ AM ʔ AC k AC a AL ʊ AM ɴ AG
သုက်ပိုး	θ AJ o AM ʊ AM ʔ AC p AH o AM
သုက်ရည်	θ AJ o AM ʊ AM ʔ AC j AB e AL
သုခ	θ AJ ṵ kʰ AD a̰ AL
သုခေါဒယ	θ AJ ṵ kʰ AD ɔ AM d AC ə AL j AB a̰ AL
သုဇာတဘုရား	θ AJ ṵ z AJ a AL t AC a̰ AL pʰ AI ə AL j AB a AL
သုည	θ AJ o AM ʊ AM ɴ AG ɲ AG a̰ AL
သုတ	θ AJ ṵ t AC a̰ AL
သုတေသန	θ AJ ṵ t AC e AL θ AJ ə AL n AG a̰ AL
သုတေသီ	θ AJ ṵ t AC e AL θ AJ i AL
သုတ်	θ AJ o AM ʊ AM ʔ AC
သုဒ္ဒ	θ AJ o AM ʊ AM ʔ AC d AC a̰ AL
သုဒ္ဒကိန်း	θ AJ o AM ʊ AM ʔ AC d AC a̰ AL k AC e AL ɪ AL ɴ AG
သုဒ္ဒကြိယာ	θ AJ o AM ʊ AM ʔ AC d AC a̰ AL k AC ə AL ɹ AB ḭ j AB a AL
သုဒ္ဓေါဒန	θ AJ u AM d AC d AC ɔ AM d AC ə AL n AG a̰ AL
သုဓမ္မပူရ	θ AJ ṵ d AC ə AL m AF a̰ AL p AH u AM ɹ AB a̰ AL
သုဓမ္မသိင်္ဂီ	θ AJ ṵ d AC a AL ɴ AG m AF a̰ AL θ AJ e AL ɪ AL ɴ AG ɡ AC i AL
သုဓာ	θ AJ o AM ʊ AM ʔ AC d AC a AL
သုပ်	θ AJ o AM ʊ AM ʔ AC
သုမန	θ AJ ṵ m AF ə AL n AG a̰ AL
သုမနဘုရား	θ AJ ṵ m AF ə AL n AG a̰ AL pʰ AI ə AL j AB a AL
သုမေဓာ	θ AJ ṵ m AF e AL d AC a AL
သုမေဓာဘုရား	θ AJ ṵ m AF e AL d AC a AL pʰ AI ə AL j AB a AL
သုဝဏ္ဏ	θ AJ ṵ w AK ʊ AM ɴ AG n AG a̰ AL
သုသာန်	θ AJ o AM ʊ AM ʔ AC θ AJ a AL ɴ AG
သုံး	θ AJ o AM ʊ AM ɴ AG
သုံးဆယ်	θ AJ o AM ʊ AM ɴ AG sʰ BA ɛ AL
သုံးဆောင်	θ AJ o AM ʊ AM ɴ AG sʰ BA a AL ʊ AM ɴ AG
သုံးလ	θ AJ o AM ʊ AM ɴ AG l AE a̰ AL
သူ	θ AJ u AM
သူကောင်	θ AJ u AM ɡ AC a AL ʊ AM ɴ AG
သူကောင်တင်	θ AJ u AM ɡ AC a AL ʊ AM ɴ AG d AC ɪ AL ɴ AG
သူကောင်း	θ AJ u AM ɡ AC a AL ʊ AM ɴ AG
သူကောင်းပြု	θ AJ u AM ɡ AC a AL ʊ AM ɴ AG p AH j AB ṵ
သူကောင်းမြှောက်	θ AJ u AM ɡ AC a AL ʊ AM ɴ AG m̥ AF j AB a AL ʊ AM ʔ AC
သူကောင်းသား	θ AJ u AM ɡ AC a AL ʊ AM ɴ AG ð AJ a AL
သူကျက်	θ AJ u AM d AC ʑ AJ ɛ AL ʔ AC
သူကြီး	θ AJ u AM d AC ʑ AJ i AL
သူကြွယ်	θ AJ u AM t AC ɕ AJ w AK ɛ AL
သူခိုး	θ AJ ə AL kʰ AD o AM
သူငယ်	θ AJ ə AL ŋ AG ɛ AL
သူငယ်ချင်း	θ AJ ə AL ŋ AG ɛ AL d AC ʑ AJ ɪ AL ɴ AG
သူငယ်တန်း	θ AJ u AM ŋ AG ɛ AL d AC a AL ɴ AG
သူငယ်မ	θ AJ ə AL ŋ AG ɛ AL m AF a̰ AL
သူစိမ်း	ð AJ ə AL z AJ e AL ɪ AL ɴ AG
သူစိမ်းတစ်ရံဆံ	ð AJ ə AL z AJ e AL ɪ AL ɴ AG t AC ə AL j AB a AL ɴ AG z AJ a AL ɴ AG
သူဆင်းရဲ	θ AJ u AM sʰ BA ɪ AL ɴ AG j AB ɛ AL
သူဇာ	θ AJ u AM z AJ a AL
သူဌေး	θ AJ ə AL tʰ AD e AL
သူတကာ	θ AJ u AM d AC ə AL ɡ AC a AL
သူတစ်ခွန်းငါတစ်ခွန်း	θ AJ u AM t AC ə AL kʰ AD ʊ AM ɴ AG ŋ AG a AL t AC ə AL kʰ AD ʊ AM ɴ AG
သူတစ်ထူး	θ AJ u AM t AC ə AL tʰ AD u AM
သူတစ်ပါး	θ AJ u AM d AC ə AL b AH a AL
သူတစ်ပြန်ငါတစ်ပြန်	θ AJ u AM d AC ə AL b AH j AB a AL ɴ AG ŋ AG a AL d AC ə AL b AH j AB a AL ɴ AG
သူတစ်လူငါတစ်မင်း	θ AJ u AM t AC ə AL l AE u AM ŋ AG a AL t AC ə AL m AF ɪ AL ɴ AG
သူတို့	θ AJ u AM d AC o̰ AM
သူတောင်းစား	ð AJ ə AL d AC a AL ʊ AM ɴ AG z AJ a AL
သူတော်	θ AJ u AM d AC ɔ AM
သူတော်ကောင်း	θ AJ u AM d AC ɔ AM ɡ AC a AL ʊ AM ɴ AG
သူတော်စင်	θ AJ u AM d AC ɔ AM z AJ ɪ AL ɴ AG
သူတော်သူမြတ်	θ AJ u AM d AC ɔ AM θ AJ u AM m AF j AB a AL ʔ AC
သူနာ	θ AJ u AM n AG a AL
သူနာတင်ကား	θ AJ u AM n AG a AL t AC ɪ AL ɴ AG k AC a AL
သူနာတင်ယာဉ်	θ AJ u AM n AG a AL t AC ɪ AL ɴ AG j AB ɪ AL ɴ AG
သူနာပြု	θ AJ u AM n AG a AL b AH j AB ṵ
သူနိုင်ငါညှဉ်းလုပ်	θ AJ u AM n AG a AL ɪ AL ɴ AG ŋ AG a AL ɲ̊ AG ɪ AL ɴ AG l AE o AM ʊ AM ʔ AC
သူပုန်	ð AJ ə AL b AH o AM ʊ AM ɴ AG
သူပုန်ထ	ð AJ ə AL b AH o AM ʊ AM ɴ AG tʰ AD a̰ AL
သူပုန်သူကန်	ð AJ ə AL b AH ə AL ð AJ u AM ɡ AC a AL ɴ AG
သူပြောငါပြော	θ AJ u AM p AH j AB ɔ AM ŋ AG a AL p AH j AB ɔ AM
သူဖုန်းစား	θ AJ u AM pʰ AI o AM ʊ AM ɴ AG s AJ a AL
သူမ	θ AJ u AM m AF a̰ AL
သူမသာကိုယ်မသာ	θ AJ u AM m AF ə AL θ AJ a AL k AC o AM j AB m AF ə AL θ AJ a AL
သူမသာငါမသာ	θ AJ u AM m AF ə AL θ AJ a AL ŋ AG a AL m AF ə AL θ AJ a AL
သူမိုက်	θ AJ u AM m AF a AL ɪ AL ʔ AC
သူများ	θ AJ u AM m AF j AB a AL
သူများနည်းတူ	θ AJ u AM m AF j AB a AL n AG i AL t AC u AM
သူယုတ်မာ	θ AJ u AM j AB o AM ʊ AM ʔ AC m AF a AL
သူယောင်	θ AJ u AM j AB a AL ʊ AM ɴ AG
သူယောင်မယ်	θ AJ u AM j AB a AL ʊ AM ɴ AG m AF ɛ AL
သူရ	θ AJ u AM j AB a̰ AL
သူရကန်	θ AJ u AM ɹ AB ə AL k AC a AL ɴ AG
သူရင်းငှား	θ AJ ə AL j AB ɪ AL ɴ AG ŋ̊ AG a AL
သူရင်းတိုင်	θ AJ ə AL j AB ɪ AL ɴ AG d AC a AL ɪ AL ɴ AG
သူရသတ္တိ	θ AJ u AM j AB a̰ AL θ AJ a AL ʔ AC t AC ḭ
သူရိန်	θ AJ u AM j AB e AL ɪ AL ɴ AG
သူရိယမာသ	θ AJ u AM ɹ AB ḭ j AB a̰ AL m AF a AL θ AJ a̰ AL
သူရဲ	θ AJ ə AL j AB ɛ AL
သူရဲကောင်း	θ AJ u AM j AB ɛ AL ɡ AC a AL ʊ AM ɴ AG
သူရဲကြီး	θ AJ u AM j AB ɛ AL d AC ʑ AJ i AL
သူရဲကြီးအလံ	θ AJ u AM j AB ɛ AL d AC ʑ AJ i AL ʔ AC ə AL l AE a AL ɴ AG
သူရဲခို	θ AJ ə AL j AB ɛ AL kʰ AD o AM
သူရဲပြေး	θ AJ ə AL j AB ɛ AL p AH j AB e AL
သူရဲဘောကြောင်	θ AJ ə AL j AB ɛ AL b AH ɔ AM d AC ʑ AJ a AL ʊ AM ɴ AG
သူရဲဘောနည်း	θ AJ ə AL j AB ɛ AL b AH ɔ AM n AG i AL
သူရဿတီ	θ AJ u AM ɹ AB a̰ AL θ AJ ə AL t AC i AL
သူလိုငါလို	θ AJ u AM l AE o AM ŋ AG a AL l AE o AM
သူလျှို	ð AJ ə AL ʃ AJ o AM
သူသူငါငါ	θ AJ u AM θ AJ u AM ŋ AG a AL ŋ AG a AL
သူသေ	θ AJ u AM θ AJ e AL
သူဟောင်းစကား	θ AJ u AM h AA a AL ʊ AM ɴ AG z AJ ə AL ɡ AC a AL
သူအို	θ AJ u AM ʔ AC o AM
သူ့	θ AJ ṵ
သေ	θ AJ e AL
သေခြင်း	θ AJ e AL d AC ʑ AJ ɪ AL ɴ AG
သေတ္တာ	θ AJ ɪ AL ʔ AC t AC a AL
သေနတ်	θ AJ ə AL n AG a AL ʔ AC
သော	θ AJ ɔ AM
သောက္ကတဲ	θ AJ a AL ʊ AM ʔ AC k AC ə AL t AC ɛ AL
သောက်	θ AJ a AL ʊ AM ʔ AC
သောကြာ	θ AJ a AL ʊ AM ʔ AC t AC ɕ AJ a AL
သောကြာဂြိုဟ်	θ AJ a AL ʊ AM ʔ AC t AC ɕ AJ a AL d AC ʑ AJ o AM
သောင်း	θ AJ a AL ʊ AM ɴ AG
သောင်းသောင်း	θ AJ a AL ʊ AM ɴ AG ð AJ a AL ʊ AM ɴ AG
သောဘိတ	θ AJ ɔ AM b AH ḭ t AC a̰ AL
သောဘိတဘုရား	θ AJ ɔ AM b AH ḭ t AC a̰ AL pʰ AI ə AL j AB a AL
သောမနဿ	θ AJ ɔ AM m AF ə AL n AG a AL ʔ AC θ AJ a̰ AL
သောသော	θ AJ ɔ AM ð AJ ɔ AM
သော့	θ AJ ɔ̰ AM
သော့တံ	θ AJ ɔ̰ AM d AC a AL ɴ AG
သော်	ð AJ ɔ AM
သော်တာ	θ AJ ɔ AM d AC a AL
သေး	θ AJ e AL
သဲ	θ AJ ɛ AL
သဲကန္တာရ	θ AJ e AL ɡ AC a AL ɴ AG d AC a AL j AB a̰ AL
သဲကျောက်	θ AJ ɛ AL d AC ʑ AJ a AL ʊ AM ʔ AC
သဲ့သဲ့	θ AJ ɛ̰ AL ð AJ ɛ̰ AL
သံ	θ AJ a AL ɴ AG
သံကြိုး	θ AJ a AL ɴ AG d AC ʑ AJ o AM
သံကြိုးစာ	θ AJ a AL ɴ AG d AC ʑ AJ o AM z AJ a AL
သံကြွပ်	θ AJ a AL ɴ AG d AC ʑ AJ ʊ AM ʔ AC
သံချပ်	θ AJ ə AL d AC ʑ AJ a AL ʔ AC
သံချေး	θ AJ a AL ɴ AG d AC ʑ AJ i AL
သံခွာ	θ AJ a AL ɴ AG kʰ AD w AK a AL
သံဃာ	θ AJ a AL ɴ AG ɡ AC a AL
သံစုံတီးဝိုင်း	θ AJ a AL ɴ AG z AJ o AM ʊ AM ɴ AG t AC i AL w AK a AL ɪ AL ɴ AG
သံတမန်	θ AJ a AL ɴ AG t AC ə AL m AF a AL ɴ AG
သံတော်ဆင့်	θ AJ a AL ɴ AG d AC ɔ AM z AJ ɪ̰ AL ɴ AG
သံတွဲ	θ AJ a AL ɴ AG d AC w AK ɛ AL
သံပန်း	θ AJ a AL ɴ AG b AH a AL ɴ AG
သံပရာ	θ AJ a AL ɴ AG b AH ə AL j AB a AL
သံပရို	θ AJ a AL ɴ AG b AH a̰ AL j AB o AM
သံပေါက်	θ AJ a AL ɴ AG b AH a AL ʊ AM ʔ AC
သံပြိုင်	θ AJ a AL ɴ AG b AH j AB a AL ɪ AL ɴ AG
သံဖြူ	θ AJ a AL ɴ AG b AH j AB u AM
သံမဏိ	θ AJ a AL ɴ AG m AF ə AL n AG ḭ
သံရုံး	θ AJ a AL ɴ AG j AB o AM ʊ AM ɴ AG
သံလမ်း	θ AJ a AL ɴ AG l AE a AL ɴ AG
သံလမ်းရထား	θ AJ a AL ɴ AG l AE a AL ɴ AG j AB ə AL tʰ AD a AL
သံလိုက်	θ AJ a AL ɴ AG l AE a AL ɪ AL ʔ AC
သံလိုက်စက်ကွင်း	θ AJ a AL ɴ AG l AE a AL ɪ AL ʔ AC s AJ ɛ AL ʔ AC k AC w AK ɪ AL ɴ AG
သံလွင်	θ AJ a AL ɴ AG l AE w AK ɪ AL ɴ AG
သံဝါသ	θ AJ a AL ɴ AG w AK a AL θ AJ a̰ AL
သံသယ	θ AJ a AL ɴ AG θ AJ ə AL j AB a̰ AL
သံအမတ်	θ AJ a AL ɴ AG ʔ AC ə AL m AF a AL ʔ AC
သံ့သံ့	θ AJ a̰ AL ɴ AG ð AJ a̰ AL ɴ AG
သျှင်	ʃ AJ ɪ AL ɴ AG
သျှမ်း	ʃ AJ a AL ɴ AG
သျှောင်	j AB a AL ʊ AM ɴ AG
သွင်သွင်	θ AJ w AK ɪ AL ɴ AG ð AJ w AK ɪ AL ɴ AG
သွင်း	θ AJ w AK ɪ AL ɴ AG
သွတ်သွတ်	θ AJ ʊ AM ʔ AC θ AJ ʊ AM ʔ AC
သွန်းသွန်း	θ AJ ʊ AM ɴ AG ð AJ ʊ AM ɴ AG
သွပ်	θ AJ ʊ AM ʔ AC
သွား	θ AJ w AK a AL
သွားကြားထိုးတံ	θ AJ w AK a AL d AC ʑ AJ a AL tʰ AD o AM d AC a AL ɴ AG
သွားတိုက်ဆေး	θ AJ w AK a AL d AC a AL ɪ AL ʔ AC sʰ BA e AL
သွားပွတ်တံ	ð AJ ə AL b AH ʊ AM ʔ AC t AC a AL ɴ AG
သွားဖုံး	θ AJ ə AL pʰ AI o AM ʊ AM ɴ AG
သွားရည်	θ AJ ə AL j AB i AL
သွေ	θ AJ w AK e AL
သွေး	θ AJ w AK e AL
သွေးကြော	θ AJ w AK e AL d AC ʑ AJ ɔ AM
သွေးတိုးရောဂါ	θ AJ w AK e AL t AC o AM j AB ɔ AM ɡ AC a AL
သွေးပေါ်	θ AJ w AK e AL p AH ɔ AM
သွေးအုပ်စု	θ AJ w AK e AL ʔ AC o AM ʊ AM ʔ AC s AJ ṵ
ဟ	h AA a̰ AL
ဟင့်အင်း	h AA ɪ̰ AL ɴ AG ʔ AC ɪ AL ɴ AG
ဟင်း	h AA ɪ AL ɴ AG
ဟင်းခါး	h AA ɪ AL ɴ AG ɡ AC a AL
ဟင်းရည်	h AA ɪ AL ɴ AG j AB e AL
ဟင်းသီးဟင်းရွက်	h AA ɪ AL ɴ AG ð AJ i AL h AA ɪ AL ɴ AG j AB w AK ɛ AL ʔ AC
ဟင်္သာ	h AA ɪ AL ɴ AG θ AJ a AL
ဟင်္သာတ	h AA ɪ AL ɴ AG θ AJ ə AL t AC a̰ AL
ဟထိုး	h AA a̰ AL tʰ AD o AM
ဟနူမာန်	h AA ə AL n AG u AM m AF a AL n AG
ဟန်ဂေရီ	h AA a AL ɴ AG ɡ AC e AL ɹ AB i AL
ဟန်နီ	h AA a AL ɴ AG n AG i AL
ဟမ်ဘာဂါ	h AA a AL ɴ AG b AH a AL ɡ AC a AL
ဟယ်လီကော့ပတာ	h AA ɛ AL l AE i AL k AC ɔ̰ AM p AH ə AL t AC a AL
ဟရိဘုဉ္ဇ	h AA ə AL ɹ AB ḭ b AH o AM ʊ AM ɴ AG z AJ a̰ AL
ဟလဝါ	h AA a̰ AL l AE ə AL w AK a AL
ဟာနွိုင်း	h AA a AL n AG w AK a AL ɪ AL ɴ AG
ဟာသ	h AA a AL θ AJ a̰ AL
ဟားခါး	h AA a AL kʰ AD a AL
ဟိတ်	h AA e AL ɪ AL ʔ AC
ဟိန္ဒီ	h AA e AL ɪ AL ɴ AG d AC i AL
ဟိန္ဒူ	h AA e AL ɪ AL ɴ AG d AC u AM
ဟိမဝန္တာ	h AA ḭ m AF a̰ AL w AK ʊ AM ɴ AG t AC a AL
ဟိမာလယ	h AA ḭ m AF a AL l AE ə AL j AB a̰ AL
ဟို	h AA o AM
ဟိုက်ဒရိုဂျင်	h AA a AL ɪ AL ʔ AC d AC ə AL ɹ AB o AM d AC ʑ AJ ɪ AL ɴ AG
ဟိုင်းအီနာ	h AA a AL ɪ AL ɴ AG ʔ AC i AL n AG a AL
ဟိုတယ်	h AA o AM t AC ɛ AL
ဟိုမှာ	h AA o AM m̥ AF a AL
ဟိုဟာ	h AA o AM h AA a AL
ဟီ	h AA i AL
ဟီနယာန	h AA i AL n AG a̰ AL j AB a AL n AG a̰ AL
ဟီလီယမ်	h AA i AL l AE i AL j AB a AL ɴ AG
ဟုတ်	h AA o AM ʊ AM ʔ AC
ဟုတ်ကဲ့	h AA o AM ʊ AM ʔ AC k AC ɛ̰ AL
ဟုတ်တာပေါ့	h AA o AM ʊ AM ʔ AC t AC a AL p AH ɔ̰ AM
ဟူ	h AA u AM
ဟူးရား	h AA u AM j AB a AL
ဟူးဟူး	h AA u AM h AA u AM
ဟေတီ	h AA e AL t AC i AL
ဟေမန္တ	h AA e AL m AF a AL ɴ AG t AC a̰ AL
ဟေမန်	h AA e AL m AF a AL ɴ AG
ဟေမာ	h AA e AL m AF a AL
ဟော	h AA ɔ AM
ဟောက်	h AA a AL ʊ AM ʔ AC
ဟောင်ကောင်	h AA a AL ʊ AM ɴ AG k AC a AL ʊ AM ɴ AG
ဟောင်း	h AA a AL ʊ AM ɴ AG
ဟော်	h AA ɔ AM
ဟော်ကီ	h AA ɔ AM k AC i AL
ဟော်တယ်	h AA ɔ AM t AC ɛ AL
ဟော်လန်	h AA ɔ AM l AE a AL ɴ AG
ဟဲလို	h AA ɛ AL l AE o AM
ဟွန်ဒူးရပ်စ်	h AA ʊ AM ɴ AG d AC u AM ɹ AB a AL ʔ AC s AJ
ဠ	l AE a̰ AL
ဠကြီး	l AE a̰ AL t AC ɕ AJ i AL
အ	ʔ AC a̰ AL
အက	ʔ AC ə AL k AC a̰ AL
အကယ်၍	ʔ AC ə AL k AC ɛ AL j AB w AK ḛ
အကာ	ʔ AC ə AL k AC a AL
အကိတ်	ʔ AC ə AL k AC e AL ɪ AL ʔ AC
အကို	ʔ AC ə AL k AC o AM
အကိုင်း	ʔ AC ə AL k AC a AL ɪ AL ɴ AG
အကုန်	ʔ AC ə AL k AC o AM ʊ AM ɴ AG
အကူ	ʔ AC ə AL k AC u AM
အကောက်	ʔ AC ə AL k AC a AL ʊ AM ʔ AC
အကောက်ဆိပ်	ʔ AC ə AL k AC a AL ʊ AM ʔ AC sʰ BA e AL ɪ AL ʔ AC
အကောင့်	ʔ AC ə AL k AC a̰ AL ʊ AM ɴ AG
အကော်ဒီယံ	ʔ AC ə AL k AC ɔ AM d AC i AL j AB a AL ɴ AG
အက္ခရာ	ʔ AC ɛ AL ʔ AC kʰ AD ə AL j AB a AL
အက်	ʔ AC ɛ AL ʔ AC
အက်စစ်	ʔ AC ɛ AL ʔ AC s AJ ɪ AL ʔ AC
အက်စတိုးနီးယား	ʔ AC ɛ AL ʔ AC s AJ ə AL t AC o AM n AG i AL j AB a AL
အက်တမ်	ʔ AC ɛ AL ʔ AC t AC a AL ɴ AG
အကျဉ်း	ʔ AC ə AL t AC ɕ AJ ɪ AL ɴ AG
အကျဉ်းထောင်	ʔ AC ə AL t AC ɕ AJ ɪ AL ɴ AG d AC a AL ʊ AM ɴ AG
အကျည်း	ʔ AC ə AL t AC ɕ AJ i AL
အကျည်းတန်	ʔ AC ə AL t AC ɕ AJ i AL t AC a AL ɴ AG
အကျယ်	ʔ AC ə AL t AC ɕ AJ ɛ AL
အကျိတ်	ʔ AC ə AL t AC ɕ AJ e AL ɪ AL ʔ AC
အကျိုး	ʔ AC ə AL t AC ɕ AJ o AM
အကျော်	ʔ AC ə AL t AC ɕ AJ ɔ AM
အကျော်ဇေယျ	ʔ AC ə AL t AC ɕ AJ ɔ AM z AJ e AL j AB a̰ AL
အကြမ်းဖက်ဝါဒ	ʔ AC ə AL t AC ɕ AJ a AL ɴ AG pʰ AI ɛ AL ʔ AC w AK a AL d AC a̰ AL
အကြမ်းဖက်သမား	ʔ AC ə AL t AC ɕ AJ a AL ɴ AG pʰ AI ɛ AL ʔ AC θ AJ ə AL m AF a AL
အကြောင်း	ʔ AC ə AL t AC ɕ AJ a AL ʊ AM ɴ AG
အကြော်	ʔ AC a̰ AL t AC ɕ AJ ɔ AM
အကြေး	ʔ AC ə AL t AC ɕ AJ e AL
အကြံ	ʔ AC ə AL t AC ɕ AJ a AL ɴ AG
အကြံပေးချက်	ʔ AC ə AL t AC ɕ AJ a AL ɴ AG p AH e AL d AC ʑ AJ ɛ AL ʔ AC
အကြွေး	ʔ AC ə AL t AC ɕ AJ w AK e AL
အကြွေးဝယ်ကတ်ပြား	ʔ AC ə AL t AC ɕ AJ w AK e AL w AK ɛ AL k AC a AL ʔ AC p AH j AB a AL
အကွ	ʔ AC ə AL k AC w AK a̰ AL
အကွာအဝေး	ʔ AC ə AL k AC w AK a AL ʔ AC ə AL w AK e AL
အခန်း	ʔ AC ə AL kʰ AD a AL ɴ AG
အခမဲ့	ʔ AC ə AL kʰ AD a̰ AL m AF ɛ̰ AL
အခါတစ်ပါး	ʔ AC ə AL kʰ AD a AL d AC ə AL b AH a AL
အခိုး	ʔ AC ə AL kʰ AD o AM
အခု	ʔ AC ə AL kʰ AD ṵ
အခေါက်	ʔ AC ə AL kʰ AD a AL ʊ AM ʔ AC
အချက်	ʔ AC ə AL t AC ɕʰ BA ɛ AL ʔ AC
အချင်း	ʔ AC ə AL t AC ɕʰ BA ɪ AL ɴ AG
အချင်းဝက်	ʔ AC ə AL t AC ɕʰ BA ɪ AL ɴ AG w AK ɛ AL ʔ AC
အချစ်	ʔ AC ə AL t AC ɕʰ BA ɪ AL ʔ AC
အချပ်	ʔ AC ə AL t AC ɕʰ BA a AL ʔ AC
အချိတ်	ʔ AC ə AL t AC ɕʰ BA e AL ɪ AL ʔ AC
အချိန်	ʔ AC ə AL t AC ɕʰ BA e AL ɪ AL ɴ AG
အချိန်စာရင်း	ʔ AC ə AL t AC ɕʰ BA e AL ɪ AL ɴ AG s AJ ə AL j AB ɪ AL ɴ AG
အချို	ʔ AC ə AL t AC ɕʰ BA o AM
အချိုပွဲ	ʔ AC ə AL t AC ɕʰ BA o AM b AH w AK ɛ AL
အချိုမှုန့်	ʔ AC ə AL t AC ɕʰ BA o AM m̥ AF o̰ AM ʊ AM ɴ AG
အချို့	ʔ AC ə AL t AC ɕʰ BA o̰ AM
အချိုး	ʔ AC ə AL t AC ɕʰ BA o AM
အချုပ်ခန်း	ʔ AC ə AL t AC ɕʰ BA o AM ʊ AM ʔ AC kʰ AD a AL ɴ AG
အချုပ်အခြာအာဏာ	ʔ AC ə AL t AC ɕʰ BA o AM ʊ AM ʔ AC ʔ AC ə AL t AC ɕʰ BA a AL ʔ AC a AL n AG a AL
အချွဲ	ʔ AC ə AL t AC ɕʰ BA w AK ɛ AL
အခြား	ʔ AC ə AL t AC ɕʰ BA a AL
အခြေ	ʔ AC ə AL t AC ɕʰ BA e AL
အခြောက်	ʔ AC ə AL t AC ɕʰ BA a AL ʊ AM ʔ AC
အခွင့်	ʔ AC ə AL kʰ AD w AK ɪ̰ AL ɴ AG
အခွင့်ထူးခံ	ʔ AC ə AL kʰ AD w AK ɪ̰ AL ɴ AG tʰ AD u AM ɡ AC a AL ɴ AG
အခွင့်အရေး	ʔ AC ə AL kʰ AD w AK ɪ̰ AL ɴ AG ʔ AC ə AL j AB e AL
အခွန်	ʔ AC ə AL kʰ AD ʊ AM ɴ AG
အခွံ	ʔ AC ə AL kʰ AD ʊ AM ɴ AG
အခွံမာသီး	ʔ AC ə AL kʰ AD ʊ AM ɴ AG m AF a AL ð AJ i AL
အဂတိ	ʔ AC a̰ AL ɡ AC ə AL d AC ḭ
အဂ္ဂမဟာပဏ္ဍိတ	ʔ AC ɛ AL ʔ AC ɡ AC a̰ AL m AF ə AL h AA a AL p AH a AL ɴ AG d AC ḭ t AC a̰ AL
အဂ္ဂမဟာသေနာပတိ	ʔ AC ɛ AL ʔ AC ɡ AC a̰ AL m AF ə AL h AA a AL θ AJ e AL n AG a AL p AH ə AL t AC ḭ
အဂ္ဂမဟေသီ	ʔ AC ɛ AL ʔ AC ɡ AC a̰ AL m AF ə AL h AA e AL θ AJ i AL
အငတ်	ʔ AC ə AL ŋ AG a AL ʔ AC
အင်ဂိုလာ	ʔ AC ɪ AL ɴ AG ɡ AC o AM l AE a AL
အင်ဂျင်	ʔ AC ɪ AL ɴ AG d AC ʑ AJ ɪ AL ɴ AG
အင်ဂျင်နီယာ	ʔ AC ɪ AL ɴ AG d AC ʑ AJ ɪ AL ɴ AG n AG i AL j AB a AL
အင်တာနက်	ʔ AC ɪ AL ɴ AG t AC a AL n AG ɛ AL ʔ AC
အင်တာဗျူး	ʔ AC ɪ AL ɴ AG t AC ə AL b AH j AB u AM
အင်ဒိုချိုင်းနား	ʔ AC ɪ AL ɴ AG d AC o AM t AC ɕʰ BA a AL ɪ AL ɴ AG n AG a AL
အင်ဒိုနီးရှား	ʔ AC ɪ AL ɴ AG d AC o AM n AG i AL ʃ AJ a AL
အင်ဒိုရာ	ʔ AC ɪ AL ɴ AG d AC o AM ɹ AB a AL
အင်ပါယာ	ʔ AC ɪ AL ɴ AG p AH a AL j AB a AL
အင်း	ʔ AC ɪ AL ɴ AG
အင်းကျီ	ʔ AC ɪ AL ɴ AG d AC ʑ AJ i AL
အင်းစိန်	ʔ AC ɪ AL ɴ AG s AJ e AL ɪ AL ɴ AG
အင်းဆက်	ʔ AC ɪ AL ɴ AG sʰ BA ɛ AL ʔ AC
အင်းဝ	ʔ AC ɪ AL ɴ AG w AK a̰ AL
အင်းသား	ʔ AC ɪ AL ɴ AG ð AJ a AL
အင်္ကျီ	ʔ AC ɪ AL ɴ AG d AC ʑ AJ i AL
အင်္ဂတေ	ʔ AC ɪ AL ɴ AG ɡ AC ə AL d AC e AL
အင်္ဂလန်	ʔ AC ɪ AL ɴ AG ɡ AC ə AL l AE a AL ɴ AG
အင်္ဂလိပ်	ʔ AC ɪ AL ɴ AG ɡ AC ə AL l AE e AL ɪ AL ʔ AC
အင်္ဂါ	ʔ AC ɪ AL ɴ AG ɡ AC a AL
အင်္ဂါဇာတ်	ʔ AC ɪ AL ɴ AG ɡ AC a AL z AJ a AL ʔ AC
အငြိမ့်	ʔ AC ə AL ɲ AG ḛ ɪ AL ɴ AG
အငြိမ့်တီးမျိုး	ʔ AC a̰ AL ɲ AG ḛ ɪ AL ɴ AG t AC i AL m AF j AB o AM
အငွေ့	ʔ AC a̰ AL ŋ AG w AK ḛ
အစ	ʔ AC ə AL s AJ a̰ AL
အစက်	ʔ AC ə AL s AJ ɛ AL ʔ AC
အစဉ်	ʔ AC ə AL s AJ ɪ AL ɴ AG
အစည်းအရုံး	ʔ AC ə AL s AJ i AL ʔ AC ə AL j AB o AM ʊ AM ɴ AG
အစည်းအဝေး	ʔ AC ə AL s AJ i AL ʔ AC ə AL w AK e AL
အစမ်း	ʔ AC ə AL s AJ a AL ɴ AG
အစား	ʔ AC ə AL s AJ a AL
အစားအစာ	ʔ AC ə AL s AJ a AL ʔ AC ə AL s AJ a AL
အစိမ်း	ʔ AC ə AL s AJ e AL ɪ AL ɴ AG
အစိုးရ	ʔ AC ə AL s AJ o AM j AB a̰ AL
အစီရင်	ʔ AC ə AL s AJ i AL j AB ɪ AL ɴ AG
အစီရင်ခံ	ʔ AC ə AL s AJ i AL j AB ɪ AL ɴ AG kʰ AD a AL ɴ AG
အစီရင်ခံစာ	ʔ AC ə AL s AJ i AL j AB ɪ AL ɴ AG kʰ AD a AL ɴ AG z AJ a AL
အစီအစဉ်	ʔ AC ə AL s AJ i AL ʔ AC ə AL s AJ ɪ AL ɴ AG
အစီအလျဉ်	ʔ AC ə AL s AJ i AL ʔ AC ə AL l AE j AB ɪ AL ɴ AG
အစု	ʔ AC ə AL s AJ ṵ
အစုရှင်	ʔ AC ə AL s AJ ṵ ʃ AJ ɪ AL ɴ AG
အစုံအစုံ	ʔ AC ə AL s AJ o AM ʊ AM ɴ AG ʔ AC ə AL s AJ o AM ʊ AM ɴ AG
အစေအပါး	ʔ AC ə AL s AJ e AL ʔ AC ə AL p AH a AL
အစောင့်	ʔ AC ə AL s AJ a̰ AL ʊ AM ɴ AG
အစေ့	ʔ AC ə AL s AJ ḭ
အစ္စရေး	ʔ AC ɪ AL ʔ AC z AJ ə AL ɹ AB e AL
အစ္စလမ်	ʔ AC ɪ AL ʔ AC s AJ ə AL l AE a AL ɴ AG
အစ်	ʔ AC ɪ AL ʔ AC
အစ်ကို	ʔ AC ə AL k AC o AM
အစ်မ	ʔ AC ə AL m AF a̰ AL
အစွန်း	ʔ AC ə AL s AJ ʊ AM ɴ AG
အဆင့်	ʔ AC ə AL sʰ BA ɪ̰ AL ɴ AG
အဆန်	ʔ AC ə AL sʰ BA a AL ɴ AG
အဆိပ်	ʔ AC ə AL sʰ BA e AL ɪ AL ʔ AC
အဆိုတော်	ʔ AC ə AL sʰ BA o AM d AC ɔ AM
အဆီ	ʔ AC ə AL sʰ BA i AL
အဆုတ်	ʔ AC ə AL sʰ BA o AM ʊ AM ʔ AC
အဆုတ်ရောင်ရောဂါ	ʔ AC a̰ AL sʰ BA o AM ʊ AM ʔ AC j AB a AL ʊ AM ɴ AG j AB ɔ AM ɡ AC a AL
အဆုံး	ʔ AC ə AL sʰ BA o AM ʊ AM ɴ AG
အဆောက်အအုံ	ʔ AC ə AL sʰ BA a AL ʊ AM ʔ AC ʔ AC ə AL ʔ AC u AM
အဆောက်အဦ	ʔ AC ə AL sʰ BA a AL ʊ AM ʔ AC ʔ AC ə AL ʔ AC u AM
အဆောင်	ʔ AC ə AL sʰ BA a AL ʊ AM ɴ AG
အဆွေး	ʔ AC ə AL sʰ BA w AK e AL
အဇာဘိုင်ဂျန်	ʔ AC a̰ AL z AJ ə AL b AH a AL ɪ AL ɴ AG d AC ʑ AJ a AL ɴ AG
အဉ္ဇလီ	ʔ AC ɪ AL ɴ AG z AJ ə AL l AE i AL
အညစ်အကြေး	ʔ AC ə AL ɲ AG ɪ AL ʔ AC ʔ AC ə AL t AC ɕ AJ e AL
အညစ်အထည်း	ʔ AC ə AL ɲ AG ɪ AL ʔ AC ʔ AC ə AL tʰ AD i AL
အညာသား	ʔ AC ə AL ɲ AG a AL ð AJ a AL
အညို	ʔ AC ə AL ɲ AG o AM
အညီ	ʔ AC ə AL ɲ AG i AL
အဋ္ဌမ	ʔ AC a AL ʔ AC tʰ AD ə AL m AF a̰ AL
အဏုဇီဝဗေဒ	ʔ AC ə AL n AG ṵ z AJ i AL w AK a̰ AL b AH e AL d AC a̰ AL
အဏ္ဏဝါ	ʔ AC a AL ɴ AG n AG ə AL w AK a AL
အဏ္ဏဝါဗေဒ	ʔ AC a AL n AG n AG ə AL w AK a AL b AH e AL d AC a̰ AL
အတင်း	ʔ AC ə AL t AC ɪ AL ɴ AG
အတန်း	ʔ AC ə AL t AC a AL ɴ AG
အတာ	ʔ AC ə AL t AC a AL
အတာအိုး	ʔ AC ə AL t AC a AL ʔ AC o AM
အတိတ်	ʔ AC ə AL t AC e AL ɪ AL ʔ AC
အတိုင်ပင်ခံ	ʔ AC ə AL t AC a AL ɪ AL ɴ AG b AH ɪ AL ɴ AG ɡ AC a AL ɴ AG
အတိုင်း	ʔ AC ə AL t AC a AL ɪ AL ɴ AG
အတိုး	ʔ AC ə AL t AC o AM
အတီမျှ	ʔ AC ə AL t AC i AL m̥ AF j AB a̰ AL
အတူ	ʔ AC ə AL t AC u AM
အတူတူ	ʔ AC ə AL t AC u AM d AC u AM
အတောင်	ʔ AC ə AL t AC a AL ʊ AM ɴ AG
အတ္တဒဿီ	ʔ AC a AL ʔ AC t AC a̰ AL d AC a AL ʔ AC θ AJ i AL
အတ္တဒဿီဘုရား	ʔ AC a AL ʔ AC t AC a̰ AL d AC ə AL t AC θ AJ i AL pʰ AI ə AL j AB a AL
အတွင်း	ʔ AC ə AL t AC w AK ɪ AL ɴ AG
အတွင်းခံ	ʔ AC ə AL t AC w AK ɪ AL ɴ AG ɡ AC a AL ɴ AG
အတွင်းစကား	ʔ AC ə AL t AC w AK ɪ AL ɴ AG z AJ ə AL ɡ AC a AL
အတွင်းတာရာ	ʔ AC ə AL t AC w AK ɪ AL ɴ AG t AC a AL j AB a AL
အတွင်းရန်	ʔ AC ə AL t AC w AK ɪ AL ɴ AG j AB a AL ɴ AG
အတွင်းဝန်	ʔ AC ə AL t AC w AK ɪ AL ɴ AG w AK ʊ AM ɴ AG
အတွဲ	ʔ AC ə AL t AC w AK ɛ AL
အထက်	ʔ AC ə AL tʰ AD ɛ AL ʔ AC
အထက်လွှတ်တော်	ʔ AC ə AL tʰ AD ɛ AL ʔ AC l̥ AE ʊ AM ʔ AC t AC ɔ AM
အထက်သား	ʔ AC ə AL tʰ AD ɛ AL ʔ AC ð AJ a AL
အထင်	ʔ AC ə AL tʰ AD ɪ AL ɴ AG
အထပ်	ʔ AC ə AL tʰ AD a AL ʔ AC
အထိ	ʔ AC ə AL tʰ AD ḭ
အထိန်း	ʔ AC ə AL tʰ AD e AL ɪ AL ɴ AG
အထိမ်းအမှတ်	ʔ AC ə AL tʰ AD e AL ɪ AL ɴ AG ʔ AC ə AL m̥ AF a AL ʔ AC
အထီး	ʔ AC ə AL tʰ AD i AL
အထုပ်	ʔ AC ə AL tʰ AD o AM ʊ AM ʔ AC
အထုံးအဖွဲ့	ʔ AC ə AL tʰ AD o AM ʊ AM ɴ AG ʔ AC ə AL pʰ AI w AK ɛ̰ AL
အထဲ	ʔ AC ə AL tʰ AD ɛ AL
အဓမ္မ	ʔ AC ə AL d AC ə AL m AF a̰ AL
အဓိက	ʔ AC a̰ AL d AC ḭ ɡ AC a̰ AL
အဓိကရုဏ်း​	ʔ AC ə AL d AC ḭ k AC a̰ AL j AB o AM ʊ AM ɴ AG
အဓိဌာန်	ʔ AC ə AL d AC e AL ɪ AL ʔ AC tʰ AD a AL ɴ AG
အဓိပ္ပါယ်	ʔ AC ə AL d AC e AL ɪ AL ʔ AC b AH ɛ AL
အနက်	ʔ AC ə AL n AG ɛ AL ʔ AC
အနန္တ	ʔ AC ə AL n AG a AL ɴ AG d AC a̰ AL
အနန္တောအနန္တငါးပါး	ʔ AC ə AL n AG a AL ɴ AG d AC ɔ AM ʔ AC ə AL n AG d AC a̰ AL ŋ AG a AL p AH a AL
အနာကြီးရောဂါ	ʔ AC ə AL n AG a AL d AC ʑ AJ i AL j AB ɔ AM ɡ AC a AL
အနာဂတ်	ʔ AC ə AL n AG a AL ɡ AC a AL ʔ AC
အနား	ʔ AC ə AL n AG a AL
အနားယူ	ʔ AC ə AL n AG a AL j AB u AM
အနိစ္စ	ʔ AC ə AL n AG e AL s AJ s AJ a̰ AL
အနို့	ʔ AC ə AL n AG o̰ AM
အနီ	ʔ AC ə AL n AG i AL
အနုတ်လက္ခဏာ	ʔ AC ə AL n̥ AG o AM ʊ AM ʔ AC l AE ɛ AL ʔ AC kʰ AD ə AL n AG a AL
အနုပညာ	ʔ AC ə AL n AG ṵ p AH j AB ɪ AL ɴ AG ɲ AG a AL
အနုရာဓပူရ	ʔ AC ə AL n AG ṵ j AB a AL d AC a̰ AL p AH u AM ɹ AB a̰ AL
အနုရုဒ္ဓါ	ʔ AC ə AL n AG ṵ j AB o AM ʊ AM ʔ AC d AC a AL
အနောက်	ʔ AC ə AL n AG a AL ʊ AM ʔ AC
အနောက်ဝန်	ʔ AC ə AL n AG a AL ʊ AM ʔ AC w AK ʊ AM ɴ AG
အနောမဒဿီ	ʔ AC ə AL n AG ɔ AM m AF ə AL d AC ə AL t AC θ AJ i AL
အနောမဒဿီဘုရား	ʔ AC ə AL n AG ɔ AM m AF ə AL d AC a AL ʔ AC θ AJ i AL pʰ AI ə AL j AB a AL
အနော်ရထာ	ʔ AC ə AL n AG ɔ AM j AB ə AL tʰ AD a AL
အနံ့	ʔ AC ə AL n AG a̰ AL ɴ AG
အန္တရာယ်	ʔ AC a AL ɴ AG d AC ə AL j AB ɛ AL
အန္တာတိက	ʔ AC a AL ɴ AG t AC a AL t AC ḭ k AC a̰ AL
အန်	ʔ AC a AL ɴ AG
အန်ကယ်	ʔ AC a AL ɴ AG k AC ɛ AL
အန်တီ	ʔ AC a AL ɴ AG t AC i AL
အန်နီမဲ	ʔ AC a AL ɴ AG n AG i AL m AF ɛ AL
အနွယ်	ʔ AC ə AL n AG w AK ɛ AL
အနှစ်	ʔ AC ə AL n̥ AG ɪ AL ʔ AC
အနှိပ်	ʔ AC ə AL n̥ AG e AL ɪ AL ʔ AC
အနှီဟာ	ʔ AC ə AL n̥ AG i AL h AA a AL
အနှီး	ʔ AC ə AL n̥ AG i AL
အပင်	ʔ AC ə AL p AH ɪ AL ɴ AG
အပတ်စဉ်	ʔ AC a̰ AL p AH a AL ʔ AC z AJ ɪ AL ɴ AG
အပိုင်း	ʔ AC ə AL p AH a AL ɪ AL ɴ AG
အပိုဒ်	ʔ AC ə AL p AH a AL ɪ AL ʔ AC
အပူ	ʔ AC ə AL p AH u AM
အပေါင်	ʔ AC ə AL p AH a AL ʊ AM ɴ AG
အပေါင်းလက္ခဏာ	ʔ AC ə AL p AH a AL ʊ AM ɴ AG l AE ɛ AL ʔ AC kʰ AD ə AL n AG a AL
အပေါ့	ʔ AC ə AL p AH ɔ̰ AM
အပေါ်	ʔ AC ə AL p AH ɔ AM
အပ်	ʔ AC a AL ʔ AC
အပ်ချည်	ʔ AC a AL ʔ AC t AC ɕʰ BA i AL
အပ်ချုပ်စက်	ʔ AC a AL ʔ AC t AC ɕʰ BA o AM ʊ AM ʔ AC s AJ ɛ AL ʔ AC
အပ်ထောက်	ʔ AC a AL ʔ AC tʰ AD a AL ʊ AM ʔ AC
အပြင်	ʔ AC ə AL p AH j AB ɪ AL ɴ AG
အပြစ်	ʔ AC ə AL p AH j AB ɪ AL ʔ AC
အပြာ	ʔ AC ə AL p AH j AB a AL
အပြာကား	ʔ AC ə AL p AH j AB a AL k AC a AL
အပြာမယ်	ʔ AC ə AL p AH j AB a AL m AF ɛ AL
အပြိုင်	ʔ AC ə AL p AH j AB a AL ɪ AL ɴ AG
အပြီးသတ်	ʔ AC ə AL p AH j AB i AL ð AJ a AL ʔ AC
အပြုအမူ	ʔ AC ə AL p AH j AB ṵ ʔ AC ə AL m AF u AM
အပြုံး	ʔ AC ə AL p AH j AB o AM ʊ AM ɴ AG
အပြော	ʔ AC ə AL p AH j AB ɔ AM
အပွင့်	ʔ AC ə AL p AH w AK ɪ̰ AL ɴ AG
အဖ	ʔ AC ə AL pʰ AI a̰ AL
အဖတ်	ʔ AC ə AL pʰ AI a AL ʔ AC
အဖို	ʔ AC ə AL pʰ AI o AM
အဖို့	ʔ AC ə AL pʰ AI o̰ AM
အဖိုး	ʔ AC ə AL pʰ AI o AM
အဖိုးကြီး	ʔ AC ə AL pʰ AI o AM t AC ɕ AJ i AL
အဖုံဖုံ	ʔ AC ə AL pʰ AI o AM ʊ AM ɴ AG b AH o AM ʊ AM ɴ AG
အဖုံး	ʔ AC ə AL pʰ AI o AM ʊ AM ɴ AG
အဖေ	ʔ AC ə AL pʰ AI e AL
အဖော်	ʔ AC ə AL pʰ AI ɔ AM
အဖေ့	ʔ AC ə AL pʰ AI ḛ
အဖျား	ʔ AC ə AL pʰ AI j AB a AL
အဖျားဖြတ်ဆေး	ʔ AC a̰ AL pʰ AI j AB a AL pʰ AI j AB a AL ʔ AC sʰ BA e AL
အဖြူ	ʔ AC ə AL pʰ AI j AB u AM
အဖြေ	ʔ AC ə AL pʰ AI j AB e AL
အဖွဲ့	ʔ AC ə AL pʰ AI w AK ɛ̰ AL
အဖွဲ့ချုပ်	ʔ AC ə AL pʰ AI w AK ɛ̰ AL d AC ʑ AJ o AM ʊ AM ʔ AC
အဖွဲ့ဝင်	ʔ AC ə AL pʰ AI w AK ɛ̰ AL w AK ɪ AL ɴ AG
အဘိဓာန်	ʔ AC ə AL b AH ḭ d AC a AL ɴ AG
အဘိုး	ʔ AC ə AL pʰ AI o AM
အဘိုးကြီး	ʔ AC ə AL pʰ AI o AM d AC ʑ AJ i AL
အဘွား	ʔ AC ə AL pʰ AI w AK a AL
အမ	ʔ AC ə AL m AF a̰ AL
အမည်	ʔ AC ə AL m AF j AB i AL
အမည်း	ʔ AC ə AL m AF ɛ AL
အမတ်	ʔ AC ə AL m AF a AL ʔ AC
အမယ်	ʔ AC ə AL m AF ɛ AL
အမရပူရ	ʔ AC ə AL m AF ə AL j AB a̰ AL p AH u AM j AB a̰ AL
အမာ	ʔ AC a̰ AL m AF a AL
အမိ	ʔ AC ə AL m AF ḭ
အမိန့်	ʔ AC ə AL m AF ḛ ɪ AL ɴ AG
အမိန့်ရှိပါ	ʔ AC ə AL m AF ḛ ɪ AL ɴ AG ʃ AJ ḭ b AH a AL
အမိုး	ʔ AC ə AL m AF o AM
အမူအရာ	ʔ AC ə AL m AF u AM ʔ AC ə AL j AB a AL
အမေ	ʔ AC ə AL m AF e AL
အမေရိက	ʔ AC ə AL m AF e AL ɹ AB ḭ k AC a̰ AL
အမေရိကန်	ʔ AC ə AL m AF e AL ɹ AB ḭ k AC a AL ɴ AG
အမေရိကန်ပြည်ထောင်စု	ʔ AC ə AL m AF e AL ɹ AB ḭ k AC a AL ɴ AG p AH j AB i AL d AC a AL ʊ AM ɴ AG z AJ ṵ
အမေလိုး	ʔ AC ə AL m AF e AL l AE o AM
အမေး	ʔ AC ə AL m AF e AL
အမဲလိုက်	ʔ AC ə AL m AF ɛ AL l AE a AL ɪ AL ʔ AC
အမဲသား	ʔ AC ə AL m AF ɛ AL ð AJ a AL
အမဲသားမစားပါဘူး	ʔ AC ə AL m AF ɛ AL ð AJ a AL m AF ə AL s AJ a AL b AH a AL b AH u AM
အမျိုး	ʔ AC ə AL m AF j AB o AM
အမျိုးဇာတ်	ʔ AC ə AL m AF j AB o AM z AJ a AL ʔ AC
အမျိုးလေးပါး	ʔ AC ə AL m AF j AB o AM l AE e AL b AH a AL
အမျိုးသမီး	ʔ AC ə AL m AF j AB o AM ð AJ ə AL m AF i AL
အမျိုးသမီးလစဉ်သုံးပစ္စည်း	ʔ AC a̰ AL m AF j AB o AM ð AJ ə AL m AF i AL l AE a̰ AL z AJ ɪ AL ɴ AG θ AJ o AM ʊ AM ɴ AG p AH j AB ɪ AL ʔ AC s AJ i AL
အမျိုးသား	ʔ AC ə AL m AF j AB o AM ð AJ a AL
အမျိုးသားစိတ်	ʔ AC ə AL m AF j AB o AM ð AJ a AL s AJ e AL ɪ AL ʔ AC
အမျိုးသားနေ့	ʔ AC ə AL m AF j AB o AM ð AJ a AL n AG ḛ
အမျိုးသားလွှတ်တော်	ʔ AC ə AL m AF j AB o AM ð AJ a AL l̥ AE ʊ AM ʔ AC t AC ɔ AM
အမျိုးသားသီချင်း	ʔ AC ə AL m AF j AB o AM ð AJ a AL θ AJ ə AL t AC ɕʰ BA ɪ AL ɴ AG
အမျိုးအနွယ်	ʔ AC ə AL m AF j AB o AM ʔ AC ə AL n AG w AK ɛ AL
အမျှင်	ʔ AC ə AL m̥ AF j AB ɪ AL ɴ AG
အမြစ်	ʔ AC ə AL m AF j AB ɪ AL ʔ AC
အမြန်	ʔ AC ə AL m AF j AB a AL ɴ AG
အမြီး	ʔ AC ə AL m̥ AF i AL
အမြောက်	ʔ AC ə AL m AF j AB a AL ʊ AM ʔ AC
အမြဲ	ʔ AC ə AL m AF j AB ɛ AL
အမြဲတမ်း	ʔ AC ə AL m AF j AB ɛ AL d AC a AL ɴ AG
အမြွှာ	ʔ AC ə AL m̥ AF w AK a AL
အမြှုပ်	ʔ AC ə AL m̥ AF j AB o AM ʊ AM ʔ AC
အမြှောက်လက္ခဏာ	ʔ AC ə AL m̥ AF j AB a AL ʊ AM ʔ AC l AE ɛ AL ʔ AC kʰ AD ə AL n AG a AL
အမွေ	ʔ AC ə AL m AF w AK e AL
အမွေခံ	ʔ AC ə AL m AF w AK e AL ɡ AC a AL ɴ AG
အမွေခွဲ	ʔ AC ə AL m AF w AK e AL kʰ AD w AK ɛ AL
အမွေအနှစ်	ʔ AC ə AL m AF w AK e AL ʔ AC ə AL n̥ AG ɪ AL ʔ AC
အမွေး	ʔ AC ə AL m AF w AK e AL
အမွှေး	ʔ AC ə AL m̥ AF w AK e AL
အမွှေးတိုင်	ʔ AC ə AL m̥ AF w AK e AL d AC a AL ɪ AL ɴ AG
အမှတ်	ʔ AC ə AL m̥ AF a AL ʔ AC
အမှတ်တံဆိပ်	ʔ AC ə AL m̥ AF a AL ʔ AC d AC ə AL z AJ e AL ɪ AL ʔ AC
အမှန်တရား	ʔ AC ə AL m̥ AF a AL ɴ AG t AC ə AL j AB a AL
အမှာ	ʔ AC ə AL m̥ AF a AL
အမှား	ʔ AC ə AL m̥ AF a AL
အမှိုက်	ʔ AC ə AL m̥ AF a AL ɪ AL ʔ AC
အမှုန့်	ʔ AC ə AL m̥ AF o̰ AM ʊ AM ɴ AG
အမှုန်	ʔ AC ə AL m̥ AF o AM ʊ AM ɴ AG
အယုဓျာ	ʔ AC ə AL j AB o AM ʊ AM ʔ AC d AC ə AL j AB a AL
အယူ	ʔ AC ə AL j AB u AM
အယူဝါဒ	ʔ AC ə AL j AB u AM w AK a AL d AC a̰ AL
အယ်ဆာဗေဒို	ʔ AC ɛ AL sʰ BA a AL b AH e AL d AC o AM
အယ်လဘမ်	ʔ AC ɛ AL l AE ə AL b AH a AL ɴ AG
အယ်လ်ဂျီးရီးယား	ʔ AC ɛ AL l AE d AC ʑ AJ i AL ɹ AB i AL j AB a AL
အယ်လ်ဘေးနီးယား	ʔ AC ɛ AL l AE b AH e AL n AG i AL j AB a AL
အရက်	ʔ AC ə AL j AB ɛ AL ʔ AC
အရက်ဆိုင်	ʔ AC ə AL j AB ɛ AL ʔ AC sʰ BA a AL ɪ AL ɴ AG
အရင်း	ʔ AC ə AL j AB ɪ AL ɴ AG
အရင်းရှင်ဝါဒ	ʔ AC ə AL j AB ɪ AL ɴ AG ʃ AJ ɪ AL ɴ AG w AK a AL d AC a̰ AL
အရည်	ʔ AC ə AL j AB i AL
အရမ်း	ʔ AC ə AL j AB a AL ɴ AG
အရသာ	ʔ AC ə AL j AB a̰ AL ð AJ a AL
အရာ	ʔ AC ə AL j AB a AL
အရာခံဗိုလ်	ʔ AC ə AL j AB a AL ɡ AC a AL ɴ AG b AH o AM
အရိပ်	ʔ AC ə AL j AB e AL ɪ AL ʔ AC
အရိမဒ္ဒနာပူရ	ʔ AC a̰ AL ɹ AB ḭ m AF a AL d AC d AC ə AL n AG a AL p AH u AM ɹ AB a̰ AL
အရိုး	ʔ AC ə AL j AB o AM
အရိုးစု	ʔ AC ə AL j AB o AM z AJ ṵ
အရိုးပျော့နာ	ʔ AC a̰ AL j AB o AM p AH j AB ɔ̰ AM n AG a AL
အရီး	ʔ AC ə AL j AB i AL
အရီးကြီး	ʔ AC ə AL j AB i AL d AC ʑ AJ i AL
အရီးလေး	ʔ AC ə AL j AB i AL l AE e AL
အရုဏ်	ʔ AC ə AL j AB u AM n AG
အရုပ်	ʔ AC ə AL j AB o AM ʊ AM ʔ AC
အရုပ်စာ	ʔ AC ə AL j AB o AM ʊ AM ʔ AC s AJ a AL
အရေ	ʔ AC ə AL j AB e AL
အရေပြား	ʔ AC ə AL j AB e AL b AH j AB a AL
အရေပြားရောဂါ	ʔ AC ə AL j AB e AL b AH j AB a AL j AB ɔ AM ɡ AC a AL
အရောင်	ʔ AC ə AL j AB a AL ʊ AM ɴ AG
အရောင်တင်မှုန့်	ʔ AC ə AL j AB a AL ʊ AM ɴ AG t AC ɪ AL ɴ AG m̥ AF o̰ AM ʊ AM ɴ AG
အရောင်းအဝယ်	ʔ AC ə AL j AB a AL ʊ AM ɴ AG ʔ AC ə AL w AK ɛ AL
အရေး	ʔ AC a̰ AL j AB e AL
အရေးကြီး	ʔ AC a̰ AL j AB e AL t AC ɕ AJ i AL
အရေးတော်ပုံ	ʔ AC ə AL j AB e AL d AC ɔ AM b AH o AM ʊ AM ɴ AG
အရံဂြိုဟ်	ʔ AC ə AL j AB a AL ɴ AG d AC ʑ AJ o AM
အရွက်	ʔ AC ə AL j AB w AK ɛ AL ʔ AC
အရွတ်	ʔ AC ə AL j AB ʊ AM ʔ AC
အရွယ်ဆယ်ပါး	ʔ AC ə AL j AB w AK ɛ AL sʰ BA ɛ AL b AH a AL
အရှင်	ʔ AC ə AL ʃ AJ ɪ AL ɴ AG
အရှင်ဘုရား	ʔ AC ə AL ʃ AJ ɪ AL ɴ AG pʰ AI ə AL j AB a AL
အရှိန်	ʔ AC ə AL ʃ AJ e AL ɪ AL ɴ AG
အရှေ့	ʔ AC ə AL ʃ AJ ḛ
အလက်	ʔ AC ə AL l AE ɛ AL ʔ AC
အလင်း	ʔ AC ə AL l AE ɪ AL ɴ AG
အလင်းတန်း	ʔ AC ə AL l AE ɪ AL ɴ AG d AC a AL ɴ AG
အလင်္ကာ	ʔ AC ə AL l AE ɪ AL ɴ AG ɡ AC a AL
အလား	ʔ AC ə AL l AE a AL
အလို	ʔ AC ə AL l AE o AM
အလီ	ʔ AC ə AL l AE i AL
အလုပ်	ʔ AC ə AL l AE o AM ʊ AM ʔ AC
အလုပ်ပိတ်ရက်	ʔ AC ə AL l AE o AM ʊ AM ʔ AC p AH e AL ɪ AL ʔ AC j AB ɛ AL ʔ AC
အလုပ်ရုံ	ʔ AC ə AL l AE o AM ʊ AM ʔ AC j AB o AM ʊ AM ɴ AG
အလုပ်ရှင်	ʔ AC ə AL l AE o AM ʊ AM ʔ AC ʃ AJ ɪ AL ɴ AG
အလုပ်လုပ်	ʔ AC ə AL l AE o AM ʊ AM ʔ AC l AE o AM ʊ AM ʔ AC
အလုပ်သမား	ʔ AC ə AL l AE o AM ʊ AM ʔ AC θ AJ ə AL m AF a AL
အလုပ်သမားနေ့	ʔ AC ə AL l AE o AM ʊ AM ʔ AC θ AJ ə AL m AF a AL n AG ḛ
အလုံး	ʔ AC ə AL l AE o AM ʊ AM ɴ AG
အလူမီနီယမ်	ʔ AC ə AL l AE u AM m AF i AL n AG i AL j AB a AL ɴ AG
အလောင်း	ʔ AC ə AL l AE a AL ʊ AM ɴ AG
အလေး	ʔ AC ə AL l AE e AL
အလံ	ʔ AC ə AL l AE a AL ɴ AG
အလ္လာဟ်	ʔ AC a AL l AE l AE a AL h AA
အလျင်	ʔ AC ə AL l AE j AB ɪ AL ɴ AG
အလျား	ʔ AC ə AL l AE j AB a AL
အလွန်	ʔ AC ə AL l AE ʊ AM ɴ AG
အလှဆီ	ʔ AC ə AL l̥ AE a̰ AL z AJ i AL
အလှမ်း	ʔ AC ə AL l̥ AE a AL ɴ AG
အလှူရှင်	ʔ AC ə AL l̥ AE u AM ʃ AJ ɪ AL ɴ AG
အဝင်	ʔ AC ə AL w AK ɪ AL ɴ AG
အဝတာရ	ʔ AC a̰ AL w AK a̰ AL t AC a AL j AB a̰ AL
အဝတ်	ʔ AC ə AL w AK ʊ AM ʔ AC
အဝတ်လျှောက်စက်	ʔ AC ə AL w AK ʊ AM ʔ AC ʃ AJ a AL ʊ AM ʔ AC s AJ ɛ AL ʔ AC
အဝတ်အစား	ʔ AC ə AL w AK ʊ AM ʔ AC ʔ AC ə AL s AJ a AL
အဝါ	ʔ AC ə AL w AK a AL
အသက်	ʔ AC ə AL θ AJ ɛ AL ʔ AC
အသက်ဦးဆံပိုင်	ʔ AC ə AL θ AJ ɛ AL ʔ AC ʔ AC u AM sʰ BA a AL ɴ AG b AH a AL ɪ AL ɴ AG
အသင်	ʔ AC ə AL θ AJ ɪ AL ɴ AG
အသင်း	ʔ AC ə AL θ AJ ɪ AL ɴ AG
အသည်း	ʔ AC ə AL θ AJ ɛ AL
အသည်းနှလုံး	ʔ AC ə AL θ AJ ɛ AL n̥ AG ə AL l AE o AM ʊ AM ɴ AG
အသတ်	ʔ AC a̰ AL θ AJ a AL ʔ AC
အသား	ʔ AC ə AL θ AJ a AL
အသားညှပ်မုန့်	ʔ AC ə AL θ AJ a AL ɲ̊ AG a AL ʔ AC m AF o̰ AM ʊ AM ɴ AG
အသားမာ	ʔ AC ə AL θ AJ ə AL m AF a AL
အသားဝါရောဂါ	ʔ AC a̰ AL θ AJ a AL w AK a AL j AB ɔ AM ɡ AC a AL
အသိ	ʔ AC ə AL θ AJ ḭ
အသိတရား	ʔ AC ə AL θ AJ ḭ t AC ə AL j AB a AL
အသိပညာ	ʔ AC ə AL θ AJ ḭ p AH j AB ɪ AL ɴ AG ɲ AG a AL
အသိပညာရှင်	ʔ AC ə AL θ AJ ḭ p AH j AB ɪ AL ɴ AG ɲ AG a AL ʃ AJ ɪ AL ɴ AG
အသိုက်	ʔ AC ə AL θ AJ a AL ɪ AL ʔ AC
အသီး	ʔ AC ə AL θ AJ i AL
အသုပ်	ʔ AC ə AL θ AJ o AM ʊ AM ʔ AC
အသုပ်စုံ	ʔ AC ə AL θ AJ o AM ʊ AM ʔ AC s AJ o AM ʊ AM ɴ AG
အသုဘ	ʔ AC a̰ AL θ AJ ṵ b AH a̰ AL
အသုံး	ʔ AC ə AL θ AJ o AM ʊ AM ɴ AG
အသုံးပြု	ʔ AC ə AL θ AJ o AM ʊ AM ɴ AG p AH j AB ṵ
အသေ	ʔ AC ə AL θ AJ e AL
အသော	ʔ AC ə AL θ AJ ɔ AM
အသံ	ʔ AC ə AL θ AJ a AL ɴ AG
အသံထွက်	ʔ AC ə AL θ AJ a AL ɴ AG d AC w AK ɛ AL ʔ AC
အသျှင်	ʔ AC ə AL ʃ AJ ɪ AL ɴ AG
အသွားအလာ	ʔ AC ə AL θ AJ w AK a AL ʔ AC ə AL l AE a AL
အာကာသ	ʔ AC a AL k AC a AL θ AJ a̰ AL
အာကာသစိုး	ʔ AC a AL k AC a AL θ AJ a̰ AL z AJ o AM
အာကာသယာဉ်	ʔ AC a AL k AC a AL θ AJ a̰ AL j AB ɪ AL ɴ AG
အာခါ	ʔ AC a AL kʰ AD a AL
အာဂျင်တီးနား	ʔ AC a AL d AC ʑ AJ ɪ AL ɴ AG t AC i AL n AG a AL
အာဃာတ	ʔ AC a AL ɡ AC a AL t AC a̰ AL
အာစရိယ	ʔ AC a AL s AJ a̰ AL ɹ AB ḭ j AB a̰ AL
အာဇာနည်	ʔ AC a AL z AJ a AL n AG i AL
အာဇာနည်နေ့	ʔ AC a AL z AJ a AL n AG i AL n AG ḛ
အာဏာ	ʔ AC a AL n AG a AL
အာဏာရှင်	ʔ AC a AL n AG a AL ʃ AJ ɪ AL ɴ AG
အာဏာသား	ʔ AC a AL n AG a AL ð AJ a AL
အာဏာသိမ်း	ʔ AC a AL n AG a AL θ AJ e AL ɪ AL ɴ AG
အာတိတ်	ʔ AC a AL t AC e AL ɪ AL ʔ AC
အာနီ	ʔ AC a AL n AG i AL
အာနုဘော်	ʔ AC a AL n AG ṵ b AH ɔ AM
အာဖဂန်နစ်စတန်	ʔ AC a AL pʰ AI ə AL ɡ AC a AL ɴ AG n AG ɪ AL ʔ AC s AJ ə AL t AC a AL ɴ AG
အာဖရိက	ʔ AC a AL pʰ AI ə AL ɹ AB ḭ k AC a̰ AL
အာမခံ	ʔ AC a AL m AF a̰ AL ɡ AC a AL ɴ AG
အာမခံသေတ္တာ	ʔ AC a AL m AF a̰ AL ɡ AC a AL ɴ AG θ AJ ɪ AL ʔ AC t AC a AL
အာမေဍိတ်	ʔ AC a AL m AF e AL d AC e AL ɪ AL ʔ AC
အာမေးနီးယား	ʔ AC a AL m AF e AL n AG i AL j AB a AL
အာယုဗ္ဗေဒ	ʔ AC a AL j AB o AM ʊ AM ʔ AC b AH e AL d AC a̰ AL
အာရပ်	ʔ AC a AL ɹ AB a AL ʔ AC
အာရာမ	ʔ AC a AL j AB a AL m AF a̰ AL
အာရာမ်	ʔ AC a AL j AB a AL ɴ AG
အာရိုက်	ʔ AC a AL j AB a AL ɪ AL ʔ AC
အာရုံကြော	ʔ AC a AL j AB o AM ʊ AM ɴ AG d AC ʑ AJ ɔ AM
အာရှ	ʔ AC a AL ʃ AJ a̰ AL
အာလယ	ʔ AC a AL l AE ə AL j AB a̰ AL
အာလာပသလ္လာပ	ʔ AC a AL l AE a AL p AH a̰ AL θ AJ ə AL l AE a AL p AH a̰ AL
အာလူး	ʔ AC a AL l AE u AM
အာလူးပူရီ	ʔ AC a AL l AE u AM p AH u AM j AB i AL
အာလူးဖုတ်	ʔ AC a AL l AE u AM pʰ AI o AM ʊ AM ʔ AC
အာဝါဟဝိဝါဟ	ʔ AC a AL w AK a AL h AA a̰ AL w AK ḭ w AK a AL h AA a̰ AL
အာဟာရ	ʔ AC a AL h AA a AL j AB a̰ AL
အာဟာရဗေဒ	ʔ AC a AL h AA a AL j AB a̰ AL b AH e AL d AC a̰ AL
အား	ʔ AC a AL
အားကစား	ʔ AC a AL ɡ AC ə AL z AJ a AL
အားကိုး	ʔ AC a AL k AC o AM
အားနည်း	ʔ AC a AL n AG ɛ AL
အားနာ	ʔ AC a AL n AG a AL
အားနာပါးနာ	ʔ AC a AL n AG a AL p AH a AL n AG a AL
အားလပ်ရက်	ʔ AC a AL l AE a AL ʔ AC j AB ɛ AL ʔ AC
အားလုံး	ʔ AC a AL l AE o AM ʊ AM ɴ AG
အိတ်	ʔ AC e AL ɪ AL ʔ AC
အိန္ဒိယ	ʔ AC e AL ɪ AL ɴ AG d AC ḭ j AB a̰ AL
အိန္ဒြာ	ʔ AC e AL ɪ AL ɴ AG d AC ɹ AB a AL
အိန္ဒြေ	ʔ AC e AL ɪ AL ɴ AG d AC ɹ AB e AL
အိပ်	ʔ AC e AL ɪ AL ʔ AC
အိပ်ခန်း	ʔ AC e AL ɪ AL ʔ AC kʰ AD a AL ɴ AG
အိပ်မက်	ʔ AC e AL ɪ AL ʔ AC m AF ɛ AL ʔ AC
အိပ်ရာ	ʔ AC e AL ɪ AL ʔ AC j AB a AL
အိပ်ရာလိပ်	ʔ AC e AL ɪ AL ʔ AC j AB a AL l AE e AL ɪ AL ʔ AC
အိမ်	ʔ AC e AL ɪ AL ɴ AG
အိမ်တက်မင်္ဂလာ	ʔ AC e AL ɪ AL ɴ AG t AC ɛ AL ʔ AC m AF ɪ AL ɴ AG ɡ AC ə AL l AE a AL
အိမ်ထောင်	ʔ AC e AL ɪ AL ɴ AG tʰ AD a AL ʊ AM ɴ AG
အိမ်ထောင်ပြု	ʔ AC e AL ɪ AL ɴ AG d AC a AL ʊ AM ɴ AG p AH j AB ṵ
အိမ်နီးချင်း	ʔ AC e AL ɪ AL ɴ AG n AG i AL d AC ʑ AJ ɪ AL ɴ AG
အိမ်မြှောင်	ʔ AC e AL ɪ AL ɴ AG m̥ AF j AB a AL ʊ AM ɴ AG
အိမ်ရှေ့မင်း	ʔ AC e AL ɪ AL ɴ AG ʃ AJ ḛ m AF ɪ AL ɴ AG
အိမ်ရှေ့မင်းသား	ʔ AC e AL ɪ AL ɴ AG ʃ AJ ḛ m AF ɪ AL ɴ AG ð AJ a AL
အိမ်လည်	ʔ AC e AL ɪ AL ɴ AG l AE e AL
အိမ်သာ	ʔ AC e AL ɪ AL ɴ AG ð AJ a AL
အိမ်သူ	ʔ AC e AL ɪ AL ɴ AG ð AJ u AM
အို	ʔ AC o AM
အိုက်စလန်	ʔ AC a AL ɪ AL ʔ AC s AJ ə AL l AE a AL ɴ AG
အိုက်တင်	ʔ AC a AL ɪ AL ʔ AC t AC ɪ AL ɴ AG
အိုင်ဒီယာ	ʔ AC a AL ɪ AL ɴ AG d AC i AL j AB a AL
အိုင်ဗရီကို့စ်	ʔ AC a AL ɪ AL ɴ AG b AH ə AL ɹ AB i AL k AC o̰ AM s AJ
အိုင်ယာလန်	ʔ AC a AL ɪ AL ɴ AG j AB ə AL l AE a AL ɴ AG
အိုင်အိုင်	ʔ AC a AL ɪ AL ɴ AG ʔ AC a AL ɪ AL ɴ AG
အိုဗာတင်း	ʔ AC o AM b AH a AL t AC ɪ AL ɴ AG
အိုမန်	ʔ AC o AM m AF a AL ɴ AG
အိုရှန်းနီးယား	ʔ AC o AM ʃ AJ a AL ɴ AG n AG i AL j AB a AL
အိုလံပစ်	ʔ AC o AM l AE a AL ɴ AG p AH ɪ AL ʔ AC
အိုး	ʔ AC o AM
အီကြာကွေး	ʔ AC i AL t AC ɕ AJ a AL k AC w AK e AL
အီကွေတာ	ʔ AC i AL k AC w AK e AL t AC a AL
အီကွေတာဂီနီ	ʔ AC i AL k AC w AK e AL t AC a AL ɡ AC i AL n AG i AL
အီကွေဒေါ	ʔ AC i AL k AC w AK e AL d AC ɔ AM
အီဂျစ်	ʔ AC i AL d AC ʑ AJ ɪ AL ʔ AC
အီစတာ	ʔ AC i AL s AJ ə AL t AC a AL
အီတလီ	ʔ AC i AL t AC a̰ AL l AE i AL
အီနောင်	ʔ AC i AL n AG a AL ʊ AM ɴ AG
အီရတ်	ʔ AC i AL ɹ AB a AL ʔ AC
အီရန်	ʔ AC i AL ɹ AB a AL ɴ AG
အီရီထရီးယား	ʔ AC i AL ɹ AB i AL tʰ AD ə AL ɹ AB i AL j AB a AL
အီသီယိုးပီးယား	ʔ AC i AL θ AJ i AL j AB o AM p AH i AL j AB a AL
အီး	ʔ AC i AL
အီးပေါက်	ʔ AC i AL p AH a AL ʊ AM ʔ AC
အီးမေးလ်	ʔ AC i AL m AF e AL l AE
အုတ်	ʔ AC o AM ʊ AM ʔ AC
အုတ်ကြွပ်	ʔ AC o AM ʊ AM ʔ AC t AC ɕ AJ ʊ AM ʔ AC
အုန်း	ʔ AC o AM ʊ AM ɴ AG
အုန်းဆီ	ʔ AC o AM ʊ AM ɴ AG z AJ i AL
အုန်းထမင်း	ʔ AC o AM ʊ AM ɴ AG tʰ AD ə AL m AF ɪ AL ɴ AG
အုန်းနို့	ʔ AC o AM ʊ AM ɴ AG n AG o̰ AM
အုန်းနို့ခေါက်ဆွဲ	ʔ AC o AM ʊ AM ɴ AG n AG o̰ AM kʰ AD a AL ʊ AM ʔ AC sʰ BA w AK ɛ AL
အုန်းမှန်ကူ	ʔ AC o AM ʊ AM ɴ AG m̥ AF a AL ɴ AG ɡ AC u AM
အုံး	ʔ AC o AM ʊ AM ɴ AG
အူ	ʔ AC u AM
အူမကြီး	ʔ AC u AM m AF a̰ AL d AC ʑ AJ i AL
အောက်	ʔ AC a AL ʊ AM ʔ AC
အောက်ဆီဂျင်	ʔ AC a AL ʊ AM ʔ AC sʰ BA i AL d AC ʑ AJ ɪ AL ɴ AG
အောက်တိုဘာ	ʔ AC a AL ʊ AM ʔ AC t AC o AM b AH a AL
အောက်မြစ်	ʔ AC a AL ʊ AM ʔ AC m AF j AB ɪ AL ʔ AC
အောက်လွှတ်တော်	ʔ AC a AL ʊ AM ʔ AC l̥ AE ʊ AM ʔ AC t AC ɔ AM
အောက်သား	ʔ AC a AL ʊ AM ʔ AC ð AJ a AL
အောင်	ʔ AC a AL ʊ AM ɴ AG
အောင်ပွဲ	ʔ AC a AL ʊ AM ɴ AG b AH w AK ɛ AL
အောင်လံ	ʔ AC a AL ʊ AM ɴ AG l AE a AL ɴ AG
အော့	ʔ AC ɔ̰ AM
အော့အန်	ʔ AC ɔ̰ AM ʔ AC a AL ɴ AG
အော်	ʔ AC ɔ AM
အော်ကေ့ကြည်	ʔ AC ɔ AM k AC ḛ t AC ɕ AJ i AL
အော်တိုမေးရှင်း	ʔ AC ɔ AM t AC o AM m AF e AL ʃ AJ ɪ AL ɴ AG
အော်ဒါ	ʔ AC ɔ AM d AC a AL
အော်ပရာ	ʔ AC ɔ AM p AH ə AL ɹ AB a AL
အေး	ʔ AC e AL
အဲဒါ	ʔ AC ɛ AL d AC a AL
အဲဒါဘာလဲ	ʔ AC ɛ AL d AC a AL b AH a AL l AE ɛ AL
အဲဒီ	ʔ AC ɛ AL d AC i AL
အဲဒီဟာ	ʔ AC ɛ AL d AC i AL h AA a AL
အဲလစ်ဇဘက်	ʔ AC ɛ AL l AE ɪ AL ʔ AC z AJ a̰ AL b AH ɛ AL ʔ AC
ဣ	ʔ AC ḭ
ဣန္ဒာ	ʔ AC ḭ n AG d AC a AL
ဣန္ဒြေ	ʔ AC e AL ɪ AL ɴ AG d AC ɹ AB e AL
ဣရိယာပုတ်	ʔ AC ḭ ɹ AB ḭ j AB a AL b AH o AM ʊ AM ʔ AC
ဥ	ʔ AC ṵ
ဥက္ကဋ္ဌ	ʔ AC o AM ʊ AM ʔ AC k AC ə AL θ AJ a̰ AL
ဥက္ကာ	ʔ AC o AM ʊ AM ʔ AC k AC a AL
ဥက္ကာခဲ	ʔ AC o AM ʊ AM ʔ AC k AC a AL ɡ AC ɛ AL
ဥက္ကာပျံ	ʔ AC o AM ʊ AM ʔ AC k AC a AL b AH j AB a AL ɴ AG
ဥဂ္ဂါ	ʔ AC ṵ ɡ AC ɡ AC a AL
ဥစ္စာ	ʔ AC o AM ʊ AM ʔ AC s AJ a AL
ဥဇဘက်ကစ္စတန်	ʔ AC ṵ z AJ ə AL b AH ɛ AL ʔ AC k AC ɪ AL ʔ AC s AJ ə AL t AC a AL ɴ AG
ဥဏ္ဏလုံ	ʔ AC o AM ʊ AM ɴ AG n AG ə AL l AE o AM ʊ AM ɴ AG
ဥဏ္ဏလုံမွေးရှင်	ʔ AC o AM ʊ AM ɴ AG n AG ə AL l AE o AM ʊ AM ɴ AG m̥ AF w AK e AL ʃ AJ ɪ AL ɴ AG
ဥဏှဂူ	ʔ AC o AM ʊ AM ɴ AG n̥ AG ə AL ɡ AC u AM
ဥဏှိဿ	ʔ AC ṵ n̥ AG e AL ɪ AL ʔ AC θ AJ a̰ AL
ဥတု	ʔ AC ṵ d AC ṵ
ဥတ္တရ	ʔ AC o AM ʊ AM ʔ AC t AC ə AL j AB a̰ AL
ဥတ္တရခဏ္ဍ	ʔ AC o AM ʊ AM ʔ AC t AC ə AL ɹ AB a̰ AL kʰ AD a AL n AG d AC a̰ AL
ဥဒေါင်း	ʔ AC ṵ d AC a AL ʊ AM ɴ AG
ဥပဒေ	ʔ AC ṵ b AH a̰ AL d AC e AL
ဥပဒေပညာ	ʔ AC ṵ b AH ə AL d AC e AL p AH j AB ɪ AL ɴ AG ɲ AG a AL
ဥပဓိရုပ်	ʔ AC ṵ p AH a̰ AL d AC ḭ j AB o AM ʊ AM ʔ AC
ဥပမာ	ʔ AC ṵ b AH ə AL m AF a AL
ဥပရာဇာ	ʔ AC ṵ p AH ə AL ɹ AB a AL z AJ a AL
ဥပါကြယ်	ʔ AC ṵ p AH a AL t AC ɕ AJ ɛ AL
ဥပါဒါန်	ʔ AC ṵ p AH a AL d AC a AL n AG
ဥပါယ်	ʔ AC ṵ p AH ɛ AL
ဥပါလိ	ʔ AC ṵ p AH a AL l AE ḭ
ဥပုသ်	ʔ AC ṵ b AH o AM ʊ AM ʔ AC
ဥပေက္ခါ	ʔ AC ṵ p AH ɛ AL ʔ AC kʰ AD a AL
ဥမင်	ʔ AC ṵ m AF ɪ AL ɴ AG
ဥမ္မာ	ʔ AC ṵ m AF m AF a AL
ဥယျာဉ်	ʔ AC ṵ j AB ɪ AL ɴ AG
ဥရုဂွေး	ʔ AC ṵ ɹ AB ṵ ʔ AC ṵ ɡ AC w AK e AL
ဥရောပ	ʔ AC ṵ ɹ AB ɔ AM p AH a̰ AL
ဥသျှစ်	ʔ AC o AM ʊ AM ʔ AC ʃ AJ ɪ AL ʔ AC
ဥုံ	ʔ AC o AM ʊ AM ɴ AG
ဥဿဖရား	ʔ AC o AM ʊ AM ʔ AC θ AJ ə AL pʰ AI ə AL j AB a AL
ဦလန်ဘာတာ	ʔ AC u AM l AE a AL ɴ AG b AH a AL t AC a AL
ဦး	ʔ AC u AM
ဦးကြီး	ʔ AC u AM d AC ʑ AJ i AL
ဦးခိုက်	ʔ AC u AM kʰ AD a AL ɪ AL ʔ AC
ဦးချ	ʔ AC u AM t AC ɕʰ BA a̰ AL
ဦးချို	ʔ AC u AM d AC ʑ AJ o AM
ဦးခွံ	ʔ AC u AM ɡ AC ʊ AM ɴ AG
ဦးထုပ်	ʔ AC o AM ʊ AM ʔ AC tʰ AD o AM ʊ AM ʔ AC
ဦးနှောက်	ʔ AC o AM ʊ AM ɴ AG n̥ AG a AL ʊ AM ʔ AC
ဦးပဉ္စင်း	ʔ AC u AM b AH ə AL z AJ ɪ AL ɴ AG
ဦးလေး	ʔ AC u AM l AE e AL
ဧက	ʔ AC e AL k AC a̰ AL
ဧကရာဇ်	ʔ AC e AL ɡ AC ə AL ɹ AB ɪ AL ʔ AC
ဧကရီ	ʔ AC e AL k AC ə AL j AB i AL
ဧကာဒသမ	ʔ AC e AL k AC a AL d AC a̰ AL θ AJ ə AL m AF a̰ AL
ဧည့်	ʔ AC ḛ
ဧည့်သည်	ʔ AC ḛ ð AJ e AL
ဧဏီ	ʔ AC e AL n AG i AL
ဧပြီ	ʔ AC e AL b AH j AB i AL
ဩကာသ	ʔ AC ɔ AM ɡ AC a AL θ AJ a̰ AL
ဩဂုတ်	ʔ AC ɔ AM ɡ AC o AM ʊ AM ʔ AC
ဩစတြီးယား	ʔ AC ɔ AM s AJ ə AL t AC ə AL ɹ AB i AL j AB a̰ AL
ဩစတြေးလျ	ʔ AC ɔ AM s AJ ə AL t AC ə AL ɹ AB e AL l AE j AB a̰ AL
ဩဇာ	ʔ AC ɔ AM z AJ a AL
ဩဇာသီး	ʔ AC ɔ AM z AJ a AL θ AJ i AL
ဩဌဇ	ʔ AC ɔ AM tʰ AD ə AL z AJ a̰ AL
ဩရသ	ʔ AC ɔ AM j AB ə AL θ AJ a̰ AL
ဩရိဿ	ʔ AC ɔ AM ɹ AB e AL ɪ AL ʔ AC θ AJ a̰ AL
ဩသဓ	ʔ AC ɔ AM θ AJ ə AL d AC a̰ AL
၌	n̥ AG a AL ɪ AL ʔ AC
၍	j AB w AK ḛ
၎	l AE ə AL ɡ AC a AL ʊ AM ɴ AG
၎င်း	l AE ə AL ɡ AC a AL ʊ AM ɴ AG
၏	ʔ AC ḭ
