က	k a̰ AG
ကကုသန်	k a̰ AG k ṵ θ a AD ɴ
ကကုသန်ဘုရား	k a̰ AG k ṵ θ a AD ɴ pʰ ə AD j AB a AD
ကက်စီနို	k ɛ AD ʔ s i AD n o AE
ကက်ပတိန်	k ɛ AD ʔ p ə AD t e AD ɪ AD ɴ
ကက်သလစ်	k ɛ AD ʔ θ ə AD l ɪ AD ʔ
ကကြီး	k a̰ AG d ʑ i AD
ကချင်	k ə AD t ɕʰ ɪ AD ɴ
ကချေသည်	k a̰ AG d ʑ e AD ð e AD
ကင်ဆာရောဂါ	k ɪ AD ɴ sʰ a AD j AB ɔ AE ɡ a AD
ကင်ညာ	k ɪ AD ɴ ɲ a AD
ကင်ပွန်း	k ɪ AD ɴ b ʊ AE ɴ
ကင်မရာ	k ɪ AD ɴ m ə AD ɹ AI a AD
ကင်မရွန်း	k ɪ AD ɴ m a̰ AG ɹ AI ʊ AE ɴ
ကင်း	k ɪ AD ɴ
ကင်းခြေများ	k ɪ AD ɴ t ɕ i AD m j AB a AD
ကင်းပုံ	k ɪ AD ɴ b o AE ʊ AE ɴ
ကင်းမြီးကောက်	k ɪ AD ɴ m j AB i AD ɡ a AD ʊ AE ʔ
ကင်းမွန်	k ɪ AD ɴ m ʊ AE ɴ
ကစား	ɡ ə AD z a AD
ကစားကွင်း	ɡ ə AD z a AD ɡ w AC ɪ AD ɴ
ကစားစရာ	ɡ ə AD z a AD z ə AD j AB a AD
ကစားသမား	ɡ ə AD s a AD ð ə AD m a AD
ကဆုန်	k ə AD sʰ o AE ʊ AE ɴ
ကဆုန်လပြည့်နေ့	k ə AD sʰ o AE ʊ AE ɴ l a̰ AG p j AB ḭ n ḛ
ကညာ	k ə AD ɲ a AD
ကညွတ်ရိုး	k ə AD ɲ ʊ AE ʔ j AB o AE
ကဏန်း	ɡ ə AD n a AD ɴ
ကဏ္ဍ	k a AD n d a̰ AG
ကတည်းက	ɡ ə AD d ɛ AD ɡ a̰ AG
ကတိ	ɡ ə AD d ḭ
ကတော့	ɡ ə AD d ɔ̰ AH
ကတော်	ɡ ə AD d ɔ AE
ကတ္တား	k a AD ʔ t a AD
ကတ္တီပါ	ɡ ə AD d i AD b a AD
ကတ်	k a AD ʔ
ကတ်ကြေး	k a AD ʔ t ɕ i AD
ကတ်ကြေးကိုက်	k a AD ʔ t ɕ i AD k a AD ɪ AD ʔ
ကတ်ပြား	k a AD ʔ p j AB a AD
ကတ်သလိတ်	k a AD ʔ θ ə AD l e AD ɪ AD ʔ
ကတွတ်ယို	k ə AD d ʊ AE ʔ j AB o AE
ကထိန်	k ə AD tʰ e AD ɪ AD ɴ
ကဒ်	k a AD d
ကနခို	k ə AD n ə AD kʰ o AE
ကနစိုး	k ə AD n ə AD z o AE
ကနား	k ə AD n a AD
ကနုကမာ	k ə AD n ṵ k ə AD m a AD
ကနုတ်	k ə AD n o AE ʊ AE ʔ
ကနေဒါ	k a̰ AG n e AD d a AD
ကန့်	k a̰ AG ɴ
ကန့်လန့်ကာ	k ə AD l ə AD ɡ a AD
ကန္တာရ	k a AD ɴ t a AD j AB a̰ AG
ကန်	k a AD ɴ
ကန်စွန်း	ɡ ə AD z ʊ AE ɴ
ကန်စွန်းဥ	ɡ ə AD z ʊ AE ɴ ʔ ṵ
ကန်တော့	ɡ ə AD d ɔ̰ AH
ကန်ထရိုက်	k a AD ɴ tʰ ə AD ɹ AI a AD ɪ AD ʔ
ကပ္ပလီ	k a AD ʔ p ə AD l i AD
ကပ္ပလီပင်လယ်	k a AD ʔ p ə AD l i AD p ɪ AD ɴ l ɛ AD
ကပ်	k a AD ʔ
ကပ်ကြီးသုံးပါး	k a AD ʔ d ʑ i AD θ o AE ʊ AE ɴ b a AD
ကပ်နာ	k a AD ʔ n a AD
ကပ်ပယ်	k a AD ʔ p ɛ AD
ကပ်ပါး	k a AD ʔ p a AD
ကပ်ရောဂါ	k a AD ʔ j AB ɔ AE ɡ a AD
ကပွဲရုံ	k a̰ AG b w AC ɛ AD j AB o AE ʊ AE ɴ
ကဖီး	k ə AD pʰ i AD
ကဗျာ	ɡ ə AD b j AB a AD
ကဘီလူး	k a̰ AG b ə AD l u AE
ကမန်	k a̰ AG m a AD ɴ
ကမာ	k ə AD m a AD
ကမာရွတ်	k ə AD m a AD j AB ʊ AE ʔ
ကမ္ဗလာ	ɡ ə AD b ə AD l a AD
ကမ္ဗောဇ	k a AD ɴ b ɔ AE z a̰ AG
ကမ္ဘာ	ɡ ə AD b a AD
ကမ္ဘာဂြိုဟ်	ɡ ə AD b a AD d ʑ o AE
ကမ္ဘာလုံးခြမ်း	ɡ ə AD b a AD l o AE ʊ AE ɴ d ʑ a AD ɴ
ကမ္ဘောဒီးယား	k a AD ɴ b ɔ AE d i AD j AB a AD
ကမ်စော်	k a AD ɴ z ɔ AE
ကမ်း	k a AD ɴ
ကမ်းခြေ	k a AD ɴ d ʑ e AD
ကယား	k ə AD j AB a AD
ကယ်တင်ရှင်	k ɛ AD t ɪ AD ɴ ʃ ɪ AD ɴ
ကယ်လဆီယမ်	k ɛ AD l ə AD sʰ i AD j AB a AD ɴ
ကရင်	k ə AD j AB ɪ AD ɴ
ကရစ်ကက်	k ə AD ɹ AI ɪ AD ʔ k ɛ AD ʔ
ကရဝိက်	k ə AD ɹ AI a̰ AG w AC e AD ɪ AD ʔ
ကရိန်း	k ə AD ɹ AI e AD ɪ AD ɴ
ကလပ်	k ə AD l a AD ʔ
ကလမောင်း	k ə AD l ə AD m a AD ʊ AE ɴ
ကလာပ်စည်း	k ə AD l a AD ʔ s i AD
ကလိုရင်း	k ə AD l o AE ɹ AI ɪ AD ɴ
ကလီစာ	k ə AD l i AD z a AD
ကလောင်	k ə AD l a AD ʊ AE ɴ
ကလေး	kʰ ə AD l e AD
ကလျာ	k ə AD l ə AD j AB a AD
ကလျာဏမိတ္တ	k ə AD l ə AD j AB a AD n a̰ AG m e AD ɪ AD ʔ t a̰ AG
ကလျာဏီ	k ə AD l ə AD j AB a AD n i AD
ကဝိ	k ə AD w AC ḭ
ကဝေ	k ə AD w AC e AD
ကသည်း	k ə AD θ i AD
ကာ	k a AD
ကာကွယ်	k a AD ɡ w AC ɛ AD
ကာကွယ်ဆေး	k a AD ɡ w AC ɛ AD z e AD
ကာကွယ်ရေး	k a AD ɡ w AC ɛ AD j AB e AD
ကာဂစ်စတန်	k ə AD ɡ ɪ AD ʔ s ə AD t a AD ɴ
ကာဂျစ္စတန်	k ə AD d ʑ ɪ AD ʔ s ə AD t a AD ɴ
ကာဇက်စတန်	k a AD z ɛ AD ʔ s ə AD t a AD ɴ
ကာတာ	k a AD t a AD
ကာတွန်း	k a AD t ʊ AE ɴ
ကာဗွန်	k a AD b ʊ AE ɴ
ကာမ	k a AD m a̰ AG
ကာယ	k ə AD j AB a̰ AG
ကာယကံ	k a AD j AB ə AD ɡ a AD ɴ
ကာယပညာ	k a AD j AB a̰ AG p a̰ AG ɲ a AD
ကာရန်	k ə AD j AB a AD ɴ
ကာလ	k a AD l a̰ AG
ကာလဝမ်း	k a AD l ə AD w AC ʊ AE ɴ
ကာလသား	k a AD l ə AD ð a AD
ကာလသားရောဂါ	k a AD l a̰ AG θ a AD j AB ɔ AE ɡ a AD
ကာလာမသုတ်	k a AD l a AD m a̰ AG θ o AE ʊ AE ʔ
ကာလီဖိုးနီးယား	k a AD l i AD pʰ o AE n i AD j AB a AD
ကား	k a AD
ကားဂိတ်	k a AD ɡ e AD ɪ AD ʔ
ကားမှတ်တိုင်	k a AD m̥ a AD ʔ t a AD ɪ AD ɴ
ကားရုံ	k a AD j AB o AE ʊ AE ɴ
ကိစ္စ	k e AD ɪ AD ʔ s a̰ AG
ကိတ်	k e AD ɪ AD ʔ
ကိတ်ဗာဒီ	k e AD ɪ AD ʔ b ə AD d i AD
ကိတ်မုန့်	k e AD ɪ AD ʔ m o̰ AH ʊ AE ɴ
ကိန္နရာ	k e AD ɪ AD ɴ n ə AD j AB a AD
ကိန္နရီ	k e AD ɪ AD ɴ n ə AD j AB i AD
ကိန်း	k e AD ɪ AD ɴ
ကိမိလဗေဒ	k ḭ m ḭ l a̰ AG b e AD d a̰ AG
ကိရိယာ	k ə AD ɹ AI ḭ j AB a AD
ကိလေသာ	k ḭ l e AD θ a AD
ကို	ʔ
ကိုကာကိုလာ	k o AE k a AD k o AE l a AD
ကိုက်	k a AD ɪ AD ʔ
ကိုက်လန်	k a AD ɪ AD ʔ l a AD ɴ
ကိုင်	k a AD ɪ AD ɴ
ကိုဆိုဗို	k o AE sʰ o AE b o AE
ကိုဘော့	k o AE b ɔ̰ AH
ကိုမိုရို	k o AE m o AE ɹ AI o AE
ကိုယ့်ဥမှဥထင်	k o̰ AH j AB ʔ ṵ m̥ a̰ AG ʔ ṵ tʰ ɪ AD ɴ
ကိုယ်	k o AE
ကိုယ်စားလှယ်	k o AE j AB z ə AD l̥ ɛ AD
ကိုယ်လုပ်တော်	k o AE l o AE ʊ AE ʔ t ɔ AE
ကိုယ်ဝန်	k o AE j AB w AC ʊ AE ɴ
ကိုယ်ဝန်ဆောင်	k o AE j AB w AC ʊ AE ɴ sʰ a AD ʊ AE ɴ
ကိုယ်ဝန်ရှိ	k o AE j AB w AC ʊ AE ɴ ʃ ḭ
ကိုရမ်ကျမ်း	k o AE ɹ AI a AD ɴ t ɕ a AD ɴ
ကိုရီးယား	k o AE ɹ AI i AD j AB a AD
ကိုလိုနီ	k o AE l o AE n i AD
ကိုလံဘီယာ	k o AE l a AD ɴ b i AD j AB a AD
ကိုး	k o AE
ကိုးကန့်	k o AE ɡ a̰ AG ɴ
ကိုးလ	k o AE l a̰ AG
ကီလိုဂရမ်	k i AD l o AE ɡ ə AD ɹ AI a AD ɴ
ကီးမား	k i AD m a AD
ကီးယက်	k i AD j AB ɛ AD ʔ
ကုဋေ	ɡ ə AD d e AD
ကုတ်	k o AE ʊ AE ʔ
ကုတ်ဟီးနာ	k o AE ʊ AE ʔ h AA i AD n a AD
ကုန်	k o AE ʊ AE ɴ
ကုန်ကား	k o AE ʊ AE ɴ ɡ a AD
ကုန်ကုန်	k o AE ʊ AE ɴ ɡ o AE ʊ AE ɴ
ကုန်စည်	k o AE ʊ AE ɴ z i AD
ကုန်တင်ကား	k o AE ʊ AE ɴ d ɪ AD ɴ ɡ a AD
ကုန်သည်	k o AE ʊ AE ɴ ð e AD
ကုန်း	k o AE ʊ AE ɴ
ကုန်းနှီး	k o AE ʊ AE ɴ n̥ i AD
ကုဗ	k ṵ b a̰ AG
ကုမ္ပဏီ	k o AE ʊ AE ɴ p ə AD n i AD
ကုလသမဂ္ဂ	k ṵ l a̰ AG θ a̰ AG m ɛ AD ʔ ɡ a̰ AG
ကုလား	k ə AD l a AD
ကုလားထိုင်	k ə AD l ə AD tʰ a AD ɪ AD ɴ
ကုလားနို့	k ə AD l ə AD n o̰ AH
ကုလားပဲ	k ə AD l ə AD p ɛ AD
ကုလားဖြူ	k ə AD l ə AD pʰ j AB u AE
ကုလားအုတ်	k ə AD l ə AD ʔ o AE ʊ AE ʔ
ကုသိုလ်	k ṵ θ o AE
ကုသိုလ်ကံ	k ṵ ð o AE ɡ a AD ɴ
ကုသိုလ်ရှင်	k ṵ θ o AE ʃ ɪ AD ɴ
ကုံကုမံ	ɡ o AE ʊ AE ɴ ɡ ə AD m a AD ɴ
ကူ	k u AE
ကူညီ	k u AE ɲ i AD
ကူဖီ	k u AE pʰ i AD
ကူလီ	k u AE l i AD
ကူဝိတ်	k u AE w AC e AD ɪ AD ʔ
ကူး	k u AE
ကူးစက်ရောဂါ	k u AE z ɛ AD ʔ j AB ɔ AE ɡ a AD
ကူးတို့	ɡ ə AD d o̰ AH
ကူးတို့ဆိပ်	ɡ ə AD d o̰ AH z e AD ɪ AD ʔ
ကူးပြောင်း	k u AE p j AB a AD ʊ AE ɴ
ကေ	k e AD
ကေတုမဒီ	k e AD t ṵ m ə AD d i AD
ကေသ	k e AD θ a̰ AG
ကေသာ	k e AD θ a AD
ကော	ɡ ɔ AE
ကောက်	k a AD ʊ AE ʔ
ကောက်ညှင်း	k a AD ʊ AE ʔ ɲ̊ ɪ AD ɴ
ကောက်ညှင်းပေါင်း	k a AD ʊ AE ʔ ɲ̊ ɪ AD ɴ b a AD ʊ AE ɴ
ကောက်ရိုး	k a AD ʊ AE ʔ j AB o AE
ကောင်	k a AD ʊ AE ɴ
ကောင်ငယ်	k a AD ʊ AE ɴ ŋ ɛ AD
ကောင်စစ်ဝန်	k a AD ʊ AE ɴ s ɪ AD ʔ w AC ʊ AE ɴ
ကောင်စစ်ဝန်ရုံး	k a AD ʊ AE ɴ s ɪ AD ʔ w AC ʊ AE ɴ j AB o AE ʊ AE ɴ
ကောင်စီ	k a AD ʊ AE ɴ s i AD
ကောင်တာ	k a AD ʊ AE ɴ t a AD
ကောင်မငယ်	k a AD ʊ AE ɴ m a̰ AG ŋ ɛ AD
ကောင်မလေး	k a AD ʊ AE ɴ m a̰ AG l e AD
ကောင်း	k a AD ʊ AE ɴ
ကောင်းကင်	k a AD ʊ AE ɴ ɡ ɪ AD ɴ
ကောင်းကင်ကြိုး	k a AD ʊ AE ɴ ɡ ɪ AD ɴ d ʑ o AE
ကောင်းကင်တမန်	k a AD ʊ AE ɴ ɡ ɪ AD ɴ t ə AD m a AD ɴ
ကောင်းကင်ဘုံ	k a AD ʊ AE ɴ ɡ ɪ AD ɴ b o AE ʊ AE ɴ
ကောင်းကောင်း	k a AD ʊ AE ɴ ɡ a AD ʊ AE ɴ
ကောဏဂုံ	k ɔ AE n ə AD ɡ o AE ʊ AE ɴ
ကောဏဂုံဘုရား	k ɔ AE n ə AD ɡ o AE ʊ AE ɴ pʰ ə AD j AB a AD
ကောဏ္ဍည	k ɔ AE n d ə AD ɲ a̰ AG
ကောဏ္ဍညဘုရား	k ɔ AE n d ə AD ɲ a̰ AG pʰ ə AD j AB a AD
ကောလာဟလ	k ɔ AE l a AD h AA a̰ AG l a̰ AG
ကောလိပ်	k ɔ AE l e AD ɪ AD ʔ
ကောလိသိန်	k ɔ AE l ḭ θ e AD ɪ AD ɴ
ကော့စတာရီကာ	k ɔ̰ AH s ə AD t a AD ɹ AI i AD k a AD
ကော်	k ɔ AE
ကော်ဇော	k ɔ AE z ɔ AE
ကော်တွန်	k ɔ AE t ʊ AE ɴ
ကော်ပီ	k ɔ AE p i AD
ကော်ပီစာအုပ်	k ɔ AE p i AD s a AD ʔ o AE ʊ AE ʔ
ကော်ပြန့်	k ɔ AE p j AB a̰ AG ɴ
ကော်ပြန့်ကြော်	k ɔ AE p j AB a̰ AG ɴ d ʑ ɔ AE
ကော်ပြန့်စိမ်း	k ɔ AE p j AB a̰ AG ɴ z e AD ɪ AD ɴ
ကော်ဖီ	k ɔ AE pʰ i AD
ကော်မတီ	k ɔ AE m ə AD t i AD
ကော်ရည်ခေါက်ဆွဲ	k ɔ AE j AB i AD kʰ a AD ʊ AE ʔ sʰ w AC ɛ AD
ကော်လာ	k ɔ AE l a AD
ကဲ့	k ɛ̰ AG
ကံ	k a AD ɴ
ကံကြမ္မာ	k a AD ɴ t ɕ ə AD m a AD
ကံသုံးပါး	k a AD ɴ θ o AE ʊ AE ɴ b a AD
ကံ့ကူတံ	k a̰ AG ɴ ɡ u AE d a AD ɴ
ကံ့ကော်	ɡ a̰ AG ɴ ɡ ɔ AE
ကျ	t ɕ a̰ AG
ကျက်သရေ	t ɕ ɛ AD ʔ θ ə AD j AB e AD
ကျင်ကြီး	t ɕ ɪ AD ɴ d ʑ i AD
ကျင်ချောင်း	t ɕ ɪ AD ɴ t ɕʰ a AD ʊ AE ɴ
ကျင်စွယ်	t ɕ ɪ AD ɴ z w AC ɛ AD
ကျဉ်း	t ɕ ɪ AD ɴ
ကျဉ်းကျပ်	t ɕ ɪ AD ɴ t ɕ a AD ʔ
ကျည်	t ɕ i AD
ကျည်ကပ်	t ɕ i AD ɡ a AD ʔ
ကျည်ဖူး	t ɕ i AD b u AE
ကျနော်	t ɕ ə AD n ɔ AE
ကျန်	t ɕ a AD ɴ
ကျန်း	t ɕ a AD ɴ
ကျန်းမာရေး	t ɕ a AD ɴ m a AD j AB e AD
ကျပ်	t ɕ a AD ʔ
ကျပ်သား	t ɕ a AD ʔ θ a AD
ကျမ	t ɕ ə AD m a̰ AG
ကျယ်	t ɕ ɛ AD
ကျယ်ဝန်း	t ɕ ɛ AD w AC ʊ AE ɴ
ကျား	t ɕ a AD
ကျားကျားလျားလျား	t ɕ a AD d ʑ a AD j AB a AD j AB a AD
ကျားမ	t ɕ a AD m a̰ AG
ကျားမျက်လုံး	t ɕ a AD m j AB ɛ AD ʔ l o AE ʊ AE ɴ
ကျားလက်သည်း	t ɕ a AD l ɛ AD ʔ θ ɛ AD
ကျားလျှာ	t ɕ a AD ʃ a AD
ကျားသစ်	t ɕ ə AD θ ɪ AD ʔ
ကျိန္တလီ	t ɕ e AD ɪ AD ɴ t a̰ AG l i AD
ကျိန်း	t ɕ e AD ɪ AD ɴ
ကျို	t ɕ o AE
ကျိုက္ခမီ	t ɕ a AD ɪ AD ʔ kʰ ə AD m i AD
ကျိုက်ထို	t ɕ a AD ɪ AD ʔ tʰ o AE
ကျိုက်ထီးရိုး	t ɕ a AD ɪ AD ʔ tʰ i AD j AB o AE
ကျိုက်မရော	t ɕ a AD ɪ AD ʔ m ə AD ɹ AI ɔ AE
ကျိုင်းတုံ	t ɕ a AD ɪ AD ɴ t o AE ʊ AE ɴ
ကျီး	t ɕ i AD
ကျီးအ	t ɕ i AD ʔ a̰ AG
ကျုပ်	t ɕ o AE ʊ AE ʔ
ကျုပ်တို့	t ɕ o AE ʊ AE ʔ t o̰ AH
ကျူးဘား	t ɕ u AE b a AD
ကျော	t ɕ ɔ AE
ကျောက်	t ɕ a AD ʊ AE ʔ
ကျောက်ကပ်	t ɕ a AD ʊ AE ʔ k a AD ʔ
ကျောက်ကြီး	t ɕ a AD ʊ AE ʔ t ɕ i AD
ကျောက်ဂွမ်း	t ɕ a AD ʊ AE ʔ ɡ ʊ AE ɴ
ကျောက်စိမ်း	t ɕ a AD ʊ AE ʔ s e AD ɪ AD ɴ
ကျောက်နီ	t ɕ a AD ʊ AE ʔ n i AD
ကျောက်ပွင့်သုပ်	t ɕ a AD ʊ AE ʔ p w AC ɪ̰ AG ɴ θ o AE ʊ AE ʔ
ကျောက်ဖရုံ	t ɕ a AD ʊ AE ʔ pʰ ə AD j AB o AE ʊ AE ɴ
ကျောက်ဖြူ	t ɕ a AD ʊ AE ʔ pʰ j AB u AE
ကျောက်မီး	t ɕ a AD ʊ AE ʔ m i AD
ကျောက်မီးသွေး	t ɕ a AD ʊ AE ʔ m i AD ð w AC e AD
ကျောက်သင်ပုန်း	t ɕ a AD ʊ AE ʔ θ ɪ AD ɴ b o AE ʊ AE ɴ
ကျောင်း	t ɕ a AD ʊ AE ɴ
ကျောင်းနေဖက်	t ɕ a AD ʊ AE ɴ n e AD b ɛ AD ʔ
ကျောင်းသား	t ɕ a AD ʊ AE ɴ ð a AD
ကျောင်းသုံးစာအုပ်	t ɕ a AD ʊ AE ɴ ð o AE ʊ AE ɴ s a AD ʔ o AE ʊ AE ʔ
ကျောင်းသူ	t ɕ a AD ʊ AE ɴ ð u AE
ကျောပိုးအိတ်	t ɕ ɔ AE b o AE ʔ e AD ɪ AD ʔ
ကျောရိုး	t ɕ ɔ AE j AB o AE
ကျေးဇူး	t ɕ e AD z u AE
ကျေးဇူးတင်	t ɕ e AD z u AE t ɪ AD ɴ
ကျေးဇူးတင်ပါတယ်	t ɕ e AD z u AE t ɪ AD ɴ b a AD d ɛ AD
ကျေးဇူးပြု၍	t ɕ e AD z u AE p j AB ṵ j AB w AC ḛ
ကျေးဇူးရှင်	t ɕ e AD z u AE ʃ ɪ AD ɴ
ကျဲ	t ɕ ɛ AD
ကျွန်	t ɕ ʊ AE ɴ
ကျွန်တော့်	t ɕ ʊ AE ɴ d ɔ̰ AH
ကျွန်တော်	t ɕ ʊ AE ɴ d ɔ AE
ကျွန်တော်တို့	t ɕ ʊ AE ɴ d ɔ AE d o̰ AH
ကျွန်မ	t ɕ ʊ AE ɴ m a̰ AG
ကျွန်မတို့	t ɕ ʊ AE ɴ m a̰ AG d o̰ AH
ကျွန်း	t ɕ ʊ AE ɴ
ကျွန်းကလေး	t ɕ ʊ AE ɴ ɡ ə AD l e AD
ကျွန်းကိုင်းမှီကိုင်းကျွန်းမှီ	t ɕ ʊ AE ɴ k a AD ɪ AD ɴ m̥ i AD k a AD ɪ AD ɴ t ɕ ʊ AE ɴ m̥ i AD
ကျွန်းဆွယ်	t ɕ ʊ AE ɴ z w AC ɛ AD
ကျွဲ	t ɕ w AC ɛ AD
ကျွဲကော	t ɕ w AC ɛ AD ɡ ɔ AE
ကျွဲပြည့်စင်	t ɕ w AC ɛ AD p j AB ḭ z ɪ AD ɴ
ကြက်	t ɕ ɛ AD ʔ
ကြက်ခြေ	t ɕ ɛ AD ʔ t ɕʰ e AD
ကြက်ခြေနီ	t ɕ ɛ AD ʔ t ɕʰ e AD n i AD
ကြက်ခြေနီအသင်း	t ɕ ɛ AD ʔ t ɕʰ e AD n i AD ʔ ə AD θ ɪ AD ɴ
ကြက်ဆင်	t ɕ ɛ AD ʔ sʰ ɪ AD ɴ
ကြက်ဆီထမင်း	t ɕ ɛ AD ʔ sʰ i AD tʰ ə AD m ɪ AD ɴ
ကြက်ဆူ	t ɕ ɛ AD ʔ sʰ u AE
ကြက်တူရွေး	t ɕ ɛ AD ʔ t u AE j AB w AC e AD
ကြက်ဖ	t ɕ ɛ AD ʔ pʰ a̰ AG
ကြက်မ	t ɕ ɛ AD ʔ m a̰ AG
ကြက်မောက်	t ɕ ɛ AD ʔ m a AD ʊ AE ʔ
ကြက်မောက်သီး	t ɕ ɛ AD ʔ m a AD ʊ AE ʔ θ i AD
ကြက်သား	t ɕ ɛ AD ʔ θ a AD
ကြက်သီးထ	t ɕ ɛ AD ʔ θ e AD ɪ AD ɴ tʰ a̰ AG
ကြက်သီးမွေးညင်းထ	t ɕ ɛ AD ʔ θ e AD ɪ AD ɴ m w AC e AD ɲ ɪ AD ɴ tʰ a̰ AG
ကြက်သွန်	t ɕ ɛ AD ʔ θ ʊ AE ɴ
ကြက်သွန်နီ	t ɕ ɛ AD ʔ θ ʊ AE ɴ n i AD
ကြက်သွန်ဖြူ	t ɕ ɛ AD ʔ θ ʊ AE ɴ b j AB u AE
ကြက်သွန်မြိတ်	t ɕ ɛ AD ʔ θ ʊ AE ɴ m j AB e AD ɪ AD ʔ
ကြက်ဟင်းခါးသီး	t ɕ ɛ AD ʔ h AA ɪ AD ɴ ɡ a AD ð i AD
ကြက်အူချောင်း	t ɕ ɛ AD ʔ ʔ u AE d ʑ a AD ʊ AE ɴ
ကြခတ်ဝါး	t ɕ ə AD kʰ a AD ʔ w AC a AD
ကြငှန်း	t ɕ ə AD ŋ̊ a AD ɴ
ကြဉ်	t ɕ ɪ AD ɴ
ကြည့်	t ɕ ḭ
ကြည့်မြင်တိုင်	t ɕ ḭ m j AB ɪ AD ɴ d a AD ɪ AD ɴ
ကြည်	t ɕ ɪ AD ɴ
ကြည်းတပ်	t ɕ i AD d a AD ʔ
ကြမ္မာ	t ɕ ə AD m a AD
ကြမ်း	t ɕ a AD ɴ
ကြယ်	t ɕ ɛ AD
ကြယ်စု	t ɕ ɛ AD z ṵ
ကြယ်တံခွန်	t ɕ ɛ AD d ə AD ɡ ʊ AE ɴ
ကြယ်သီး	t ɕ ɛ AD θ i AD
ကြာ	t ɕ a AD
ကြာကြာ	t ɕ a AD d ʑ a AD
ကြာချည်	t ɕ a AD t ɕʰ i AD
ကြာဆံ	t ɕ a AD z a AD ɴ
ကြာဆံသုပ်	t ɕ a AD z a AD ɴ θ o AE ʊ AE ʔ
ကြာညို့	t ɕ a AD ɲ o̰ AH
ကြာသပတေး	t ɕ a AD θ a̰ AG p a̰ AG d e AD
ကြား	t ɕ a AD
ကြိမ်	t ɕ e AD ɪ AD ɴ
ကြိယာ	k ə AD ɹ AI ḭ j AB a AD
ကြိယာဝိသေသန	k ə AD ɹ AI ḭ j AB a AD w AC ḭ θ e AD θ ə AD n a̰ AG
ကြိုက်	t ɕ a AD ɪ AD ʔ
ကြိုဆိုပါ၏	t ɕ o AE z o AE b a AD ʔ ɛ̰ AG
ကြို့	t ɕ o̰ AH
ကြိုး	t ɕ o AE
ကြိုးကြာ	d ʑ o AE d ʑ a AD
ကြိုးစင်	t ɕ o AE z ɪ AD ɴ
ကြိုးစား	t ɕ o AE z a AD
ကြီး	t ɕ i AD
ကြီးကြီး	t ɕ i AD d ʑ i AD
ကြီးမား	t ɕ i AD m a AD
ကြောက်	t ɕ a AD ʊ AE ʔ
ကြောင့်	d ʑ a̰ AG ʊ AE ɴ
ကြောင်	t ɕ a AD ʊ AE ɴ
ကြောင်ကလေး	t ɕ a AD ʊ AE ɴ ɡ ə AD l e AD
ကြောင်ထီး	t ɕ a AD ʊ AE ɴ d i AD
ကြောင်မ	t ɕ a AD ʊ AE ɴ m a̰ AG
ကြောင်လိမ်လှေကား	t ɕ a AD ʊ AE ɴ l e AD ɪ AD ɴ l̥ e AD ɡ a AD
ကြောင်အိမ်	t ɕ a AD ʊ AE ɴ ʔ e AD ɪ AD ɴ
ကြော်	t ɕ ɔ AE
ကြော်ငြာ	t ɕ ɔ AE ɲ a AD
ကြော်ငြာစာ	t ɕ ɔ AE ɲ a AD z a AD
ကြေး	t ɕ e AD
ကြေးကြီး	t ɕ e AD t ɕ i AD
ကြေးငွေ	t ɕ e AD ŋ w AC e AD
ကြေးစည်	t ɕ e AD z i AD
ကြေးနန်း	t ɕ e AD n a AD ɴ
ကြေးနီ	t ɕ e AD n i AD
ကြေးမုံ	t ɕ e AD m o AE ʊ AE ɴ
ကြေးဝါ	t ɕ e AD w AC a AD
ကြေးအိုး	t ɕ e AD ʔ o AE
ကြံ	t ɕ a AD ɴ
ကြံ့	t ɕ a̰ AG ɴ
ကြံ့လျော်	t ɕ a̰ AG ɴ ʃ ɔ AE
ကြွ	t ɕ w AC a̰ AG
ကြွက်	t ɕ w AC ɛ AD ʔ
ကြွက်နို့	t ɕ w AC ɛ AD ʔ n o̰ AH
ကြွက်သား	t ɕ w AC ɛ AD ʔ θ a AD
ကြွင်း	t ɕ w AC ɪ AD ɴ
ကြွပ်	t ɕ ʊ AE ʔ
ကြွယ်	t ɕ w AC ɛ AD
ကြွေ	t ɕ w AC e AD
ကြွေး	t ɕ w AC e AD
ကွင်း	k w AC ɪ AD ɴ
ကွင်းထိုးဖိနပ်	ɡ w AC ɪ AD ɴ d o AE pʰ ə AD n a AD ʔ
ကွတ်	k ʊ AE ʔ
ကွန်	k ʊ AE ɴ
ကွန်ကရစ်	k ʊ AE ɴ ɡ ə AD ɹ AI ɪ AD ʔ
ကွန်ဂို	k ʊ AE ɴ ɡ o AE
ကွန်ဒုံး	k ʊ AE ɴ d o AE ʊ AE ɴ
ကွန်ပါ	k ʊ AE ɴ p a AD
ကွန်ပျူတာ	k ʊ AE ɴ p j AB u AE t a AD
ကွန်ဖရင့်	k ʊ AE ɴ pʰ ə AD ɹ AI ɪ̰ AG ɴ
ကွန်ဖြူးရှပ်	k ʊ AE ɴ pʰ j AB u AE ʃ a AD ʔ
ကွန်ရက်	k ʊ AE ɴ j AB ɛ AD ʔ
ကွမ်ရင်	k w AC a AD ɴ j AB ɪ AD ɴ
ကွမ်ရင်မယ်တော်	k w AC a AD ɴ j AB ɪ AD ɴ m ɛ AD d ɔ AE
ကွမ်းတောင်	k ʊ AE ɴ d a AD ʊ AE ɴ
ကွမ်းမွှေး	k ʊ AE ɴ m̥ w AC e AD
ကွမ်းယာ	k ʊ AE ɴ j AB a AD
ကွမ်းရွက်ပင်	k ʊ AE ɴ j AB w AC ɛ AD ʔ p ɪ AD ɴ
ကွယ်လွန်	k w AC ɛ AD l ʊ AE ɴ
ကွာစေ့	k w AC a AD s ḭ
ကွာလာလမ်ပူ	k w AC a AD l a AD l a AD ɴ p u AE
ကွီး	k w AC i AD
ကွဲ	k w AC ɛ AD
ကဿပ	k a AD ʔ θ ə AD p a̰ AG
ကဿပဘုရား	k a AD ʔ θ ə AD p a̰ AG pʰ ə AD j AB a AD
ခ	kʰ a̰ AG
ခက်	kʰ ɛ AD ʔ
ခက်ရင်း	kʰ ə AD j AB ɪ AD ɴ
ခကွေး	kʰ a̰ AG ɡ w AC e AD
ခင်	kʰ ɪ AD ɴ
ခင်ပွန်း	kʰ ɪ AD ɴ b ʊ AE ɴ
ခင်ဗျာ	kʰ ə AD m j AB a AD
ခင်ဗျာ့	kʰ ɪ AD ɴ b j AB a̰ AG
ခင်ဗျား	kʰ ɪ AD ɴ b j AB a AD
ခင်ဗျားတို့	kʰ ɪ AD ɴ b j AB a AD d o̰ AH
ခင်မင်မှု	kʰ ɪ AD ɴ m ɪ AD ɴ m̥ ṵ
ခဏ	kʰ ə AD n a̰ AG
ခဏခဏ	kʰ ə AD n a̰ AG ɡ ə AD n a̰ AG
ခတ္တိယ	kʰ a AD ʔ t ḭ j AB a̰ AG
ခနုံထုပ်	kʰ ə AD n o AE ʊ AE ɴ d o AE ʊ AE ʔ
ခနုံအီ	kʰ ə AD n o AE ʊ AE ɴ ʔ i AD
ခန္တီ	kʰ a AD ɴ t i AD
ခန္ဓာ	kʰ a AD ɴ d a AD
ခန္ဓာငါးပါး	kʰ a AD ɴ d a AD ŋ a AD b a AD
ခန္ဓာဗေဒ	kʰ a AD ɴ d a AD b e AD d a̰ AG
ခန်တမာ	kʰ a AD ɴ t ə AD m a AD
ခန်း	kʰ a AD ɴ
ခပ်သိမ်း	kʰ a AD ʔ θ e AD ɪ AD ɴ
ခမည်းတော်	kʰ ə AD m i AD d ɔ AE
ခမာ	kʰ ə AD m a AD
ခမောက်	kʰ ə AD m a AD ʊ AE ʔ
ခယ်မ	kʰ ɛ AD m a̰ AG
ခရင်း	kʰ ə AD j AB ɪ AD ɴ
ခရစ္စမတ်	kʰ ə AD ɹ AI ɪ AD ʔ s ə AD m a AD ʔ
ခရစ်	kʰ ə AD ɹ AI ɪ AD ʔ
ခရစ်တော်	kʰ ə AD ɹ AI ɪ AD ʔ t ɔ AE
ခရစ်ယာန်	kʰ ə AD ɹ AI ɪ AD ʔ j AB a AD n
ခရမ်း	kʰ ə AD j AB a AD ɴ
ခရမ်းချဉ်	kʰ ə AD j AB a AD ɴ d ʑ ɪ AD ɴ
ခရမ်းသီး	kʰ ə AD j AB a AD ɴ θ i AD
ခရာမွှေး	kʰ ə AD j AB a AD m̥ w AC e AD
ခရိုင်	kʰ ə AD j AB a AD ɪ AD ɴ
ခရိုမီယမ်	kʰ ə AD ɹ AI o AE m i AD j AB a AD ɴ
ခရိုအေးရှား	kʰ ə AD ɹ AI o AE ʔ e AD ʃ a AD
ခရီး	kʰ ə AD j AB i AD
ခရီးသည်	kʰ ə AD j AB i AD ð e AD
ခရု	kʰ ə AD j AB ṵ
ခရုပက်ကျိ	kʰ ə AD j AB ṵ p ɛ AD ʔ t ɕ ḭ
ခရေ	kʰ ə AD j AB e AD
ခလာသီ	kʰ ə AD l a AD θ i AD
ခလုတ်	kʰ ə AD l o AE ʊ AE ʔ
ခလုတ်ခုံ	kʰ ə AD l o AE ʊ AE ʔ kʰ o AE ʊ AE ɴ
ခဝဲ	kʰ ə AD w AC ɛ AD
ခါ	kʰ a AD
ခါး	kʰ a AD
ခါးပတ်	ɡ ə AD b a AD ʔ
ခို	kʰ o AE
ခိုး	kʰ o AE
ခိုးစား	kʰ o AE s a AD
ခု	kʰ ṵ
ခုခံအားကျရောဂါ	kʰ ṵ ɡ a AD ɴ ʔ a AD t ɕ a̰ AG j AB ɔ AE ɡ a AD
ခုနစ်	kʰ ʊ AE ɴ n̥ ɪ AD ʔ
ခုနစ်လ	kʰ ʊ AE ɴ n̥ ə AD l a̰ AG
ခုန်	kʰ o AE ʊ AE ɴ
ခုံတန်းလျား	kʰ o AE ʊ AE ɴ t a AD ɴ j AB a AD
ခုံရှည်	kʰ o AE ʊ AE ɴ ʃ e AD
ခေတ္တ	kʰ ɪ AD ʔ t a̰ AG
ခေတ်	kʰ ɪ AD ʔ
ခေမာရဋ္ဌ	kʰ e AD m a AD j AB ə AD tʰ a̰ AG
ခေါက်	kʰ a AD ʊ AE ʔ
ခေါက်ဆွဲ	kʰ a AD ʊ AE ʔ sʰ w AC ɛ AD
ခေါက်ဆွဲဆိုင်	kʰ a AD ʊ AE ʔ sʰ w AC ɛ AD z a AD ɪ AD ɴ
ခေါက်ဆွဲသုပ်	kʰ a AD ʊ AE ʔ sʰ w AC ɛ AD θ o AE ʊ AE ʔ
ခေါက်မုန့်	kʰ a AD ʊ AE ʔ m o̰ AH ʊ AE ɴ
ခေါင်း	ɡ a AD ʊ AE ɴ
ခေါင်းဆောင်	ɡ a AD ʊ AE ɴ z a AD ʊ AE ɴ
ခေါင်းပေါင်း	ɡ a AD ʊ AE ɴ b a AD ʊ AE ɴ
ခေါင်းလောင်း	kʰ a AD ʊ AE ɴ l a AD ʊ AE ɴ
ခေါင်းလျှော်ရည်	ɡ a AD ʊ AE ɴ ʃ ɔ AE j AB e AD
ခေါင်းအုံး	ɡ a AD ʊ AE ɴ ʔ o AE ʊ AE ɴ
ခေါပုတ်	kʰ ɔ AE b o AE ʊ AE ʔ
ခေါပျဉ်	kʰ ɔ AE b j AB ɪ AD ɴ
ခေါ်	kʰ ɔ AE
ခေး	kʰ e AD
ခဲ	kʰ ɛ AD
ခဲတံ	kʰ ɛ AD d a AD ɴ
ခဲဖျက်	kʰ ɛ AD b j AB ɛ AD ʔ
ခဲယဉ်း	kʰ ɛ AD j AB ɪ AD ɴ
ခဲအို	kʰ ɛ AD ʔ o AE
ခဲ့	ɡ ɛ̰ AG
ခံ	kʰ a AD ɴ
ခံစား	kʰ a AD ɴ z a AD
ခံတပ်	kʰ a AD ɴ d a AD ʔ
ခံမြို့	kʰ a AD ɴ m j AB o̰ AH
ခံယူချက်	kʰ a AD ɴ j AB u AE d ʑ ɛ AD ʔ
ချက်	t ɕʰ ɛ AD ʔ
ချက်ကြိုး	t ɕʰ ɛ AD ʔ t ɕ o AE
ချက်သမ္မတ	t ɕʰ ɛ AD ʔ θ ə AD m ə AD d a̰ AG
ချင်	t ɕʰ ɪ AD ɴ
ချင်း	t ɕʰ ɪ AD ɴ
ချင်းမိုင်	t ɕʰ ɪ AD ɴ m a AD ɪ AD ɴ
ချင်းသုပ်	d ʑ ɪ AD ɴ ð o AE ʊ AE ʔ
ချစ်	t ɕʰ ɪ AD ʔ
ချစ်ခင်	t ɕʰ ɪ AD ʔ kʰ ɪ AD ɴ
ချစ်တီး	t ɕʰ ɪ AD ʔ t i AD
ချစ်သူ	t ɕʰ ɪ AD ʔ θ u AE
ချဉ်	t ɕʰ ɪ AD ɴ
ချဉ်ပေါင်	t ɕʰ ɪ AD ɴ b a AD ʊ AE ɴ
ချည်	t ɕʰ i AD
ချည်လုံး	t ɕʰ i AD l o AE ʊ AE ɴ
ချဒ်	t ɕʰ a AD d
ချပါတီ	t ɕʰ ə AD p a AD t i AD
ချပ်	d ʑ a AD ʔ
ချမ်း	t ɕʰ a AD ɴ
ချယ်ရီ	t ɕʰ ɛ AD ɹ AI i AD
ချာတိတ်	t ɕʰ a AD t e AD ɪ AD ʔ
ချားလ်	t ɕʰ a AD l
ချိတ်	d ʑ e AD ɪ AD ʔ
ချို	t ɕʰ o AE
ချိုချဉ်	t ɕʰ o AE t ɕʰ ɪ AD ɴ
ချိုး	t ɕʰ o AE
ချီလီ	t ɕʰ i AD l i AD
ချုပ်	t ɕʰ o AE ʊ AE ʔ
ချူးအင်းဂမ်း	t ɕʰ u AE ʔ ɪ AD ɴ ɡ a AD ɴ
ချေ	t ɕʰ i AD
ချော	t ɕʰ ɔ AE
ချောကလက်	t ɕʰ ɔ AE k ə AD l ɛ AD ʔ
ချောက်	t ɕʰ a AD ʊ AE ʔ
ချောင်	t ɕʰ a AD ʊ AE ɴ
ချောင်း	t ɕʰ a AD ʊ AE ɴ
ချော်	t ɕʰ ɔ AE
ချေး	t ɕʰ i AD
ချေးထုပ်	t ɕʰ e AD tʰ o AE ʊ AE ʔ
ချဲ့ချဲ့	t ɕʰ ɛ̰ AG d ʑ ɛ̰ AG
ချွန်	t ɕʰ ʊ AE ɴ
ချွန်ထက်	t ɕʰ ʊ AE ɴ tʰ ɛ AD ʔ
ချွေး	t ɕʰ w AC e AD
ချွေးမ	t ɕʰ w AC e AD m a̰ AG
ချွံချွံ	t ɕʰ ʊ AE ɴ d ʑ ʊ AE ɴ
ခြ	t ɕʰ a̰ AG
ခြင်	t ɕʰ ɪ AD ɴ
ခြင်း	t ɕʰ ɪ AD ɴ
ခြင်းလုံး	t ɕʰ ɪ AD ɴ l o AE ʊ AE ɴ
ခြင်္သေ့	t ɕʰ ɪ AD ɴ ð ḛ
ခြင်္သေ့ကလေး	t ɕʰ ɪ AD ɴ ð ḛ ɡ ə AD l e AD
ခြင်္သေ့မ	t ɕʰ ɪ AD ɴ ð ḛ m a̰ AG
ခြည်	t ɕʰ i AD
ခြတောင်ပို့	t ɕʰ a̰ AG t a AD ʊ AE ɴ b o̰ AH
ခြမ်း	t ɕʰ a AD ɴ
ခြား	t ɕʰ a AD
ခြားနား	t ɕʰ a AD n a AD
ခြားနားချက်	t ɕʰ a AD n a AD d ʑ ɛ AD ʔ
ခြေ	t ɕʰ e AD
ခြေစွပ်	t ɕʰ e AD z ʊ AE ʔ
ခြေထောက်	t ɕʰ e AD d a AD ʊ AE ʔ
ခြေနင်း	t ɕʰ e AD n ɪ AD ɴ
ခြေဖနောင့်	t ɕʰ e AD b ə AD n a̰ AG ʊ AE ɴ
ခြေဖဝါး	t ɕʰ e AD b ə AD w AC a AD
ခြေသည်း	t ɕʰ e AD ð e AD
ခြေအိတ်	t ɕʰ e AD ʔ e AD ɪ AD ʔ
ခြောက်	t ɕʰ a AD ʊ AE ʔ
ခြောက်လ	t ɕʰ a AD ʊ AE ʔ l a̰ AG
ခြံ	t ɕʰ a AD ɴ
ခွက်	kʰ w AC ɛ AD ʔ
ခွင့်လွှတ်	kʰ w AC ɪ̰ AG ɴ l̥ ʊ AE ʔ
ခွဆုံ	ɡ w AC a̰ AG z o AE ʊ AE ɴ
ခွန်	kʰ ʊ AE ɴ
ခွန်း	kʰ ʊ AE ɴ
ခွာ	kʰ w AC a AD
ခွာနာလျှာနာ	kʰ w AC a AD n a AD ʃ a AD n a AD
ခွေး	kʰ w AC e AD
ခွေးမ	kʰ w AC e AD m a̰ AG
ခွေးမသား	kʰ w AC e AD m a̰ AG ð a AD
ခွေးရူးပြန်ရောဂါ	kʰ w AC e AD j AB u AE b j AB a AD ɴ j AB ɔ AE ɡ a AD
ခွေးသူတောင်းစား	kʰ w AC e AD ð ə AD d a AD ʊ AE ɴ z a AD
ခွေးအိမ်	kʰ w AC e AD ʔ e AD ɪ AD ɴ
ခွဲ	kʰ w AC ɛ AD
ခွံ	kʰ ʊ AE ɴ
ဂငယ်	ɡ a̰ AG ŋ ɛ AD
ဂငယ်ကွေ့	ɡ a̰ AG ŋ ɛ AD ɡ w AC ḛ
ဂင်းနီဗစ်ဆော	ɡ ɪ AD ɴ n i AD b ɪ AD ʔ sʰ ɔ AE
ဂင်္ဂါ	ɡ ɪ AD ɴ ɡ a AD
ဂဏန်း	ɡ ə AD n a AD ɴ
ဂဏန်းတွက်စက်	ɡ ə AD n a AD ɴ t w AC ɛ AD ʔ s ɛ AD ʔ
ဂန္ထဗေဒ	ɡ a AD ɴ tʰ a̰ AG b e AD d a̰ AG
ဂန္ထဝင်	ɡ a AD ɴ d ə AD w AC ɪ AD ɴ
ဂန္ဒမာ	ɡ a AD ɴ d ə AD m a AD
ဂန်ဂျာ	ɡ a AD ɴ d ʑ a AD
ဂန်ဒူး	ɡ a AD ɴ d u AE
ဂမ်ဘီယာ	ɡ a AD ɴ b i AD j AB a AD
ဂယ်လက်ဆီ	ɡ ɛ AD l ɛ AD ʔ sʰ i AD
ဂရပ်	ɡ ə AD ɹ AI a AD ʔ
ဂရမ်	ɡ ə AD ɹ AI a AD ɴ
ဂရိ	ɡ ə AD ɹ AI ḭ
ဂရိတ်ဗြိတိန်	ɡ ə AD ɹ AI e AD ɪ AD ʔ b j AB ḭ t e AD ɪ AD ɴ
ဂရု	ɡ ə AD j AB ṵ
ဂလင်း	ɡ ə AD l ɪ AD ɴ
ဂဠုန်	ɡ ə AD l o AE ʊ AE ɴ
ဂါထာ	ɡ a AD tʰ a AD
ဂါနာ	ɡ a AD n a AD
ဂါဘွန်	ɡ a AD b ʊ AE ɴ
ဂိတ်	ɡ e AD ɪ AD ʔ
ဂိတ်ဆုံး	ɡ e AD ɪ AD ʔ sʰ o AE ʊ AE ɴ
ဂိမှာန်	ɡ e AD ɪ AD ɴ m̥ a AD ɴ
ဂိရိမေခလာ	ɡ ḭ ɹ AI ḭ m e AD kʰ ə AD l a AD
ဂိုင်ယာနာ	ɡ a AD ɪ AD ɴ j AB a AD n a AD
ဂိုဏ်း	ɡ o AE n
ဂိုဏ်းချုပ်	ɡ a AD ɪ AD ɴ d ʑ o AE ʊ AE ʔ
ဂိုဏ်းထောက်	ɡ o AE n d a AD ʊ AE ʔ
ဂိုဏ်းအုပ်	ɡ o AE n ʔ o AE ʊ AE ʔ
ဂိုဒေါင်	ɡ o AE d a AD ʊ AE ɴ
ဂီတ	ɡ i AD t a̰ AG
ဂီတပညာ	ɡ i AD t a̰ AG p a̰ AG ɲ a AD
ဂီတသမား	ɡ i AD t a̰ AG ð ə AD m a AD
ဂီတာ	ɡ i AD t a AD
ဂီနီ	ɡ i AD n i AD
ဂုဏ်	ɡ o AE ʊ AE ɴ
ဂုန္တန်	ɡ o AE ʊ AE ɴ d a AD ɴ
ဂုရု	ɡ ṵ ɹ AI ṵ
ဂူ	ɡ u AE
ဂေဟဗေဒ	ɡ e AD h AA a̰ AG t a̰ AG b e AD d a̰ AG
ဂေါက်	ɡ a AD ʊ AE ʔ
ဂေါတမ	ɡ ɔ AE t ə AD m a̰ AG
ဂေါတမဘုရား	ɡ ɔ AE t ə AD m a̰ AG pʰ ə AD j AB a AD
ဂေါ်	ɡ ɔ AE
ဂေါ်ဖီထုပ်	ɡ ɔ AE b i AD d o AE ʊ AE ʔ
ဂေါ်ဖီပန်း	ɡ ɔ AE b i AD p a AD ɴ
ဂေါ်မိတ်	ɡ ɔ AE m e AD ɪ AD ʔ
ဂေါ်ရခါး	ɡ ɔ AE j AB ə AD kʰ a AD
ဂေါ်ရခါးသီး	ɡ ɔ AE j AB ə AD kʰ a AD θ i AD
ဂျက်	d ʑ ɛ AD ʔ
ဂျင်	d ʑ ɪ AD ɴ
ဂျင်းဘောင်းဘီ	d ʑ ɪ AD ɴ b a AD ʊ AE ɴ b i AD
ဂျပန်	d ʑ ə AD p a AD ɴ
ဂျမေကာ	d ʑ ə AD m e AD k a AD
ဂျလေဘီ	d ʑ ə AD l e AD b i AD
ဂျာမနီ	d ʑ a AD m ə AD n i AD
ဂျာမန်	d ʑ a AD m a AD ɴ
ဂျီဘူတီ	d ʑ i AD b u AE t i AD
ဂျုံ	d ʑ o AE ʊ AE ɴ
ဂျုံမှုန့်	d ʑ o AE ʊ AE ɴ m̥ o̰ AH ʊ AE ɴ
ဂျူး	d ʑ u AE
ဂျေရုဆလင်	d ʑ e AD ɹ AI ṵ sʰ a̰ AG l ɪ AD ɴ
ဂျော့ခ်ျ	d ʑ ɔ̰ AH t ɕʰ ə AD
ဂျော်ဂျီယာ	d ʑ ɔ AE d ʑ i AD j AB a AD
ဂျော်ဒန်	d ʑ ɔ AE d a AD ɴ
ဂျော်နီ	d ʑ ɔ AE n i AD
ဂြိုဟ်	d ʑ o AE
ဂြိုဟ်တု	d ʑ o AE h AA d ṵ
ဂွမ်း	ɡ ʊ AE ɴ
ဂွါတီမာလာ	ɡ w AC a AD t i AD m a AD l a AD
ဂွေး	ɡ w AC e AD
ဃကြီး	ɡ a̰ AG d ʑ i AD
င	ŋ a̰ AG
ငချိတ်	ŋ ə AD t ɕʰ e AD ɪ AD ʔ
ငတ်	ŋ a AD ʔ
ငန်	ŋ a AD ɴ
ငန်း	ŋ a AD ɴ
ငယ်	ŋ ɛ AD
ငရုတ်	ŋ ə AD j AB o AE ʊ AE ʔ
ငရုတ်ကောင်း	ŋ ə AD j AB o AE ʊ AE ʔ ɡ a AD ʊ AE ɴ
ငရဲ	ŋ ə AD j AB ɛ AD
ငရဲကြီးရှစ်ထပ်	ŋ ə AD j AB ɛ AD d ʑ i AD ʃ ɪ AD ʔ tʰ a AD ʔ
ငရဲမင်း	ŋ ə AD j AB ɛ AD m ɪ AD ɴ
ငရဲသား	ŋ ə AD j AB ɛ AD ð a AD
ငလျင်	ŋ ə AD l j AB ɪ AD ɴ
ငါ	ŋ a AD
ငါတို့	ŋ a AD t o̰ AH
ငါ့	ŋ a̰ AG
ငါး	ŋ a AD
ငါးကျပ်တင်	ŋ a AD t ɕ a AD ʔ t ɪ AD ɴ
ငါးကြင်း	ŋ a AD d ʑ ɪ AD ɴ
ငါးခူ	ŋ ə AD kʰ u AE
ငါးပိ	ŋ ə AD p ḭ
ငါးပိထောင်း	ŋ a AD p ḭ tʰ a AD ʊ AE ɴ
ငါးပိရည်	ŋ ə AD p ḭ j AB e AD
ငါးပုဏ္ဏား	ŋ ə AD p o AE ʊ AE ɴ n a AD
ငါးပေါင်းထုပ်	ŋ ə AD b a AD ʊ AE ɴ d o AE ʊ AE ʔ
ငါးဖန်ခွက်	ŋ ə AD pʰ a AD ɴ ɡ w AC ɛ AD ʔ
ငါးဖယ်	ŋ ə AD pʰ ɛ AD
ငါးဖျင်းသလက်	ŋ ə AD pʰ j AB ɪ AD ɴ θ ə AD l ɛ AD ʔ
ငါးမန်း	ŋ ə AD m a AD ɴ
ငါးမုန့်	ŋ a AD m o̰ AH ʊ AE ɴ
ငါးမူး	ŋ a AD m u AE
ငါးမျှားတံ	ŋ ə AD m̥ j AB a AD d a AD ɴ
ငါးမြစ်ချင်း	ŋ ə AD m j AB ɪ AD ʔ t ɕʰ ɪ AD ɴ
ငါးရံ့	ŋ ə AD j AB a̰ AG ɴ
ငါးလ	ŋ a AD l a̰ AG
ငါးသလောက်	ŋ ə AD θ ə AD l a AD ʊ AE ʔ
ငါးသလောက်ပေါင်း	ŋ ə AD θ ə AD l a AD ʊ AE ʔ b a AD ʊ AE ɴ
ငါးဥ	ŋ a AD ʔ ṵ
ငို	ŋ o AE
ငု	ŋ ṵ
ငုစပ်	ŋ ṵ z a AD ʔ
ငုသိမ်	ŋ ṵ ð e AD ɪ AD ɴ
ငူတူတူ	ŋ u AE t u AE d u AE
ငံ	ŋ a AD ɴ
ငံပြာရည်	ŋ a AD ɴ b j AB a AD j AB e AD
ငြာ	ɲ a AD
ငြိမ်းချမ်းရေး	ɲ e AD ɪ AD ɴ d ʑ a AD ɴ j AB e AD
ငွေ	ŋ w AC e AD
ငွေကြေး	ŋ w AC e AD t ɕ e AD
ငွေသား	ŋ w AC e AD ð a AD
ငွေ့ငွေ့	ŋ w AC ḛ ŋ w AC ḛ
ငှက်	ŋ̊ ɛ AD ʔ
ငှက်ဆိုး	ŋ̊ ɛ AD ʔ sʰ o AE
ငှက်ပျော	ŋ ə AD p j AB ɔ AE
ငှက်ပျောပေါင်း	ŋ̊ ə AD b j AB ɔ AE b a AD ʊ AE ɴ
ငှက်ဖျား	ŋ̊ ɛ AD ʔ pʰ j AB a AD
ငှါး	ŋ̊ a AD
ငှား	ŋ̊ a AD
စ	s a̰ AG
စကတ်	s ə AD k a AD ʔ
စကား	z ə AD ɡ a AD
စကားထာ	z ə AD ɡ ə AD tʰ a AD
စကားနည်းရန်စဲ	z ə AD ɡ a AD n ɛ AD j AB a AD ɴ z ɛ AD
စကားပုံ	z ə AD ɡ ə AD b o AE ʊ AE ɴ
စကားပြန်	z ə AD ɡ ə AD b j AB a AD ɴ
စကားပြောကြေးနန်း	z ə AD ɡ a AD b j AB ɔ AE t ɕ e AD n a AD ɴ
စကားလုံး	z ə AD ɡ ə AD l o AE ʊ AE ɴ
စကားဝှက်	z ə AD ɡ ə AD ʍ AF ɛ AD ʔ
စက္ကန့်	s ɛ AD ʔ k a̰ AG ɴ
စက္ကရီတေရီ	s ɛ AD ʔ k ə AD ɹ AI i AD t e AD j AB i AD
စက္ကူ	s ɛ AD ʔ k u AE
စက်	s ɛ AD ʔ
စက်ခေါင်း	s ɛ AD ʔ ɡ a AD ʊ AE ɴ
စက်ဆရာ	s ɛ AD ʔ sʰ ə AD j AB a AD
စက်ဆုပ်	s ɛ AD ʔ sʰ o AE ʊ AE ʔ
စက်တင်ဘာ	s ɛ AD ʔ t ɪ AD ɴ b a AD
စက်ဘီး	s ɛ AD ʔ b e AD ɪ AD ɴ
စက်ရုပ်	s ɛ AD ʔ j AB o AE ʊ AE ʔ
စက်ရုံ	s ɛ AD ʔ j AB o AE ʊ AE ɴ
စက်လှေကား	s ɛ AD ʔ l̥ e AD ɡ a AD
စက်သုံးဆီဆိုင်	s ɛ AD ʔ θ o AE ʊ AE ɴ sʰ i AD sʰ a AD ɪ AD ɴ
စက်သေနတ်	s ɛ AD ʔ θ ə AD n a AD ʔ
စကြဝဠာ	s ɛ AD ʔ t ɕ a AD w AC ə AD l a AD
စကြာ	s ɛ AD ʔ t ɕ a AD
စကြာဝဠာဗေဒ	s ɛ AD ʔ t ɕ a AD w AC ə AD l a AD b e AD d a̰ AG
စခန်း	s ə AD kʰ a AD ɴ
စင်	s ɪ AD ɴ
စင်ကာပူ	s ɪ AD ɴ ɡ ə AD p u AE
စင်စင်	s ɪ AD ɴ z ɪ AD ɴ
စင်း	s ɪ AD ɴ
စင်္ကာပူ	s ɪ AD ɴ ɡ ə AD p u AE
စင်္ကြံ	z ɪ AD ɴ d ʑ a AD ɴ
စစ်	s ɪ AD ʔ
စစ်ကိုင်း	z ə AD ɡ a AD ɪ AD ɴ
စစ်ကဲ	s ɪ AD ʔ k ɛ AD
စစ်တပ်	s ɪ AD ʔ t a AD ʔ
စစ်တုရင်	s ɪ AD ʔ b ə AD j AB ɪ AD ɴ
စစ်တွေ	s ɪ AD ʔ t w AC e AD
စစ်ဗိုလ်	s ɪ AD ʔ b o AE
စစ်သား	s ɪ AD ʔ θ a AD
စဉ်းစား	s ɪ AD ɴ z a AD
စည်	s i AD
စည်ပိုင်း	s i AD b a AD ɪ AD ɴ
စည်း	s i AD
စည်းပုံ	s i AD b o AE ʊ AE ɴ
စတိုး	s ə AD t o AE
စတု	z ə AD t ṵ
စတုဂံ	s ə AD t ṵ ɡ a AD ɴ
စတုတ္ထ	z ə AD d o AE ʊ AE ʔ tʰ a̰ AG
စတုဒိသာ	s ə AD t ṵ d ḭ θ a AD
စတုရန်း	s ə AD t ṵ j AB a AD ɴ
စတေဒီယံ	s ə AD t e AD d i AD j AB a AD ɴ
စနစ်	s ə AD n ɪ AD ʔ
စနေ	s ə AD n e AD
စန္ဒရား	s a AD ɴ d ə AD j AB a AD
စန္ဒာ	s a AD ɴ d a AD
စန္ဒီ	s a AD ɴ d i AD
စန္ဒြမာသ	s a AD ɴ d ɹ AI a̰ AG m a AD θ a̰ AG
စန္ဒြာ	s a AD ɴ d ɹ AI a AD
စန်း	s a AD ɴ
စပါး	z ə AD b a AD
စပါးလင်	z ə AD b ə AD l ɪ AD ɴ
စပိန်	s ə AD p e AD ɪ AD ɴ
စပ်	s a AD ʔ
စပျစ်	z ə AD b j AB ɪ AD ʔ
စပျစ်သီး	z ə AD b j AB ɪ AD ʔ θ i AD
စပွတ်နစ်	s ə AD p ʊ AE ʔ n ɪ AD ʔ
စမတ်	s ə AD m a AD ʔ
စမူဆာ	s ə AD m u AE z a AD
စမူဆာသုပ်	s ə AD m u AE z a AD θ o AE ʊ AE ʔ
စမ်း	s a AD ɴ
စရိတ်	z ə AD j AB e AD ɪ AD ʔ
စရိုက်	z ə AD j AB a AD ɪ AD ʔ
စလုံး	s a̰ AG l o AE ʊ AE ɴ
စလွယ်	s ə AD l w AC e AD
စအို	s ə AD ʔ o AE
စာ	s a AD
စာကိုယ်	s a AD ɡ o AE
စာကြည့်တိုက်	s a AD t ɕ ḭ d a AD ɪ AD ʔ
စာချုပ်	s ə AD t ɕʰ o AE ʊ AE ʔ
စာစောင်	s a AD z a AD ʊ AE ɴ
စာဆို	s a AD z o AE
စာတိုက်	s a AD d a AD ɪ AD ʔ
စာပို့	s a AD p o̰ AH
စာပုံး	s a AD b o AE ʊ AE ɴ
စာပေ	s a AD p e AD
စာဖတ်	s a AD pʰ a AD ʔ
စာမရီ	s a AD m ə AD j AB i AD
စာမေးပွဲ	s a AD m e AD b w AC ɛ AD
စာမျက်နှာ	s a AD m j AB ɛ AD ʔ n̥ a AD
စာမွဲ	s ə AD m w AC ɛ AD
စာရင်း	s ə AD j AB ɪ AD ɴ
စာရင်းကိုင်	s ə AD j AB ɪ AD ɴ ɡ a AD ɪ AD ɴ
စာရင်းကိုင်ပညာ	s ə AD j AB ɪ AD ɴ ɡ a AD ɪ AD ɴ p j AB ɪ AD ɴ ɲ a AD
စာရင်းအင်း	s a AD j AB ɪ AD ɴ ʔ ɪ AD ɴ
စာရေး	s ə AD j AB e AD
စာရေးဆရာ	s a AD j AB e AD sʰ ə AD j AB a AD
စာရွက်စာတမ်း	s a AD j AB w AC ɛ AD ʔ s a AD d a AD ɴ
စာလုံးပေါင်းသတ်ပုံ	s ə AD l o AE ʊ AE ɴ b a AD ʊ AE ɴ θ a AD ʔ p o AE ʊ AE ɴ
စာသင်ခန်း	s a AD θ ɪ AD ɴ ɡ a AD ɴ
စာသား	s a AD ð a AD
စာအိတ်	s a AD ʔ e AD ɪ AD ʔ
စာအုပ်	s a AD ʔ o AE ʊ AE ʔ
စာအုပ်ဆိုင်	s a AD ʔ o AE ʊ AE ʔ sʰ a AD ɪ AD ɴ
စား	s a AD
စားချဉ့်ပြန်	s ə AD t ɕʰ ɪ̰ AG ɴ p j AB a AD ɴ
စားစရာ	s a AD z ə AD j AB a AD
စားတော်ဆက်	s a AD d ɔ AE z ɛ AD ʔ
စားပြီးပြီလား	s a AD p i AD b i AD l a AD
စားပွဲ	z ə AD b w AC ɛ AD
စားပွဲထိုး	z a AD b w AC ɛ AD d o AE
စားဖို	s ə AD pʰ o AE
စားဖိုဆောင်	s ə AD pʰ o AE z a AD ʊ AE ɴ
စားမြုံ့ပြန်	s ə AD m j AB o̰ AH ʊ AE ɴ p j AB a AD ɴ
စားသောက်ဆိုင်	s a AD θ a AD ʊ AE ʔ sʰ a AD ɪ AD ɴ
စိတ္တဇ	s e AD ɪ AD ʔ d ə AD z a̰ AG
စိတ္တဇပန်းချီ	s e AD ɪ AD ʔ d ə AD z a̰ AG b ə AD d ʑ i AD
စိတ္တဇရောဂါ	s e AD ɪ AD ʔ d ə AD z a̰ AG j AB ɔ AE ɡ a AD
စိတ္တဗေဒ	s e AD ɪ AD ʔ t a̰ AG b e AD d a̰ AG
စိတ်	s e AD ɪ AD ʔ
စိတ်ဆိုး	s e AD ɪ AD ʔ sʰ o AE
စိတ်ဓာတ်	s e AD ɪ AD ʔ d a AD t
စိတ်ပညာ	s e AD ɪ AD ʔ p j AB ɪ AD ɴ ɲ a AD
စိတ်မှတ်	s e AD ɪ AD ʔ m̥ a AD ʔ
စိတ်ရောဂါ	s e AD ɪ AD ʔ j AB ɔ AE ɡ a AD
စိန်	s e AD ɪ AD ɴ
စိန်ဖြူ	s e AD ɪ AD ɴ pʰ j AB u AE
စိမ့်	s ḛ ɪ AD ɴ
စိမ်း	s e AD ɪ AD ɴ
စိမ်းစားဥ	s e AD ɪ AD ɴ z a AD ʔ ṵ
စို	s o AE
စိုက်	s a AD ɪ AD ʔ
စိုက်ပျိုးရေး	s a AD ɪ AD ʔ p j AB o AE j AB e AD
စိုင်း	s a AD ɪ AD ɴ
စိုထိုင်း	s o AE tʰ a AD ɪ AD ɴ
စို့	s o̰ AH
စီဒီ	s i AD d i AD
စီလုံ	s i AD l o AE ʊ AE ɴ
စီလုံတီး	s i AD l o AE ʊ AE ɴ t i AD
စီး	s i AD
စီးကရက်	s i AD k ə AD ɹ AI ɛ AD ʔ
စီးကလိပ်	s i AD k ə AD l e AD ɪ AD ʔ
စီးနင်း	s i AD n ɪ AD ɴ
စီးပွား	s i AD b w AC a AD
စီးပွားရေး	s i AD b w AC a AD j AB e AD
စီးပွားရေးသမား	s i AD b w AC a AD j AB e AD ð ə AD m a AD
စုတ်	s o AE ʊ AE ʔ
စုန်း	s o AE ʊ AE ɴ
စုပ်	s o AE ʊ AE ʔ
စုပ်စုပ်	s o AE ʊ AE ʔ s o AE ʊ AE ʔ
စုလျား	s ṵ j AB a AD
စုံစမ်း	s o AE ʊ AE ɴ z a AD ɴ
စုံထောက်	s o AE ʊ AE ɴ d a AD ʊ AE ʔ
စုံဖက်	s o AE ʊ AE ɴ pʰ ɛ AD ʔ
စူပါမားကတ်	s u AE p ə AD m a AD k a AD ʔ
စူးစူး	s u AE z u AE
စေတနာ	s e AD d ə AD n a AD
စေတနာရှင်	s e AD d ə AD n a AD ʃ ɪ AD ɴ
စေတီ	z e AD d i AD
စော	s ɔ AE
စောက်	s a AD ʊ AE ʔ
စောင့်	s a̰ AG ʊ AE ɴ
စောင်	s a AD ʊ AE ɴ
စောင်း	s a AD ʊ AE ɴ
စောင်းလျား	z a AD ʊ AE ɴ j AB a AD
စောစော	s ɔ AE z ɔ AE
စောပြာ	s ɔ AE b j AB a AD
စော်ဘွား	s ɔ AE b w AC a AD
စေ့စပ်	s ḛ z a AD ʔ
စဲ	s ɛ AD
စံပယ်	z ə AD b ɛ AD
စွင့်	s w AC ɪ̰ AG ɴ
စွတ်စွတ်နာ	s ʊ AE ʔ s ʊ AE ʔ n a AD
စွတ်ဖါး	s ʊ AE ʔ pʰ a AD
စွန်	s ʊ AE ɴ
စွန်ကုပ်	s ʊ AE ɴ ɡ o AE ʊ AE ʔ
စွပ်	s ʊ AE ʔ
စွပ်ပြုတ်	s ʊ AE ʔ p j AB o AE ʊ AE ʔ
စွမ်း	s w AC a AD ɴ
စွမ်းအင်	s w AC a AD ɴ ʔ ɪ AD ɴ
စွယ်	s w AC ɛ AD
စွေ့စွေ့	s w AC ḛ z w AC ḛ
ဆက္ကဂံ	sʰ ɛ AD ʔ k ə AD ɡ a AD ɴ
ဆက်	sʰ ɛ AD ʔ
ဆက်ဆံ	sʰ ɛ AD ʔ sʰ a AD ɴ
ဆက်သွယ်ရေး	sʰ ɛ AD ʔ θ w AC ɛ AD j AB e AD
ဆင့်	sʰ ɪ̰ AG ɴ
ဆင်	sʰ ɪ AD ɴ
ဆင်ခြေထောက်ရောဂါ	sʰ ɪ AD ɴ t ɕʰ e AD d a AD ʊ AE ʔ j AB ɔ AE ɡ a AD
ဆင်စွယ်	sʰ ɪ AD ɴ z w AC ɛ AD
ဆင်ဝင်	sʰ ɪ AD ɴ w AC ɪ AD ɴ
ဆင်း	sʰ ɪ AD ɴ
ဆင်းရဲ	sʰ ɪ AD ɴ j AB ɛ AD
ဆစ်ဒနီ	sʰ ɪ AD ʔ d ə AD n i AD
ဆဋ္ဌမ	sʰ a AD ʔ tʰ ə AD m a̰ AG
ဆန့်ကျင်	sʰ a̰ AG ɴ d ʑ ɪ AD ɴ
ဆန့်ကျင်ဘက်	sʰ a̰ AG ɴ d ʑ ɪ AD ɴ b ɛ AD ʔ
ဆန္ဒ	sʰ a AD ɴ d a̰ AG
ဆန္ဒပြပွဲ	sʰ a AD ɴ d a̰ AG p j AB a̰ AG b w AC ɛ AD
ဆန်	sʰ a AD ɴ
ဆန်ခါ	z ə AD ɡ a AD
ဆန်ပြုတ်	sʰ a AD ɴ b j AB o AE ʊ AE ʔ
ဆန်မာရီနို	sʰ a AD ɴ m a AD ɹ AI i AD n o AE
ဆန်း	sʰ a AD ɴ
ဆန်းဒဝစ်	sʰ a AD ɴ d ə AD w AC ɪ AD ʔ
ဆနွင်းမကင်း	sʰ ə AD n w AC ɪ AD ɴ m ə AD k ɪ AD ɴ
ဆပ္ပတ်	sʰ a AD ʔ p a AD ʔ
ဆပ်	sʰ a AD ʔ
ဆပ်ကပ်	sʰ a AD ʔ k a AD ʔ
ဆပ်ပြာ	sʰ a AD ʔ p j AB a AD
ဆပ်သွားဖူး	sʰ a AD ʔ θ w AC a AD pʰ u AE
ဆယ့်တစ်	sʰ ɛ̰ AG t ɪ AD ʔ
ဆယ့်တစ်လ	sʰ ɛ̰ AG t ɪ AD ʔ l a̰ AG
ဆယ့်နှစ်	sʰ ɛ̰ AG n̥ ɪ AD ʔ
ဆယ့်နှစ်ရာသီ	sʰ ɛ̰ AG n̥ ə AD j AB a AD θ i AD
ဆယ့်နှစ်လ	sʰ ɛ̰ AG n̥ ə AD l a̰ AG
ဆယ်	sʰ ɛ AD
ဆယ်လ	sʰ ɛ AD l a̰ AG
ဆရာ	sʰ ə AD j AB a AD
ဆရာတော်	sʰ ə AD j AB a AD d ɔ AE
ဆရာမ	sʰ ə AD j AB a AD m a̰ AG
ဆရာလေး	sʰ ə AD j AB a AD l e AD
ဆရာဝန်	sʰ a̰ AG j AB a AD w AC ʊ AE ɴ
ဆရာသမား	sʰ a̰ AG j AB a AD θ ə AD m a AD
ဆလတ်	sʰ ə AD l a AD ʔ
ဆလဗ	sʰ ə AD l a̰ AG b a̰ AG
ဆလိမ်	sʰ a̰ AG l e AD ɪ AD ɴ
ဆလိုင်း	sʰ ə AD l a AD ɪ AD ɴ
ဆလိုဗားကီးယား	sʰ ə AD l o AE b a AD k i AD j AB a AD
ဆလိုဗေးနီးယား	sʰ ə AD l o AE b e AD n i AD j AB a AD
ဆာ	sʰ a AD
ဆာဂျင်	sʰ a AD d ʑ ɪ AD ɴ
ဆာမူရိုင်း	sʰ a AD m u AE ɹ AI a AD ɪ AD ɴ
ဆာယာ	sʰ a AD j AB a AD
ဆာရီ	sʰ a AD ɹ AI i AD
ဆာလဖာ	sʰ a AD l ə AD pʰ a AD
ဆား	sʰ a AD
ဆားကြက်ဥ	sʰ a AD t ɕ ɛ AD ʔ ʔ ṵ
ဆားဘီးယား	sʰ a AD b i AD j AB a AD
ဆားဘဲဥ	sʰ a AD b ɛ AD ʔ ṵ
ဆားရည်	sʰ a AD j AB e AD
ဆိတ်	sʰ e AD ɪ AD ʔ
ဆိတ်ကုလား	sʰ e AD ɪ AD ʔ k ə AD l a AD
ဆိတ်ချေး	sʰ e AD ɪ AD ʔ t ɕʰ i AD
ဆိတ်ထီး	sʰ e AD ɪ AD ʔ tʰ i AD
ဆိတ်မ	sʰ e AD ɪ AD ʔ m a̰ AG
ဆိပ်	sʰ e AD ɪ AD ʔ
ဆိပ်ကမ်း	sʰ e AD ɪ AD ʔ k a AD ɴ
ဆိမ့်	sʰ ḛ ɪ AD ɴ
ဆို	sʰ o AE
ဆိုကရေးတီး	sʰ o AE k ə AD ɹ AI e AD t i AD
ဆိုက်	sʰ a AD ɪ AD ʔ
ဆိုက်ကား	sʰ a AD ɪ AD ʔ k a AD
ဆိုက်ပရပ်စ်	sʰ a AD ɪ AD ʔ p ə AD ɹ AI a AD ʔ s
ဆိုက်ဘေးရီးယား	sʰ a AD ɪ AD ʔ b e AD ɹ AI i AD j AB a AD
ဆိုင်	sʰ a AD ɪ AD ɴ
ဆိုင်း	sʰ a AD ɪ AD ɴ
ဆိုင်းထိုး	sʰ a AD ɪ AD ɴ tʰ o AE
ဆိုင်းဘုတ်	sʰ a AD ɪ AD ɴ b o AE ʊ AE ʔ
ဆိုင်းဝိုင်း	sʰ a AD ɪ AD ɴ w AC a AD ɪ AD ɴ
ဆိုဆုံးမ	sʰ o AE sʰ o AE ʊ AE ɴ m a̰ AG
ဆိုထုံး	sʰ o AE d o AE ʊ AE ɴ
ဆိုဒီယမ်	sʰ o AE d i AD j AB a AD ɴ
ဆိုဖာ	sʰ o AE pʰ a AD
ဆိုဗီယက်	sʰ o AE b i AD j AB ɛ AD ʔ
ဆိုမာလီယာ	sʰ o AE m a AD l i AD j AB a AD
ဆိုမြည်	sʰ o AE m j AB i AD
ဆိုရိုးစကား	sʰ o AE j AB o AE z ə AD ɡ a AD
ဆိုး	sʰ o AE
ဆိုးဆေး	sʰ o AE z e AD
ဆီ	sʰ i AD
ဆီချက်	sʰ i AD d ʑ ɛ AD ʔ
ဆီချက်ခေါက်ဆွဲ	sʰ i AD d ʑ ɛ AD ʔ kʰ a AD ʊ AE ʔ sʰ w AC ɛ AD
ဆီထမင်း	sʰ i AD tʰ ə AD m ɪ AD ɴ
ဆီနီဂေါ	sʰ i AD n i AD ɡ ɔ AE
ဆီပြန်	sʰ i AD b j AB a AD ɴ
ဆီမီးတောက်	sʰ i AD m i AD d a AD ʊ AE ʔ
ဆီယူ	sʰ i AD j AB u AE
ဆီရာလီယွန်	sʰ i AD ɹ AI a AD l i AD j AB ʊ AE ɴ
ဆီး	sʰ i AD
ဆီးချို	sʰ i AD d ʑ o AE
ဆီးချုပ်ရောဂါ	sʰ i AD d ʑ o AE ʊ AE ʔ j AB ɔ AE ɡ a AD
ဆီးပူညောင်းကျ	sʰ i AD p u AE ɲ a AD ʊ AE ɴ t ɕ a̰ AG
ဆီးဖြူ	z i AD b j AB u AE
ဆီးရီးယား	sʰ i AD ɹ AI i AD j AB a AD
ဆီးအောင့်ရောဂါ	sʰ i AD ʔ a̰ AG ʊ AE ɴ j AB ɔ AE ɡ a AD
ဆု	sʰ ṵ
ဆုံး	sʰ o AE ʊ AE ɴ
ဆုံးဖြတ်	sʰ o AE ʊ AE ɴ pʰ j AB a AD ʔ
ဆူ	sʰ u AE
ဆူဒန်	sʰ u AE d a AD ɴ
ဆူရာနမ်	sʰ u AE ɹ AI a AD n a AD ɴ
ဆူရှီ	sʰ u AE ʃ i AD
ဆူး	sʰ u AE
ဆူးပုပ်	sʰ u AE b o AE ʊ AE ʔ
ဆောက်	sʰ a AD ʊ AE ʔ
ဆောင်	sʰ a AD ʊ AE ɴ
ဆောင်ပုဒ်	sʰ a AD ʊ AE ɴ b o AE ʊ AE ʔ
ဆောင်း	sʰ a AD ʊ AE ɴ
ဆောင်းပါး	sʰ a AD ʊ AE ɴ b a AD
ဆောင်းရာသီ	sʰ a AD ʊ AE ɴ j AB a AD ð i AD
ဆောင်းဦး	sʰ a AD ʊ AE ɴ ʔ u AE
ဆောင်းဦးရာသီ	sʰ a AD ʊ AE ɴ ʔ u AE j AB a AD ð i AD
ဆောရီး	sʰ ɔ AE ɹ AI i AD
ဆော့	sʰ ɔ̰ AH
ဆော့ဖ်ဝဲလ်	sʰ a AD ʊ AE ʔ w AC ɛ AD
ဆော်ဒီအာရေဗျ	sʰ ɔ AE d i AD ʔ a AD ɹ AI e AD b j AB a̰ AG
ဆေး	sʰ e AD
ဆေးခန်း	sʰ e AD kʰ a AD ɴ
ဆေးခြောက်	sʰ e AD d ʑ a AD ʊ AE ʔ
ဆေးဆိုင်	sʰ e AD z a AD ɪ AD ɴ
ဆေးတံ	sʰ e AD d a AD ɴ
ဆေးပေါ့လိပ်	sʰ e AD b ɔ̰ AH l e AD ɪ AD ʔ
ဆေးပြင်းလိပ်	sʰ e AD b j AB ɪ AD ɴ l e AD ɪ AD ʔ
ဆေးဘဲဥ	sʰ e AD b ɛ AD ʔ ṵ
ဆေးရုံ	sʰ e AD j AB o AE ʊ AE ɴ
ဆေးရှဲ	sʰ e AD ʃ ɛ AD
ဆေးလိပ်	sʰ e AD l e AD ɪ AD ʔ
ဆေးလိပ်မသောက်ရ	sʰ e AD l e AD ɪ AD ʔ m ə AD θ a AD ʊ AE ʔ j AB a̰ AG
ဆေးလုံး	sʰ e AD l o AE ʊ AE ɴ
ဆံ	sʰ a AD ɴ
ဆံတော်ချ	sʰ a AD ɴ t ɔ AE t ɕʰ a̰ AG
ဆံပင်	z ə AD b ɪ AD ɴ
ဆံပင်ညှပ်	z ə AD b ɪ AD ɴ ɲ̊ a AD ʔ
ဆံပင်တု	z ə AD b ɪ AD ɴ d ṵ
ဆွစ်ဇာလန်	sʰ w AC ɪ AD ʔ z ə AD l a AD ɴ
ဆွဆွ	sʰ w AC a̰ AG z w AC a̰ AG
ဆွပ်	sʰ ʊ AE ʔ
ဆွမ်း	sʰ ʊ AE ɴ
ဆွမ်းမွှေး	sʰ ʊ AE ɴ m̥ w AC e AD
ဆွမ်းအုပ်	sʰ ʊ AE ɴ ʔ o AE ʊ AE ʔ
ဆွယ်တာ	sʰ w AC ɛ AD t a AD
ဆွာဇီလန်	sʰ w AC a AD z i AD l a AD ɴ
ဆွီဒင်	sʰ w AC i AD d ɪ AD ɴ
ဆွေခုနစ်ဆက်မျိုးခုနစ်ဆက်	sʰ w AC e AD kʰ ə AD n ə AD z ɛ AD ʔ m j AB o AE kʰ ə AD n ə AD z ɛ AD ʔ
ဆွဲ	sʰ w AC ɛ AD
ဇကွဲ	z a̰ AG ɡ w AC ɛ AD
ဇင့်ခ်	z ɪ̰ AG ɴ
ဇင်ဘာဘွေ	z ɪ AD ɴ b a AD b w AC e AD
ဇင်းမယ်	z ɪ AD ɴ m ɛ AD
ဇင်္ဂမဥစ္စာ	z ɪ AD ɴ ɡ ə AD m a̰ AG ʔ o AE ʊ AE ʔ s a AD
ဇစ်	z ɪ AD ʔ
ဇနပုဒ်	z ə AD n ə AD p o AE ʊ AE ʔ
ဇနီး	z ə AD n i AD
ဇန်နဝါရီ	z a AD ɴ n ə AD w AC a AD ɹ AI i AD
ဇမ်ဘီယာ	z a AD ɴ b i AD j AB a AD
ဇယ	z ə AD j AB a̰ AG
ဇယား	z ə AD j AB a AD
ဇရပ်	z ə AD j AB a AD ʔ
ဇရာ	z ə AD j AB a AD
ဇလဗေဒ	z ə AD l a̰ AG b e AD d a̰ AG
ဇလုံ	z ə AD l o AE ʊ AE ɴ
ဇာ	z a AD
ဇာဂနာ	z a AD ɡ ə AD n a AD
ဇာတိ	z a AD t ḭ
ဇာတိပ္ဖိုလ်	z a AD d e AD ɪ AD ʔ pʰ o AE
ဇာတိပ္ဖိုလ်စေ့	z a AD d e AD ɪ AD ʔ pʰ o AE z ḛ
ဇာတ်	z a AD ʔ
ဇာတ်ကား	z a AD ʔ k a AD
ဇာတ်ကြီးဆယ်ဘွဲ့	z a AD t d ʑ i AD sʰ ɛ AD b w AC ɛ̰ AG
ဇာတ်ခုံ	z a AD ʔ kʰ o AE ʊ AE ɴ
ဇာတ်ဆောင်	z a AD ʔ sʰ a AD ʊ AE ɴ
ဇာတ်ညွှန်း	z a AD t ɲ̊ ʊ AE ɴ
ဇာတ်တော်	z a AD t
ဇာတ်ရုံ	z a AD ʔ j AB o AE ʊ AE ɴ
ဇာနည်	z a AD n i AD
ဇိန	z ḭ n a̰ AG
ဇိမ်မယ်	z e AD ɪ AD ɴ m ɛ AD
ဇီဇဝါ	z i AD z ə AD w AC a AD
ဇီရာ	z i AD j AB a AD
ဇီရာစေ့	z i AD j AB a AD s ḛ
ဇီဝ	z i AD w AC a̰ AG
ဇီဝကမ္မဗေဒ	z i AD w AC a̰ AG k a AD ɴ m a̰ AG b e AD d a̰ AG
ဇီဝစက်	z i AD w AC a̰ AG s ɛ AD ʔ
ဇီဝဓာတုဗေဒ	z i AD w AC a̰ AG d a AD t ṵ b e AD d a̰ AG
ဇီဝဗေဒ	z i AD w AC a̰ AG b e AD d a̰ AG
ဇူလိုင်	z u AE l a AD ɪ AD ɴ
ဇေ	z e AD
ဇေယျ	z e AD j AB a̰ AG
ဇေယျာပူရ	z e AD j AB a AD p u AE ɹ AI a̰ AG
ဇော်ဂျီ	z ɔ AE d ʑ i AD
ဇွန်	z ʊ AE ɴ
ဇွန်း	z ʊ AE ɴ
ဈမျဉ်းဆွဲ	z a̰ AG m j AB ɪ AD ɴ z w AC ɛ AD
ဈာန်	z a AD n
ဈာပန	z a AD p ə AD n a̰ AG
ဈေး	z e AD
ဈေးကြီး	z e AD t ɕ i AD
ဈေးချို	z e AD t ɕʰ o AE
ဈေးနှုန်း	z e AD n̥ o AE ʊ AE ɴ
ဉာဏ်	ɲ a AD n
ဉာဏ်စမ်း	ɲ a AD n s a AD ɴ
ဉာဏ်တော်	ɲ a AD ɴ d ɔ AE
ဉာဏ်ပူဇော်ခ	ɲ a AD n p u AE z ɔ AE kʰ a̰ AG
ည	ɲ a̰ AG
ညကလေး	ɲ a̰ AG k ə AD l e AD
ညကြီး	ɲ a̰ AG t ɕ i AD
ညစာ	ɲ a̰ AG z a AD
ညစ်	ɲ ɪ AD ʔ
ညစ်ထည်း	ɲ ɪ AD ʔ tʰ e AD
ညည်း	ɲ i AD
ညနေ	ɲ a̰ AG n e AD
ညနေခင်း	ɲ a̰ AG n e AD ɡ ɪ AD ɴ
ညလေး	ɲ a̰ AG l e AD
ညာ	ɲ a AD
ညို	ɲ o AE
ညီ	ɲ i AD
ညီနောင်	ɲ i AD n a AD ʊ AE ɴ
ညီမ	ɲ i AD m a̰ AG
ညီမျှခြင်း	ɲ i AD m̥ j AB a̰ AG d ʑ ɪ AD ɴ
ညီလာခံ	ɲ i AD l a AD ɡ a AD ɴ
ညီအစ်ကို	ɲ i AD ʔ ə AD k o AE
ညီအစ်မ	ɲ i AD ʔ ə AD m a̰ AG
ညောင်	ɲ a AD ʊ AE ɴ
ညောင်ဖြူ	ɲ a AD ʊ AE ɴ b j AB u AE
ညောင်ဗောဓိ	ɲ a AD ʊ AE ɴ b ɔ AE d ḭ
ညောင်လေးပင်	ɲ a AD ʊ AE ɴ l e AD p ɪ AD ɴ
ညောင်းကျရောဂါ	ɲ a AD ʊ AE ɴ t ɕ a̰ AG j AB ɔ AE ɡ a AD
ညေး	ɲ e AD
ညံစာစာ	ɲ a AD ɴ s a AD z a AD
ညွန့်	ɲ ʊ̰ AH ɴ
ညှင်း	ɲ̊ ɪ AD ɴ
ညှစ်	ɲ̊ ɪ AD ʔ
ညှပ်	ɲ̊ a AD ʔ
ညှာ	ɲ̊ a AD
ဋသန်လျင်းချိတ်	t a̰ AG θ ə AD j AB ɪ AD ɴ d ʑ e AD ɪ AD ʔ
ဌဝမ်းဘဲ	tʰ a̰ AG w AC ʊ AE ɴ b ɛ AD
ဌာန	tʰ a AD n a̰ AG
ဌာပနာ	tʰ a AD p ə AD n a AD
ဌေး	tʰ e AD
ဍရင်ကောက်	d a̰ AG j AB ɪ AD ɴ ɡ a AD ʊ AE ʔ
ဎရေမှုတ်	d a̰ AG j AB e AD m̥ o AE ʊ AE ʔ
ဏကြီး	n a̰ AG d ʑ i AD
တ	t ə AD
တကယ်	d ə AD ɡ ɛ AD
တကာ	d ə AD ɡ a AD
တက္ကစီ	t ɛ AD ʔ k ə AD s i AD
တက္ကဗေဒ	t ɛ AD ʔ k a̰ AG b e AD d a̰ AG
တက္ကသိုလ်	t ɛ AD ʔ k ə AD θ o AE
တက်	t ɛ AD ʔ
တကွ	d ə AD ɡ w AC a̰ AG
တချို့	t ə AD t ɕʰ o̰ AH
တခြား	t ə AD t ɕʰ a AD
တင့်ကား	t ɪ̰ AG ɴ k a AD
တင်	t ɪ AD ɴ
တင်ကူး	t ɪ AD ɴ ɡ u AE
တင်ဒါ	t ɪ AD ɴ d a AD
တင်ပါ့ဘုရား	t ɪ AD ɴ b a̰ AG pʰ ə AD j AB a AD
တင်းတင်း	t ɪ AD ɴ t ɪ AD ɴ
တင်းထိမ်	t ɪ AD ɴ d e AD ɪ AD ɴ
တင်းနစ်	t ɪ AD ɴ n ɪ AD ʔ
တစပြင်	d ə AD z a̰ AG b j AB ɪ AD ɴ
တစောင်း	d ə AD z a AD ʊ AE ɴ
တစ္ဆေ	t ə AD sʰ e AD
တစ်	t ɪ AD ʔ
တစ်ခုလပ်	t ə AD kʰ ṵ l a AD ʔ
တစ်ချောင်းပုဒ်	t ə AD t ɕʰ a AD ʊ AE ɴ p o AE ʊ AE ʔ
တစ်ဆယ်	t ə AD z ɛ AD
တစ်ထောင်	t ə AD tʰ a AD ʊ AE ɴ
တစ်ပင်တိုင်မင်းသမီး	d ə AD b ɪ AD ɴ d a AD ɪ AD ɴ m ɪ AD ɴ ð ə AD m i AD
တစ်ရာ	t ə AD j AB a AD
တစ်လ	t ə AD l a̰ AG
တဆယ်	t ə AD z ɛ AD
တဆေး	t ə AD sʰ e AD
တညင်း	d ə AD ɲ ɪ AD ɴ
တညင်းသီး	d ə AD ɲ ɪ AD ɴ ð i AD
တည်	t ɛ AD
တည်ဆောက်	t i AD sʰ a AD ʊ AE ʔ
တည်တံ့	t i AD d a̰ AG ɴ
တည်း	tʰ ɛ AD
တဏှင်္ကရာ	t ə AD n̥ ɪ AD ɴ k ə AD ɹ AI a AD
တဏှင်္ကရာဘုရား	t ə AD n̥ ɪ AD ɴ k ə AD ɹ AI a AD pʰ ə AD j AB a AD
တဏှာ	t ə AD n̥ a AD
တတိယ	t a̰ AG t ḭ j AB a̰ AG
တတ်	ʔ
တန	t a̰ AG n a̰ AG
တနင်္ဂနွေ	t ə AD n ɪ AD ɴ ɡ ə AD n w AC e AD
တနင်္လာ	t ə AD n ɪ AD ɴ l a AD
တန်ခိုးရှင်	t a AD ɴ kʰ o AE ʃ ɪ AD ɴ
တန်ခူး	d ə AD ɡ u AE
တန်ဆောင်မုန်း	d ə AD z a AD ʊ AE ɴ m o AE ʊ AE ɴ
တန်ဇေးနီးယား	t a AD ɴ z e AD n i AD j AB a AD
တပည့်တော်	d ə AD b ḭ d ɔ AE
တပည့်တော်မ	d ə AD b ḭ d ɔ AE m a̰ AG
တပို့တွဲ	d ə AD b o̰ AH d w AC ɛ AD
တပေါင်း	d ə AD b a AD ʊ AE ɴ
တပေါင်းလပြည့်နေ့	d ə AD b a AD ʊ AE ɴ l a̰ AG p j AB ḭ n ḛ
တပ်	t a AD ʔ
တပ်ကြပ်	t a AD ʔ t ɕ a AD ʔ
တပ်ကြပ်ကြီး	t a AD ʔ t ɕ a AD ʔ t ɕ i AD
တပ်ခွဲတပ်ကြပ်ကြီး	t a AD ʔ kʰ w AC ɛ AD t a AD ʔ t ɕ a AD ʔ t ɕ i AD
တပ်မတော်	t a AD ʔ m ə AD d ɔ AE
တပ်မတော်နေ့	t a AD ʔ m ə AD d ɔ AE n ḛ
တဘက်	d ə AD b ɛ AD ʔ
တမန်	t ə AD m a AD ɴ
တမန်တော်	t ə AD m a AD ɴ d ɔ AE
တမလန်း	t ə AD m ə AD l a AD ɴ
တယော	t ə AD j AB ɔ AE
တယ်	t ɛ AD
တယ်လီဖုန်း	t ɛ AD l i AD pʰ o AE ʊ AE ɴ
တယ်လီဗီးရှင်း	t ɛ AD l i AD b i AD ʃ ɪ AD ɴ
တရား	t ə AD j AB a AD
တရားခံ	t ə AD j AB ə AD kʰ a AD ɴ
တရားစွဲ	t ə AD j AB a AD s w AC ɛ AD
တရားရုံး	t ə AD j AB a AD j AB o AE ʊ AE ɴ
တရားလွှတ်တော်	t ə AD j AB a AD l̥ ʊ AE ʔ t ɔ AE
တရားလွှတ်တော်ချုပ်	t ə AD j AB a AD l̥ ʊ AE ʔ t ɔ AE d ʑ o AE ʊ AE ʔ
တရားသူကြီး	t ə AD j AB a AD ð u AE d ʑ i AD
တရုတ်	t ə AD j AB o AE ʊ AE ʔ
တရုတ်စံကား	t a̰ AG j AB o AE ʊ AE ʔ s a AD ɴ k a AD
တရုတ်ဆီးသီး	t ə AD j AB o AE ʊ AE ʔ z i AD θ i AD
တရုတ်နံနံ	t a̰ AG j AB o AE ʊ AE ʔ n a AD ɴ n a AD ɴ
တရုတ်နှင်းသီး	t a̰ AG j AB o AE ʊ AE ʔ n̥ ɪ AD ɴ θ i AD
တရုတ်မဆလာ	t ə AD j AB o AE ʊ AE ʔ m ə AD sʰ ə AD l a AD
တလည်း	t ə AD l e AD
တလိုင်း	t ə AD l a AD ɪ AD ɴ
တလွဲ	t ə AD l w AC ɛ AD
တာချီလိတ်	t a AD t ɕʰ i AD l e AD ɪ AD ʔ
တာဂျစ်ကစ္စတန်	t a AD d ʑ ɪ AD ʔ k ɪ AD ʔ s ə AD t a AD ɴ
တာတား	t a AD t a AD
တာမွေ	t a AD m w AC e AD
တာယာ	t a AD j AB a AD
တာရာ	t a AD j AB a AD
တာလုဇ	t a AD l ṵ z a̰ AG
တာဝတိံသာ	t a AD w AC a̰ AG t e AD ɪ AD ɴ θ a AD
တာဝန်	t a AD w AC ʊ AE ɴ
တာ့ခ်မင်နစ္စတန်	t a̰ AG kʰ m ɪ AD ɴ n ɪ AD ʔ s ə AD t a AD ɴ
တား	t a AD
တိ	t ḭ
တိတ်	t e AD ɪ AD ʔ
တိန်းညက်	t e AD ɪ AD ɴ ɲ ɛ AD ʔ
တိပိဋက	t ḭ p ḭ t ə AD k a̰ AG
တိမ်	t e AD ɪ AD ɴ
တိရစ္ဆာန်	t ə AD ɹ AI e AD ɪ AD ʔ sʰ a AD ɴ
တိရစ္ဆာန်ရုံ	t ə AD ɹ AI e AD ɪ AD ʔ sʰ a AD ɴ j AB o AE ʊ AE ɴ
တို	t o AE
တိုက်	t a AD ɪ AD ʔ
တိုက်ခန်း	t a AD ɪ AD ʔ kʰ a AD ɴ
တိုက်ပုံ	t a AD ɪ AD ʔ p o AE ʊ AE ɴ
တိုက်ပွဲ	t a AD ɪ AD ʔ p w AC ɛ AD
တိုက်အိမ်	t a AD ɪ AD ʔ ʔ e AD ɪ AD ɴ
တိုကျို	t o AE t ɕ o AE
တိုဂို	t o AE ɡ o AE
တိုင်	t a AD ɪ AD ɴ
တိုင်ကီ	t a AD ɪ AD ɴ k i AD
တိုင်ပင်	t a AD ɪ AD ɴ b ɪ AD ɴ
တိုင်ဖွန်း	t a AD ɪ AD ɴ pʰ ʊ AE ɴ
တိုင်းရင်းသား	t a AD ɪ AD ɴ j AB ɪ AD ɴ ð a AD
တိုဖူး	t o AE pʰ u AE
တိုရှေ	t o AE ʃ e AD
တိုဟူး	t o AE h AA u AE
တိုဟူးနွေး	t o AE h AA u AE n w AC e AD
တိုဟူးသုပ်	t o AE h AA u AE θ o AE ʊ AE ʔ
တို့	d o̰ AH
တိုး	t o AE
တိုးတက်	t o AE t ɛ AD ʔ
တိုးတက်ခြင်း	t o AE t ɛ AD ʔ d ʑ ɪ AD ɴ
တိုးတက်ရေး	t o AE t ɛ AD ʔ j AB e AD
တိုးတိုး	t o AE d o AE
တိုးနရား	t o AE n ə AD j AB a AD
တိဿ	t e AD ɪ AD ʔ θ a̰ AG
တိဿဘုရား	t e AD ɪ AD ʔ θ a̰ AG pʰ ə AD j AB a AD
တီ	t i AD
တီကောင်	t i AD ɡ a AD ʊ AE ɴ
တီကေ့	t i AD k ḛ
တီထွင်	t i AD tʰ w AC ɪ AD ɴ
တီထွင်မှု	t i AD tʰ w AC ɪ AD ɴ m̥ ṵ
တီဗီ	t i AD b i AD
တီရှပ်	t i AD ʃ a AD ʔ
တီဟီရန်	t i AD h AA i AD ɹ AI a AD ɴ
တီး	t i AD
တီးတိုးပြော	t i AD d o AE p j AB ɔ AE
တုတ်	d o AE ʊ AE ʔ
တုတ်မီး	d o AE ʊ AE ʔ m i AD
တုံး	t o AE ʊ AE ɴ
တူ	t u AE
တူနီးရှား	t u AE n i AD ʃ a AD
တူမ	t u AE m a̰ AG
တူရကီ	t u AE ɹ AI ə AD k i AD
တူရိယာ	t u AE ɹ AI ḭ j AB a AD
တူး	t u AE
တူးမြောင်း	t u AE m j AB a AD ʊ AE ɴ
တူးရစ်	t u AE ɹ AI ɪ AD ʔ
တေဇော	t e AD z ɔ AE
တေသံ	t e AD ð a AD ɴ
တော	t ɔ AE
တောက်တဲ့	t a AD ʊ AE ʔ t ɛ̰ AG
တောက်ပ	t a AD ʊ AE ʔ p a̰ AG
တောကြက်မောက်	t ɔ AE t ɕ ɛ AD ʔ m a AD ʊ AE ʔ
တောခွေး	t ɔ AE ɡ w AC e AD
တောင်	t a AD ʊ AE ɴ
တောင်ကိုရီးယား	t a AD ʊ AE ɴ k o AE ɹ AI i AD j AB a AD
တောင်ကြား	t a AD ʊ AE ɴ d ʑ a AD
တောင်ကြီး	t a AD ʊ AE ɴ d ʑ i AD
တောင်ငူ	t a AD ʊ AE ɴ ŋ u AE
တောင်ဆူဒန်	t a AD ʊ AE ɴ sʰ u AE d a AD ɴ
တောင်ပံ	t a AD ʊ AE ɴ b a AD ɴ
တောင်ဖက်ဝန်း	t a AD ʊ AE ɴ pʰ ɛ AD ʔ w AC ʊ AE ɴ
တောင်သူ	t a AD ʊ AE ɴ ð u AE
တောင်သူလယ်သမား	t a AD ʊ AE ɴ ð u AE l ɛ AD ð ə AD m a AD
တောင်သူလယ်သမားနေ့	t a AD ʊ AE ɴ ð u AE l ɛ AD θ ə AD m a AD n ḛ
တောင်အာဖရိက	t a AD ʊ AE ɴ ʔ a AD pʰ ə AD ɹ AI ḭ k a̰ AG
တောင်း	t a AD ʊ AE ɴ
တောင်းပန်	t a AD ʊ AE ɴ b a AD ɴ
တောမန်ကျည်း	t ɔ AE m ə AD d ʑ i AD
တောသား	t ɔ AE ð a AD
တောသီတင်း	t ɔ AE θ i AD d ɪ AD ɴ
တော်	t ɔ AE
တော်ပြီ	t ɔ AE b i AD
တော်လေးဝ	t ɔ AE l e AD w AC a̰ AG
တော်လှန်	t ɔ AE l̥ a AD ɴ
တော်လှန်ရေး	t ɔ AE l̥ a AD ɴ j AB e AD
တော်သလင်း	t ɔ AE ð ə AD l ɪ AD ɴ
တေးသံရှင်	t e AD θ a AD ɴ ʃ ɪ AD ɴ
တေးသွား	t e AD ð w AC a AD
တဲ	t ɛ AD
တဲ့	d ɛ̰ AG
တံ	t a AD ɴ
တံခါး	d ə AD ɡ a AD
တံခါးဗိုလ်	d ə AD ɡ a AD b o AE
တံခွန်	d ə AD ɡ ʊ AE ɴ
တံခွန်တိုင်	d ə AD ɡ ʊ AE ɴ d a AD ɪ AD ɴ
တံငါ	t ə AD ŋ a AD
တံစဉ်	d ə AD z ɪ AD ɴ
တံစဉ်း	d ə AD z ɪ AD ɴ
တံဆိပ်	d ə AD z e AD ɪ AD ʔ
တံဆိပ်ခေါင်း	d ə AD z e AD ɪ AD ʔ ɡ a AD ʊ AE ɴ
တံတား	d ə AD d a AD
တံတိုင်း	d ə AD d a AD ɪ AD ɴ
တံတောင်	d ə AD d a AD ʊ AE ɴ
တံပိုး	d ə AD b o AE
တံပူ	d ə AD b u AE
တံမြက်စည်း	d ə AD b j AB ɛ AD ʔ s i AD
တံ့တံ့	t a̰ AG ɴ d a̰ AG ɴ
တြိ	t ə AD ɹ AI ḭ
တြိဂံ	t ɹ AI ḭ ɡ a AD ɴ
တြိပူရ	t ə AD ɹ AI ḭ p u AE j AB a̰ AG
တွက်	t w AC ɛ AD ʔ
တွင်	t w AC ɪ AD ɴ
တွင်း	t w AC ɪ AD ɴ
တွန်း	t ʊ AE ɴ
တွပ်	t ʊ AE ʔ
တွေ့	t w AC ḛ
တွေး	t w AC e AD
ထ	tʰ a̰ AG
ထက်	tʰ ɛ AD ʔ
ထက်ဝယ်ဖွဲ့ခွေ	tʰ ɛ AD ʔ w AC ɛ AD pʰ w AC ɛ̰ AG kʰ w AC e AD
ထင်	tʰ ɪ AD ɴ
ထင်စား	tʰ ɪ AD ɴ z a AD
ထင်း	tʰ ɪ AD ɴ
ထဆင်ထူး	tʰ a̰ AG sʰ ɪ AD ɴ d u AE
ထည်	tʰ ɛ AD
ထနောင်း	tʰ ə AD n a AD ʊ AE ɴ
ထန်း	tʰ a AD ɴ
ထန်းလျက်	tʰ ə AD ɲ ɛ AD ʔ
ထပ်	tʰ a AD ʔ
ထပ်တစ်ရာ	tʰ a AD ʔ t ə AD j AB a AD
ထဘီ	tʰ ə AD m i AD
ထမင်း	tʰ ə AD m ɪ AD ɴ
ထမင်းကြော်	tʰ ə AD m ɪ AD ɴ d ʑ ɔ AE
ထမင်းချဉ်	tʰ ə AD m ɪ AD ɴ d ʑ ɪ AD ɴ
ထမင်းဆိုင်	tʰ ə AD m ɪ AD ɴ z a AD ɪ AD ɴ
ထမင်းသုပ်	tʰ a̰ AG m ɪ AD ɴ θ o AE ʊ AE ʔ
ထမနဲ	tʰ a̰ AG m a̰ AG n ɛ AD
ထယ်	tʰ ɛ AD
ထာဝရ	tʰ a AD w AC ə AD j AB a̰ AG
ထာဝရဥစ္စာ	tʰ a AD w AC ə AD j AB a̰ AG ʔ o AE ʊ AE ʔ s a AD
ထား	tʰ a AD
ထားဝယ်	d ə AD w AC ɛ AD
ထိ	tʰ ḭ
ထိကပေါက်	tʰ ḭ ɡ ə AD b a AD ʊ AE ʔ
ထိပ်ခေါင်တင်	tʰ e AD ɪ AD ʔ kʰ a AD ʊ AE ɴ t ɪ AD ɴ
ထိပ်စုဖုရား	tʰ e AD ɪ AD ʔ s ṵ pʰ ə AD j AB a AD
ထိမ်းမြား	tʰ e AD ɪ AD ɴ m j AB a AD
ထို	tʰ o AE
ထိုင်	tʰ a AD ɪ AD ɴ
ထိုင်ခုံ	tʰ a AD ɪ AD ɴ ɡ o AE ʊ AE ɴ
ထိုင်ပေ	tʰ a AD ɪ AD ɴ p e AD
ထိုင်မသိမ်း	tʰ a AD ɪ AD ɴ m ə AD θ e AD ɪ AD ɴ
ထိုင်ဝမ်	tʰ a AD ɪ AD ɴ w AC a AD ɴ
ထိုင်း	tʰ a AD ɪ AD ɴ
ထိုမှာ	tʰ o AE m̥ a AD
ထိုး	tʰ o AE
ထိုးမုန့်	tʰ o AE m o̰ AH ʊ AE ɴ
ထီ	tʰ i AD
ထီး	tʰ i AD
ထီးတင်	tʰ i AD t ɪ AD ɴ
ထီးဖြူ	tʰ i AD b j AB u AE
ထုတ်ကုန်	tʰ o AE ʊ AE ʔ k o AE ʊ AE ɴ
ထုတ်လုပ်	tʰ o AE ʊ AE ʔ l o AE ʊ AE ʔ
ထုတ်လုပ်မှု	tʰ o AE ʊ AE ʔ l o AE ʊ AE ʔ m̥ ṵ
ထုတ်ဝေသူ	tʰ o AE ʊ AE ʔ w AC e AD ð u AE
ထုံးစံ	tʰ o AE ʊ AE ɴ z a AD ɴ
ထူ	tʰ u AE
ထူထဲ	tʰ u AE d ɛ AD
ထူပါ	tʰ u AE p a AD
ထူး	tʰ u AE
ထေရဝါဒ	tʰ e AD j AB a̰ AG w AC a AD d a̰ AG
ထော	tʰ ɔ AE
ထောက်	tʰ a AD ʊ AE ʔ
ထောက်ကြံ့	tʰ a AD ʊ AE ʔ t ɕ a̰ AG ɴ
ထောက်ခံ	tʰ a AD ʊ AE ʔ kʰ a AD ɴ
ထောက်ပံ့	tʰ a AD ʊ AE ʔ p a̰ AG ɴ
ထောင့်	d a̰ AG ʊ AE ɴ
ထောင်	tʰ a AD ʊ AE ɴ
ထောင်ကဲ	tʰ a AD ʊ AE ɴ k ɛ AD
ထောင်မှူး	tʰ a AD ʊ AE ɴ m̥ u AE
ထောင်သား	tʰ a AD ʊ AE ɴ ð a AD
ထောပတ်	tʰ ɔ AE b a AD ʔ
ထောပတ်ထမင်း	tʰ ɔ AE b a AD ʔ tʰ ə AD m ɪ AD ɴ
ထောပတ်သီး	tʰ ɔ AE p a AD ʔ θ i AD
ထော်လာဂျီ	tʰ ɔ AE l a AD d ʑ i AD
ထဲ	tʰ ɛ AD
ထံ	tʰ a AD ɴ
ထွက်	tʰ w AC ɛ AD ʔ
ထွက်ပေါက်	tʰ w AC ɛ AD ʔ p a AD ʊ AE ʔ
ထွက်ပြေး	tʰ w AC ɛ AD ʔ p j AB e AD
ထွန်	tʰ ʊ AE ɴ
ထွန်စက်	tʰ ʊ AE ɴ z ɛ AD ʔ
ထွန်း	tʰ ʊ AE ɴ
ထွေး	tʰ w AC e AD
ဒကာ	d ə AD ɡ a AD
ဒက္ခိဏ	d ɛ AD ʔ kʰ ḭ n a̰ AG
ဒဂုံ	d ə AD ɡ o AE ʊ AE ɴ
ဒင်္ဂါး	d ɪ AD ɴ ɡ a AD
ဒင်္ဂါးတိုက်	d ɪ AD ɴ ɡ a AD d a AD ɪ AD ʔ
ဒစ္စကို	d ɪ AD ʔ s a̰ AG k o AE
ဒဏ္ဍာရီ	d a AD n d a AD j AB i AD
ဒဏ်	d a AD n
ဒဏ်ငွေ	d a AD n ŋ w AC e AD
ဒဏ်ရာ	d a AD ɴ j AB a AD
ဒထွေး	d a̰ AG d w AC e AD
ဒန့်သလွန်	d a̰ AG ɴ ð ə AD l ʊ AE ɴ
ဒန်ပူ	d ə AD b u AE
ဒန်း	d a AD ɴ
ဒသမ	d a̰ AG θ ə AD m a̰ AG
ဒါ	d a AD
ဒါန	d a AD n a̰ AG
ဒါပါပဲ	d a AD b a AD b ɛ AD
ဒါပေမဲ့	d a AD b e AD m ɛ̰ AG
ဒါပော့	d a AD p ɔ̰ AH
ဒိန်ခဲ	d e AD ɪ AD ɴ ɡ ɛ AD
ဒိန်ချဉ်	d e AD ɪ AD ɴ d ʑ ɪ AD ɴ
ဒိန်းမတ်	d e AD ɪ AD ɴ m a AD ʔ
ဒိုင်ခွက်	d a AD ɪ AD ɴ ɡ w AC ɛ AD ʔ
ဒိုင်နိုဆော	d a AD ɪ AD ɴ n o AE sʰ ɔ AE
ဒိုင်ယာနာ	d a AD ɪ AD ɴ j AB a AD n a AD
ဒိုင်ယာရီ	d a AD ɪ AD ɴ j AB ə AD ɹ AI i AD
ဒီ	d i AD
ဒီဂရီ	d i AD ɡ ə AD ɹ AI i AD
ဒီဃ	d i AD ɡ a̰ AG
ဒီဇင်ဘာ	d i AD z ɪ AD ɴ b a AD
ဒီဇိုင်နာ	d i AD z a AD ɪ AD ɴ n a AD
ဒီဇိုင်း	d i AD z a AD ɪ AD ɴ
ဒီည	d i AD ɲ a̰ AG
ဒီနေ့	d i AD n ḛ
ဒီပင်္ကရာ	d i AD p ɪ AD ɴ k ə AD ɹ AI a AD
ဒီပင်္ကရာဘုရား	d i AD p ɪ AD ɴ k ə AD ɹ AI a AD pʰ ə AD j AB a AD
ဒီပါ	d i AD p a AD
ဒီပါဝလီ	d i AD p a AD w AC ə AD l i AD
ဒီဗီဒီ	d i AD b i AD d i AD
ဒီမိုကရေစီ	d i AD m o AE k ə AD ɹ AI e AD s i AD
ဒီမှာ	d i AD m̥ a AD
ဒီလို	d i AD l o AE
ဒီဟာ	d i AD h AA a AD
ဒု	d ṵ
ဒုက္ခ	d o AE ʊ AE ʔ kʰ a̰ AG
ဒုက္ခသည်	d o AE ʊ AE ʔ kʰ a̰ AG ð e AD
ဒုက္ခိတ	d o AE ʊ AE ʔ kʰ ḭ t a̰ AG
ဒုတိယ	d ṵ t ḭ j AB a̰ AG
ဒုတိယတပ်ကြပ်	d ṵ t ḭ j AB a̰ AG t a AD ʔ t ɕ a AD ʔ
ဒုတိယဗိုလ်	d ṵ t ḭ j AB a̰ AG b o AE
ဒုတိယဗိုလ်ချုပ်ကြီး	d ṵ t ḭ j AB a̰ AG b o AE d ʑ o AE ʊ AE ʔ d ʑ i AD
ဒုတိယဗိုလ်ချုပ်မှူးကြီး	d ṵ t ḭ j AB a̰ AG b o AE d ʑ o AE ʊ AE ʔ m̥ u AE d ʑ i AD
ဒုတိယဗိုလ်မှူးကြီး	d ṵ t ḭ j AB a̰ AG b o AE m̥ u AE d ʑ i AD
ဒုတိယအရာခံဗိုလ်	d ṵ t ḭ j AB a̰ AG ʔ ə AD j AB a AD ɡ a AD ɴ b o AE
ဒုဗ္ဘိက္ခန္တရကပ်	d o AE ʊ AE ʔ b e AD ɪ AD ʔ kʰ a AD ɴ t ə AD ɹ AI a̰ AG k a AD ʔ
ဒုယင်တော်	d ə AD j AB ɪ AD ɴ d ɔ AE
ဒုံမင်း	d o AE ʊ AE ɴ m ɪ AD ɴ
ဒုံး	d o AE ʊ AE ɴ
ဒုံးပျံ	d o AE ʊ AE ɴ b j AB a AD ɴ
ဒူလာ	d u AE l a AD
ဒူး	d u AE
ဒူးခေါင်း	d u AE ɡ a AD ʊ AE ɴ
ဒူးထောက်	d u AE tʰ a AD ʊ AE ʔ
ဒူးရင်းယို	d u AE j AB ɪ AD ɴ j AB o AE
ဒူးရင်းသီး	d u AE j AB ɪ AD ɴ θ i AD
ဒူးလေး	d u AE l e AD
ဒူးဝါး	d u AE w AC a AD
ဒေတာဘေ့စ်	d e AD t a AD b ḛ s
ဒေဝ	d e AD w AC a̰ AG
ဒေဝဒတ်	d e AD w AC ə AD d a AD ʔ
ဒေဝနာဂရီ	d e AD w AC a̰ AG n a AD ɡ ə AD ɹ AI i AD
ဒေဝါလီခံ	d e AD w AC a AD l i AD kʰ a AD ɴ
ဒေဝီ	d e AD w AC i AD
ဒေသ	d e AD θ a̰ AG
ဒေသန္တရ	d e AD θ a AD ɴ t ə AD j AB a̰ AG
ဒေသန္တရစကား	d e AD θ a AD ɴ t ə AD ɹ AI a̰ AG z ə AD ɡ a AD
ဒေသိယစကား	d e AD θ ḭ j AB a̰ AG z ə AD ɡ a AD
ဒေါက်တာ	d a AD ʊ AE ʔ t a AD
ဒေါင်း	d a AD ʊ AE ɴ
ဒေါင်းလန်း	d a AD ʊ AE ɴ l a AD ɴ
ဒေါ်	d ɔ AE
ဒေါ်ကြီး	d ɔ AE d ʑ i AD
ဒေါ်လာ	d ɔ AE l a AD
ဒေါ်လေး	d ɔ AE l e AD
ဒံပေါက်	d a AD ɴ p a AD ʊ AE ʔ
ဒြပ်	d ə AD ɹ AI a AD ʔ
ဒြပ်စင်	d ə AD ɹ AI a AD ʔ s ɪ AD ɴ
ဒြပ်ထု	d ə AD ɹ AI a AD ʔ tʰ u AE
ဒွယံဒွယံ	d w AC a̰ AG j AB a AD ɴ d w AC a̰ AG j AB a AD ɴ
ဒွာရ	d w AC a AD j AB a̰ AG
ဒွိ	d w AC ḭ
ဒွိလိင်	d w AC ḭ l e AD ɪ AD ɴ
ဒွေးဘော်	d w AC e AD b ɔ AE
ဒဿဂီရိ	d ə AD θ a̰ AG ɡ i AD j AB ḭ
ဒဿနဗေဒ	d a̰ AG θ ə AD n a̰ AG b e AD d a̰ AG
ဒဿနိကဗေဒ	d a̰ AG θ ə AD n ḭ k a̰ AG b e AD d a̰ AG
ဓနရှင်	d ə AD n a̰ AG ʃ ɪ AD ɴ
ဓနိတ	d ə AD n ḭ t a̰ AG
ဓနု	d ə AD n ṵ
ဓမ္မ	d ə AD m a̰ AG
ဓမ္မတာ	d ə AD m ə AD d a AD
ဓမ္မတာကာလ	d ə AD m ə AD d a AD k a AD l a̰ AG
ဓမ္မတာလာ	d ə AD m ə AD d a AD l a AD
ဓမ္မတာဝန်	d ə AD m ə AD d a AD w AC ʊ AE ɴ
ဓမ္မဒဿီ	d ə AD m a̰ AG m a̰ AG d a AD ʔ θ i AD
ဓမ္မဒဿီဘုရား	d ə AD m a̰ AG d ə AD t θ i AD pʰ ə AD j AB a AD
ဓမ္မပါလ	d a AD ɴ m a̰ AG p a AD l a̰ AG
ဓမ္မသတ်	d ə AD m ə AD θ a AD ʔ
ဓလေ့	d ə AD l ḛ
ဓအောက်ခြိုက်	d a̰ AG ʔ a AD ʊ AE ʔ t ɕʰ a AD ɪ AD ʔ
ဓာတုဗေဒ	d a AD t ṵ b e AD d a̰ AG
ဓာတ်	d a AD ʔ
ဓာတ်ကြီးလေးပါး	d a AD t t ɕ i AD l e AD p a AD
ဓာတ်ခဲ	d a AD ʔ kʰ e AD
ဓာတ်ခွက်	d a AD t kʰ w AC ɛ AD ʔ
ဓာတ်ငွေ့	d a AD ʔ ŋ w AC ḛ
ဓာတ်ဆီ	d a AD ʔ sʰ i AD
ဓာတ်ဆီဆိုင်	d a AD ʔ sʰ i AD z a AD ɪ AD ɴ
ဓာတ်ပုံ	d a AD ʔ p o AE ʊ AE ɴ
ဓာတ်ပြား	d a AD ʔ p j AB a AD
ဓာတ်မီးခြစ်	d a AD ʔ m i AD d ʑ ɪ AD ʔ
ဓာတ်မီးပူ	d a AD ʔ m i AD b u AE
ဓာတ်လှေကား	d a AD ʔ l̥ e AD ɡ a AD
ဓာတ်အိုး	d a AD ʔ ʔ o AE
ဓား	d a AD
ဓားစာခံ	d ə AD z a AD ɡ a AD ɴ
ဓားပြ	d ə AD m j AB a̰ AG
ဓားပြား	d ə AD b j AB a AD
ဓားအိမ်	d ə AD ʔ e AD ɪ AD ɴ
နက္ခတ္တဗေဒ	n ɛ AD ʔ kʰ ə AD t a̰ AG b e AD d a̰ AG
နက်	n ɛ AD ʔ
နက်ဖြန်	n ɛ AD ʔ pʰ j AB a AD ɴ
နကျယ်ကောင်	n ə AD d ʑ ɛ AD ɡ a AD ʊ AE ɴ
နဂါး	n ə AD ɡ a AD
နဂါးမောက်	n a̰ AG ɡ a AD m a AD ʊ AE ʔ
နဂါးမောက်သီး	n a̰ AG ɡ a AD m a AD ʊ AE ʔ θ i AD
နငယ်	n a̰ AG ŋ ɛ AD
နင်	n ɪ AD ɴ
နင်တို့	n ɪ AD ɴ d o̰ AH
နည်း	n ɛ AD
နည်းနည်း	n ɛ AD n ɛ AD
နည်းနည်းချင်း	n i AD n i AD t ɕʰ ɪ AD ɴ
နည်းပညာ	n i AD p j AB ɪ AD ɴ ɲ a AD
နတ်	n a AD ʔ
နတ်ကွန်း	n a AD ʔ k ʊ AE ɴ
နတ်ဆိုး	n a AD ʔ sʰ o AE
နတ်တော်	n ə AD d ɔ AE
နတ်နန်း	n a AD ʔ n a AD ɴ
နတ်ပြည်ခြောက်ထပ်	n a AD ʔ p j AB i AD t ɕʰ a AD ʊ AE ʔ tʰ a AD ʔ
နတ်ရွာစံ	n a AD ʔ j AB w AC a AD s a AD ɴ
နတ်သုဓာ	n a AD ʔ θ o AE ʊ AE ʔ d a AD
နတ်သုဓာထမင်း	n a AD ʔ θ o AE ʊ AE ʔ d a AD tʰ ə AD m ɪ AD ɴ
နဒီ	n ə AD d i AD
နန္ဒာ	n a AD ɴ d a AD
နန်း	n a AD ɴ
နန်းကထိ	n a AD ɴ k ə AD tʰ ḭ
နန်းကြီး	n a AD ɴ t ɕ i AD
နန်းကြီးသုပ်	n a AD ɴ t ɕ i AD θ o AE ʊ AE ʔ
နန်းတော်	n a AD ɴ d ɔ AE
နန်းပြားသုပ်	n a AD ɴ b j AB a AD θ o AE ʊ AE ʔ
နန်းမတော်	n a AD ɴ m ə AD d ɔ AE
နန်းမြင့်	n a AD ɴ m j AB ɪ̰ AG ɴ
နနွင်း	sʰ ə AD n w AC ɪ AD ɴ
နပန်း	n ə AD b a AD ɴ
နဖူး	n a̰ AG pʰ u AE
နမီးဘီးယား	n a̰ AG m i AD b i AD j AB a AD
နမူနာ	n ə AD m u AE n a AD
နမ်း	n a AD ɴ
နယုန်	n ə AD j AB o AE ʊ AE ɴ
နယူးဇီလန်	n ə AD j AB u AE z i AD l a AD ɴ
နယူးဒေလီ	n ə AD j AB u AE d e AD l i AD
နယူးယောက်	n ə AD j AB u AE j AB a AD ʊ AE ʔ
နယ်	n ɛ AD
နယ်စပ်	n ɛ AD z a AD ʔ
နယ်သာလန်	n ɛ AD ð ə AD l a AD ɴ
နရက်	n ə AD ɹ AI ɛ AD ʔ
နရန်း	n ə AD j AB a AD ɴ
နရား	n ə AD j AB a AD
နဝကမ္မ	n ə AD w AC a̰ AG k a AD ɴ m a̰ AG
နဝမ	n ə AD w AC ə AD m a̰ AG
နဝရတ်	n ə AD w AC ə AD ɹ AI a AD ʔ
နဝရူပ	n a̰ AG w AC a̰ AG j AB u AE p a̰ AG
နာ	n a AD
နာဂဒေဝ	n a AD ɡ a̰ AG d e AD w AC a̰ AG
နာဂရီ	n a AD ɡ ə AD ɹ AI i AD
နာတာလူးပွဲ	n a AD t a AD l u AE b w AC ɛ AD
နာနတ်	n ə AD n a AD ʔ
နာနတ်ပွင့်	n ə AD n a AD ʔ p w AC ɪ̰ AG ɴ
နာနတ်သီး	n a AD n a AD ʔ θ i AD
နာနာ	n a AD n a AD
နာနာဘာဝ	n a AD n a AD b a AD w AC a̰ AG
နာမ	n a AD m a̰ AG
နာမကရဏ	n a AD m a̰ AG k ə AD ɹ AI ə AD n a̰ AG
နာမကျန်း	n a AD m ə AD t ɕ a AD ɴ
နာမည်	n a AD m j AB i AD
နာမဝိသေသန	n a AD m a̰ AG w AC ḭ θ e AD θ ə AD n a̰ AG
နာမ်	n a AD ɴ
နာမ်စား	n a AD m z a AD
နာရဒ	n a AD ɹ AI ə AD d a̰ AG
နာရဒဘုရား	n a AD ɹ AI ə AD d a̰ AG pʰ ə AD j AB a AD
နာရီ	n a AD j AB i AD
နာရီဝက်	n a AD j AB i AD w AC ɛ AD ʔ
နား	n a AD
နားကပ်	n a AD ɡ a AD ʔ
နားကြပ်	n ə AD d ʑ a AD ʔ
နားကွင်း	n a AD ɡ w AC ɪ AD ɴ
နားထင်	n ə AD tʰ ɪ AD ɴ
နားထောင်	n a AD tʰ a AD ʊ AE ɴ
နားရွက်	n ə AD j AB w AC ɛ AD ʔ
နားလည်	n a AD l ɛ AD
နိကာယ	n ḭ k a AD j AB a̰ AG
နိခါတကဗေဒ	n ḭ kʰ a AD t ə AD k a̰ AG b e AD d a̰ AG
နိဂ္ဂဟိတ	n e AD ɪ AD ʔ ɡ ə AD h AA ḭ t a̰ AG
နိစ္စ	n e AD s a̰ AG
နိဒါန်း	n ḭ d a AD ɴ
နိဒ္ဒေသ	n e AD ɪ AD ʔ d e AD θ a̰ AG
နိပေါ	n ḭ p ɔ AE
နိဗ္ဗာန်	n e AD ɪ AD ʔ b a AD ɴ
နိယာမ	n ḭ j AB a AD m a̰ AG
နိုက်ထရိုဂျင်	n a AD ɪ AD ʔ tʰ ə AD ɹ AI o AE d ʑ ɪ AD ɴ
နိုင်	n a AD ɪ AD ɴ
နိုင်ဂျာ	n a AD ɪ AD ɴ d ʑ a AD
နိုင်ဂျီးရီးယား	n a AD ɪ AD ɴ d ʑ i AD ɹ AI i AD j AB a AD
နိုင်ငံ	n a AD ɪ AD ɴ ŋ a AD ɴ
နိုင်ငံကူးလက်မှတ်	n a AD ɪ AD ɴ ŋ a AD ɴ ɡ u AE l ɛ AD ʔ m̥ a AD ʔ
နိုင်ငံခြား	n a AD ɪ AD ɴ ŋ a AD ɴ d ʑ a AD
နိုင်ငံခြားသား	n a AD ɪ AD ɴ ɡ a AD ɴ d ʑ a AD ð a AD
နိုင်ငံတော်	n a AD ɪ AD ɴ ŋ a AD ɴ d ɔ AE
နိုင်ငံတော်သီချင်း	n a AD ɪ AD ɴ ŋ a AD ɴ d ɔ AE θ ə AD t ɕʰ ɪ AD ɴ
နိုင်ငံရေး	n a AD ɪ AD ɴ ŋ a AD ɴ j AB e AD
နိုင်ငံသား	n a AD ɪ AD ɴ ŋ a AD ɴ ð a AD
နိုင်ငံသားအဖြစ်	n a AD ɪ AD ɴ ŋ a AD ɴ ð a AD ʔ ə AD pʰ j AB ɪ AD ʔ
နိုင်နိုင်	n a AD ɪ AD ɴ n a AD ɪ AD ɴ
နိုဝင်ဘာ	n o AE w AC ɪ AD ɴ b a AD
နို့	n o̰ AH
နို့ဆီ	n o̰ AH z i AD
နို့လိမ်	n o̰ AH l e AD ɪ AD ɴ
နို့သီး	n o̰ AH ð i AD
နို့သီးခေါင်း	n o̰ AH ð i AD ɡ a AD ʊ AE ɴ
နိုး	n o AE
နိဿယ	n e AD ɪ AD ʔ θ ə AD j AB a̰ AG
နီ	n i AD
နီကာရာဂွါ	n i AD k a AD ɹ AI a AD ɡ w AC a AD
နီတိ	n i AD t ḭ
နီလာ	n i AD l a AD
နီး	n i AD
နုပ်	n o AE ʊ AE ʔ
နေ	n e AD
နေကောင်း	n e AD k a AD ʊ AE ɴ
နေကောင်းရဲ့လား	n e AD k a AD ʊ AE ɴ j AB ɛ̰ AG l a AD
နေစကြဝဠာ	n e AD s ɛ AD ʔ t ɕ a AD w AC ə AD l a AD
နေစာ	n e AD z a AD
နေထွက်	n e AD tʰ w AC ɛ AD ʔ
နေပြည်တော်	n e AD p j AB i AD d ɔ AE
နေရာ	n e AD j AB a AD
နေရာငါးသွယ်	n e AD j AB a AD ŋ a AD θ w AC ɛ AD
နေရာထိုင်ခင်း	n e AD j AB a AD tʰ a AD ɪ AD ɴ ɡ ɪ AD ɴ
နေဝင်	n e AD w AC ɪ AD ɴ
နေအိမ်	n e AD ʔ e AD ɪ AD ɴ
နောက်	n a AD ʊ AE ʔ
နောက်ကျ	n a AD ʊ AE ʔ t ɕ a̰ AG
နောက်ဆက်	n a AD ʊ AE ʔ sʰ ɛ AD ʔ
နောက်ပြီး	n a AD ʊ AE ʔ p i AD
နောက်ရုံး	n a AD ʊ AE ʔ j AB o AE ʊ AE ɴ
နောင်	n a AD ʊ AE ɴ
နော်	n ɔ AE
နော်ရထာ	n ɔ AE j AB ə AD tʰ a AD
နော်ဝေ	n ɔ AE w AC e AD
နေ့	n ḛ
နေ့စဉ်	n ḛ z ɪ AD ɴ
နေ့စွဲ	n ḛ z w AC ɛ AD
နေ့လည်	n ḛ l ɛ AD
နေ့လယ်	n ḛ l ɛ AD
နေ့လယ်စာ	n ḛ l ɛ AD z a AD
နဲ့	n ɛ̰ AG
နံကထိုင်	n a AD ɴ k ə AD tʰ a AD ɪ AD ɴ
နံနက်	n a AD ɴ n ɛ AD ʔ
နံနက်စာ	n a AD ɴ n ɛ AD ʔ s a AD
နံနံ	n a AD ɴ n a AD ɴ
နံပါတ်	n a AD ɴ b a AD ʔ
နံပြား	n a AD ɴ b j AB a AD
နံရိုး	n a AD ɴ j AB o AE
နျူကလိယ	n j AB u AE k ə AD l ḭ j AB a̰ AG
နွယ်တာ	n w AC ɛ AD t a AD
နွား	n w AC a AD
နွားထီး	n ə AD tʰ i AD
နွားနို့	n w AC a AD n o̰ AH
နွားနို့ခေါက်ဆွဲ	n w AC a AD n o̰ AH kʰ a AD ʊ AE ʔ sʰ w AC ɛ AD
နွားမ	n ə AD m a̰ AG
နွေ	n w AC e AD
နွေရာသီ	n w AC e AD j AB a AD ð i AD
နွေဦး	n w AC e AD ʔ u AE
နွေဦးပေါက်	n w AC e AD ʔ u AE b a AD ʊ AE ʔ
နွေဦးရာသီ	n w AC e AD ʔ u AE j AB a AD ð i AD
နွေး	n w AC e AD
နှင့်	n̥ ɪ̰ AG ɴ
နှင့်တကွ	n̥ ɪ̰ AG ɴ d ə AD ɡ w AC a̰ AG
နှင်း	n̥ ɪ AD ɴ
နှင်းခဲ	n̥ ɪ AD ɴ ɡ ɛ AD
နှင်းပွင့်	n̥ ɪ AD ɴ b w AC ɪ̰ AG ɴ
နှင်းသီး	n̥ ɪ AD ɴ ð i AD
နှစ်	n̥ ɪ AD ʔ
နှစ်ချုပ်	n̥ ɪ AD ʔ d ʑ o AE ʊ AE ʔ
နှစ်ချောင်းပုဒ်	n̥ ə AD t ɕʰ a AD ʊ AE ɴ p o AE ʊ AE ʔ
နှစ်စဉ်	n̥ ɪ AD ʔ z ɪ AD ɴ
နှစ်ဆန်းတစ်ရက်	n̥ ɪ AD ʔ sʰ a AD ɴ t ə AD j AB ɛ AD ʔ
နှစ်ဆန်းတစ်ရက်နေ့	n̥ ɪ AD ʔ sʰ a AD ɴ t ə AD j AB ɛ AD ʔ n ḛ
နှစ်ဆယ့်တစ်	n̥ ɪ AD ʔ sʰ ɛ̰ AG t ɪ AD ʔ
နှစ်ဆယ်	n̥ ɪ AD ʔ sʰ ɛ AD
နှစ်ရာ	n̥ ə AD j AB a AD
နှစ်လ	n̥ ə AD l a̰ AG
နှပ်	n̥ a AD ʔ
နှမ	n̥ ə AD m a̰ AG
နှမ်း	n̥ a AD ɴ
နှမ်းစေ့	n̥ a AD ɴ z ḛ
နှမ်းဆီ	n̥ a AD ɴ z i AD
နှလုံး	n̥ ə AD l o AE ʊ AE ɴ
နှလုံးရောဂါ	n̥ ə AD l o AE ʊ AE ɴ j AB ɔ AE ɡ a AD
နှာ	n̥ a AD
နှာခေါင်း	n̥ ə AD kʰ a AD ʊ AE ɴ
နှာခေါင်းပေါက်	n̥ ə AD kʰ a AD ʊ AE ɴ b a AD ʊ AE ʔ
နှာဘူး	n̥ a AD b u AE
နှာမောင်း	n̥ ə AD m a AD ʊ AE ɴ
နှိပ်ကြယ်သီး	n̥ e AD ɪ AD ʔ t ɕ ɛ AD ð i AD
နှုတ်	n̥ o AE ʊ AE ʔ
နှုတ်ခမ်း	n̥ o AE ʊ AE ʔ kʰ a AD ɴ
နှုတ်ဆက်	n̥ o AE ʊ AE ʔ sʰ ɛ AD ʔ
နှုတ်သီး	n̥ o AE ʊ AE ʔ θ i AD
နှော	n̥ ɔ AE
နှောက်	n̥ a AD ʊ AE ʔ
နှောင်း	n̥ a AD ʊ AE ɴ
နှေး	n̥ e AD
နှံကောင်	n̥ a AD ɴ ɡ a AD ʊ AE ɴ
ပကတိ	b ə AD ɡ ə AD d ḭ
ပကောဋိ	p ə AD k ɔ AE d ḭ
ပက်ကျိ	p ɛ AD ʔ t ɕ ḭ
ပခုက္ကူ	p ə AD kʰ u AE k k u AE
ပခုံး	p ə AD kʰ o AE ʊ AE ɴ
ပင့်	p ɪ̰ AG ɴ
ပင့်ကူ	p ɪ̰ AG ɴ ɡ u AE
ပင့်ကူအိမ်	p ɪ̰ AG ɴ ɡ u AE ʔ e AD ɪ AD ɴ
ပင်ဂွင်	p ɪ AD ɴ ɡ w AC ɪ AD ɴ
ပင်စင်	p ɪ AD ɴ s ɪ AD ɴ
ပင်စင်စား	p ɪ AD ɴ s ɪ AD ɴ s a AD
ပင်စည်	p ɪ AD ɴ z i AD
ပင်စိမ်း	p ɪ AD ɴ z e AD ɪ AD ɴ
ပင်စိမ်းမွှေး	p ɪ AD ɴ z e AD ɪ AD ɴ m̥ w AC e AD
ပင်ပေါင်	p ɪ AD ɴ p a AD ʊ AE ɴ
ပင်မှည့်	p ɪ AD ɴ m̥ ɛ̰ AG
ပင်လယ်	p ɪ AD ɴ l ɛ AD
ပင်လယ်ဆား	p ɪ AD ɴ l ɛ AD z a AD
ပင်လယ်ဓားပြ	p ɪ AD ɴ l ɛ AD d ə AD m j AB a̰ AG
ပင်လယ်အော်	p ɪ AD ɴ l ɛ AD ʔ ɔ AE
ပစောက်	p a̰ AG z a AD ʊ AE ʔ
ပစ္စက္ခ	p ɪ AD ʔ s ɛ AD ʔ kʰ a̰ AG
ပစ္စည်း	p ɪ AD ʔ s i AD
ပစ္စည်းလေးပါး	p j AB ɪ AD ʔ s i AD l e AD b a AD
ပစ္စယာ	p j AB ɪ AD ʔ s ə AD j AB a AD
ပစ္စုပ္ပန်	p j AB ɪ AD ʔ s o AE ʊ AE ʔ p a AD ɴ
ပစ္ဆိမ	p j AB ɪ AD ʔ sʰ e AD ɪ AD ʔ m a̰ AG
ပစ်	p j AB ɪ AD ʔ
ပဇာ	b ə AD z a AD
ပဉ္စကလျာဏီ	p j AB ɪ AD ɴ s a̰ AG k ə AD l ə AD j AB a AD n i AD
ပဉ္စင်တူရိယာ	p j AB ɪ AD ʔ s ɪ AD ɴ t u AE ɹ AI ḭ j AB a AD
ပဉ္စင်း	b ə AD z ɪ AD ɴ
ပဉ္စမ	p j AB ɪ AD ɴ s ə AD m a̰ AG
ပဉ္စရူပ	p j AB ɪ AD ɴ s a̰ AG ɹ AI u AE p a̰ AG
ပဉ္စလက်	p ɪ AD ɴ s ə AD l ɛ AD ʔ
ပညတ်	p j AB ɪ̰ AG ɴ n a AD ʔ
ပညတ်တော်	p j AB ɪ̰ AG ɴ n a AD ʔ t ɔ AE
ပညာ	p j AB ɪ AD ɴ ɲ a AD
ပညာကျော်	p j AB ɪ AD ɴ ɲ a AD d ʑ ɔ AE
ပညာပေး	p j AB ɪ AD ɴ ɲ a AD p e AD
ပညာဗလ	p j AB ɪ AD ɴ ɲ a AD b ə AD l a̰ AG
ပညာရေး	p j AB ɪ AD ɴ ɲ a AD j AB e AD
ပညာရှင်	p j AB ɪ AD ɴ ɲ a AD ʃ ɪ AD ɴ
ပဋိဇီဝဆေး	p a̰ AG d ḭ z i AD w AC a̰ AG sʰ e AD
ပဋိပက္ခ	p ə AD t ḭ p ɛ AD ʔ kʰ a̰ AG
ပဋိပက္ခဒေသ	p ə AD d ḭ p ɛ AD ʔ kʰ a̰ AG d e AD θ a̰ AG
ပဋိသန္ဓေ	p ə AD d ḭ θ a AD ɴ d e AD
ပဌမ	p a̰ AG tʰ a̰ AG m a̰ AG
ပဏ္ဍိတ	p a AD n d ḭ t a̰ AG
ပဏ္ဏာ	p ə AD n a AD
ပတ္တမြား	b ə AD d ə AD m j AB a AD
ပတ္တလား	p a AD ʔ t a̰ AG l a AD
ပတ္ထနာ	p ə AD tʰ ə AD n a AD
ပတ်	p a AD ʔ
ပတ်စပို့	p a AD ʔ s ə AD p o̰ AH
ပတ်တီး	p a AD ʔ t i AD
ပတ်ဝန်းကျင်	p a AD ʔ w AC ʊ AE ɴ t ɕ ɪ AD ɴ
ပထမ	p a̰ AG tʰ a̰ AG m a̰ AG
ပထမဘွဲ့	p a̰ AG tʰ ə AD m a̰ AG b w AC ɛ̰ AG
ပထဝီဝင်	p ə AD tʰ ə AD w AC i AD w AC ɪ AD ɴ
ပထွေး	p ə AD tʰ w AC e AD
ပဒုမ	p ə AD d ṵ m a̰ AG
ပဒုမဘုရား	p ə AD d ṵ m a̰ AG pʰ ə AD j AB a AD
ပဒုမုတ္တရ	p ə AD d ṵ m o AE ʊ AE ʔ t ə AD ɹ AI a̰ AG
ပဒုမုတ္တရဘုရား	p ə AD d ṵ m o AE ʊ AE ʔ t ə AD ɹ AI a̰ AG pʰ ə AD j AB a AD
ပဒေသရာဇ်	b ə AD d e AD θ ə AD ɹ AI ɪ AD ʔ
ပဒေသာ	b ə AD d e AD ð a AD
ပဒေသာပင်	b ə AD d e AD ð a AD b ɪ AD ɴ
ပနားမား	p a̰ AG n a AD m a AD
ပန်	p a AD ɴ
ပန်ကာ	p a AD ɴ k a AD
ပန်တျာ	p a AD ɴ t ə AD j AB a AD
ပန်း	p a AD ɴ
ပန်းကန်	b ə AD ɡ a AD ɴ
ပန်းခုနစ်မည်	p a AD ɴ kʰ ə AD n ə AD m j AB i AD
ပန်းချီ	b ə AD d ʑ i AD
ပန်းချီဆရာ	b ə AD d ʑ i AD sʰ ə AD j AB a AD
ပန်းခြံ	p a AD ɴ d ʑ a AD ɴ
ပန်းဂေါ်ဖီ	p a AD ɴ ɡ ɔ AE b i AD
ပန်းစည်း	p a AD ɴ z i AD
ပန်းဆယ်မျိုး	p a AD ɴ sʰ ɛ AD m j AB o AE
ပန်းတဉ်း	b ə AD d ɪ AD ɴ
ပန်းတမော့	p a AD ɴ d ə AD m ɔ̰ AH
ပန်းတော့	p a AD ɴ d ɔ̰ AH
ပန်းထိမ်	b ə AD d e AD ɪ AD ɴ
ပန်းနာ	p a AD ɴ n a AD
ပန်းနာရင်ကျပ်	p a AD ɴ n a AD j AB ɪ AD ɴ t ɕ a AD ʔ
ပန်းပု	b ə AD b ṵ
ပန်းပဲ	b ə AD b ɛ AD
ပန်းပွတ်	b ə AD b ʊ AE ʔ
ပန်းမုန်လာ	p a AD ɴ m o AE ʊ AE ɴ l a AD
ပန်းမုန်လာစိမ်း	p a AD ɴ m o AE ʊ AE ɴ l a AD z e AD ɪ AD ɴ
ပန်းမုန်လာဖြူ	p a AD ɴ m o AE ʊ AE ɴ l a AD b j AB u AE
ပန်းယွန်း	p a AD ɴ j AB ʊ AE ɴ
ပန်းရန်	b ə AD j AB a AD ɴ
ပန်းရွဲ	p a AD ɴ j AB w AC ɛ AD
ပန်းသီး	p a AD ɴ ð i AD
ပန်းသေရောဂါ	p a AD ɴ θ e AD j AB ɔ AE ɡ a AD
ပန်းသေး	p a AD ɴ ð e AD
ပန်းသေးခေါက်ဆွဲ	p a AD ɴ θ e AD kʰ a AD ʊ AE ʔ sʰ w AC ɛ AD
ပန်းအိ	p a AD ɴ ʔ ḭ
ပန်းအိုး	p a AD ɴ ʔ o AE
ပမာဏ	p ə AD m a AD n a̰ AG
ပယောဂ	p ə AD j AB ɔ AE ɡ a̰ AG
ပယ်ရှား	p ɛ AD ʃ a AD
ပရဟိတ	p ə AD ɹ AI a̰ AG h AA ḭ t a̰ AG
ပရိက္ခရာ	p ə AD ɹ AI e AD ɪ AD ʔ kʰ ə AD j AB a AD
ပရိဒေဝ	p ə AD ɹ AI ḭ d e AD w AC a̰ AG
ပရိဘောဂ	p ə AD ɹ AI ḭ b ɔ AE ɡ a̰ AG
ပရိယာယ်	p ə AD ɹ AI ḭ j AB e AD
ပရိသတ်	p ə AD j AB e AD ɪ AD ʔ θ a AD ʔ
ပရိုဂရမ်	p ə AD ɹ AI o AE ɡ ə AD ɹ AI a AD ɴ
ပရိုဂျက်	p ə AD ɹ AI o AE d ʑ ɛ AD ʔ
ပရုတ်	p ə AD j AB o AE ʊ AE ʔ
ပလတ်	p ə AD l a AD ʔ
ပလတ်စတစ်	p ə AD l a AD ʔ s ə AD t ɪ AD ʔ
ပလပ်ကြွတ်	p a̰ AG l a AD ʔ t ɕ ʊ AE ʔ
ပလပ်စတစ်	p ə AD l a AD ʔ s ə AD t ɪ AD ʔ
ပလာတာ	p ə AD l a AD t a AD
ပလိပ်	p ə AD l e AD ɪ AD ʔ
ပလူတိုနီယမ်	p ə AD l u AE t o AE n i AD j AB a AD ɴ
ပလောင်	p ə AD l a AD ʊ AE ɴ
ပလ္လင်	p ə AD l ɪ AD ɴ
ပလွေ	p a̰ AG l w AC e AD
ပဝရ	p ə AD w AC ə AD ɹ AI a̰ AG
ပဝါ	p a̰ AG w AC a AD
ပဝေဏီ	p ə AD w AC e AD n i AD
ပသီ	p ə AD θ i AD
ပသျှူး	p ə AD ʃ u AE
ပသျှူးရာမ	p ə AD ʃ u AE j AB a AD m a̰ AG
ပအို့ဝ်	p ə AD ʔ o̰ AH
ပါ	p a AD
ပါကစ္စတန်	p a AD k ɪ AD ʔ s ə AD t a AD ɴ
ပါဆယ်	p a AD sʰ ɛ AD
ပါတာနီ	p a AD t a AD n i AD
ပါတိတ်	p a AD t e AD ɪ AD ʔ
ပါတီ	p a AD t i AD
ပါပူအာနယူးဂီနီ	p a AD p u AE ʔ a AD n ə AD j AB u AE ɡ i AD n i AD
ပါမောက္ခ	p a AD m a AD ʊ AE ʔ kʰ a̰ AG
ပါရဂူဘွဲ့	p a AD j AB ə AD ɡ u AE b w AC ɛ̰ AG
ပါရမီ	p a AD ɹ AI ə AD m i AD
ပါရရာ	p a AD ɹ AI ə AD j AB a AD
ပါရာဂွေး	p a AD ɹ AI a AD ɡ w AC e AD
ပါရီ	p a AD ɹ AI i AD
ပါရှား	p a AD ʃ a AD
ပါလက်စတိုင်း	p a AD l ɛ AD ʔ s ə AD t a AD ɪ AD ɴ
ပါလီမန်	p a AD l i AD m a AD ɴ
ပါဝါ	p a AD w AC a AD
ပါဠိ	p a AD l ḭ
ပါး	p a AD
ပါးစပ်	p ə AD z a AD ʔ
ပါးဟက်	p ə AD h AA ɛ AD ʔ
ပိ	p ḭ
ပိဋကတ်	b ḭ t ə AD ɡ a AD ʔ
ပိဋကတ်တိုက်	b ḭ d ə AD ɡ a AD ʔ d a AD ɪ AD ʔ
ပိတ်	p e AD ɪ AD ʔ
ပိန္နဲ	p e AD ɪ AD ɴ n ɛ AD
ပိန်းဥ	p e AD ɪ AD ɴ ʔ ṵ
ပိရမစ်	p ḭ ɹ AI ə AD m ɪ AD ʔ
ပို	p o AE
ပိုက်	p a AD ɪ AD ʔ
ပိုက်ဆံ	p a AD ɪ AD ʔ sʰ a AD ɴ
ပိုက်ဆံအိတ်	p a AD ɪ AD ʔ sʰ a AD ɴ ʔ e AD ɪ AD ʔ
ပိုက်သမား	p a AD ɪ AD ʔ θ ə AD m a AD
ပိုင်ရှင်	p a AD ɪ AD ɴ ʃ ɪ AD ɴ
ပိုင်း	p a AD ɪ AD ɴ
ပိုစတာ	p o AE s ə AD t a AD
ပိုတက်ဆီယမ်	p o AE t ɛ AD ʔ sʰ i AD j AB a AD ɴ
ပိုဒ်	p a AD ɪ AD ʔ
ပိုလန်	p o AE l a AD ɴ
ပို့	p o̰ AH
ပို့စကတ်	p o̰ AH s ə AD k a AD ʔ
ပိုး	p o AE
ပိုးကြာချည်	p o AE t ɕ a AD t ɕʰ i AD
ပိုးတောင်မာ	p o AE d a AD ʊ AE ɴ m a AD
ပိုးလောင်း	p o AE l a AD ʊ AE ɴ
ပိုးဟပ်	p o AE h AA a AD ʔ
ပိုးဟပ်ဖြူ	p o AE h AA a AD ʔ pʰ j AB u AE
ပိဿာ	p e AD ɪ AD ʔ θ a AD
ပီကင်း	p i AD k ɪ AD ɴ
ပီကေ	p i AD k e AD
ပီစီ	p i AD s i AD
ပီဇာ	p i AD z a AD
ပီတိ	p i AD t ḭ
ပီပီ	p i AD b i AD
ပီယဒဿီ	p i AD j AB a̰ AG d a AD ʔ θ i AD
ပီယဒဿီဘုရား	p i AD j AB a̰ AG d a AD ʔ θ i AD pʰ ə AD j AB a AD
ပီရူး	p i AD ɹ AI u AE
ပီလောပီနံ	p i AD l ɔ AE p i AD n a AD ɴ
ပု	p ṵ
ပုခက်	p ə AD kʰ ɛ AD ʔ
ပုဂံ	b ə AD ɡ a AD ɴ
ပုဂ္ဂလိက	p o AE ʊ AE ʔ ɡ ə AD l ḭ ɡ a̰ AG
ပုဂ္ဂိုလ်	p o AE ʊ AE ʔ ɡ o AE
ပုစဉ်း	b ə AD z ɪ AD ɴ
ပုစ္ဆာ	p o AE ʊ AE ʔ sʰ a AD
ပုစွန်	b ə AD z ʊ AE ɴ
ပုဆိန်	p ə AD sʰ e AD ɪ AD ɴ
ပုဆိုး	p ə AD sʰ o AE
ပုဏ္ဏမာ	p o AE ʊ AE ɴ n ə AD m a AD
ပုဏ္ဏား	p o AE ʊ AE ɴ n a AD
ပုဏ္ဏားကျွန်း	p o AE ʊ AE ɴ n a AD d ʑ ʊ AE ɴ
ပုတ်သင်ညို	p o AE ʊ AE ʔ θ ɪ AD ɴ ɲ o AE
ပုထိုး	p ə AD tʰ o AE
ပုဒ်	p o AE ʊ AE ʔ
ပုဒ်ကလေး	p o AE ʊ AE ʔ k ə AD l e AD
ပုဒ်ကြီး	p o AE ʊ AE ʔ d ʑ i AD
ပုဒ်ထီး	p o AE ʊ AE ʔ k ə AD l e AD
ပုဒ်ဖြတ်	p o AE ʊ AE ʔ pʰ j AB a AD ʔ
ပုဒ်မ	p o AE ʊ AE ʔ m a̰ AG
ပုန်ကန်	p o AE ʊ AE ɴ k a AD ɴ
ပုန်းရည်ကြီး	p o AE ʊ AE ɴ j AB e AD d ʑ i AD
ပုပ်	p o AE ʊ AE ʔ
ပုဗ္ဗ	p o AE ʊ AE ʔ b a̰ AG
ပုရစ်	p ə AD j AB ɪ AD ʔ
ပုရပိုက်	p ə AD ɹ AI ə AD b a AD ɪ AD ʔ
ပုရွက်	p ə AD j AB w AC ɛ AD ʔ
ပုရွက်ဆိတ်	p ə AD j AB w AC ɛ AD ʔ sʰ e AD ɪ AD ʔ
ပုလင်း	p ə AD l ɪ AD ɴ
ပုလိပ်	p ə AD l e AD ɪ AD ʔ
ပုလဲ	p ə AD l ɛ AD
ပုသိမ်	p ə AD θ e AD ɪ AD ɴ
ပုံ	p o AE ʊ AE ɴ
ပုံဆွဲ	p o AE ʊ AE ɴ sʰ w AC ɛ AD
ပုံတူ	p o AE ʊ AE ɴ d u AE
ပုံတူကား	p o AE ʊ AE ɴ d u AE k a AD
ပုံနှိပ်စက်	p o AE ʊ AE ɴ n̥ e AD ɪ AD ʔ s ɛ AD ʔ
ပုံသေနည်း	p o AE ʊ AE ɴ ð e AD n i AD
ပုံး	p o AE ʊ AE ɴ
ပူ	p u AE
ပူဇော်	p u AE z ɔ AE
ပူတင်း	p u AE t ɪ AD ɴ
ပူဒီနာ	p u AE s i AD n a AD
ပူရ	p u AE ɹ AI a̰ AG
ပူရီ	p u AE j AB i AD
ပေကျင်း	p e AD t ɕ ɪ AD ɴ
ပေါက်စီ	p a AD ʊ AE ʔ s i AD
ပေါက်တူး	p a AD ʊ AE ʔ t u AE
ပေါက်ဖော်	p a AD ʊ AE ʔ pʰ ɔ AE
ပေါင်	p a AD ʊ AE ɴ
ပေါင်မုန့်	p a AD ʊ AE ɴ m o̰ AH ʊ AE ɴ
ပေါင်းတင်း	p a AD ʊ AE ɴ d ɪ AD ɴ
ပေါင်းဖို	p a AD ʊ AE ɴ b o AE
ပေါ့	p ɔ̰ AH
ပေါ်	p ɔ AE
ပေါ်ဆန်းမွှေး	p ɔ AE sʰ a AD ɴ m̥ w AC e AD
ပေါ်တူဂီ	p ɔ AE t u AE ɡ i AD
ပေါ်လစီ	p ɔ AE l ə AD s i AD
ပေး	p e AD
ပဲ	p ɛ AD
ပဲကြီး	p ɛ AD d ʑ i AD
ပဲခူး	b ə AD ɡ o AE
ပဲငံပြာရည်	p ɛ AD ŋ a AD ɴ b j AB a AD j AB e AD
ပဲဆီ	p ɛ AD z i AD
ပဲနံ့သာ	p ɛ AD n a̰ AG ɴ θ a AD
ပဲပင်ပေါက်	p ɛ AD b ɪ AD ɴ b a AD ʊ AE ʔ
ပဲပိုးတီ	p ɛ AD p o AE d i AD
ပဲမှုန့်	p ɛ AD m̥ o̰ AH ʊ AE ɴ
ပဲ့တင်သံ	p ɛ̰ AG t ɪ AD ɴ ð a AD ɴ
ပျစ်	p j AB ɪ AD ʔ
ပျဉ်	p j AB ɪ AD ɴ
ပျဉ်းကတိုး	p j AB ɪ AD ɴ ɡ ə AD d o AE
ပျဉ်းတော်သိမ်	p j AB ɪ AD ɴ d ɔ AE θ e AD ɪ AD ɴ
ပျဉ်းမ	p j AB ɪ AD ɴ m a̰ AG
ပျပျ	p j AB a̰ AG b j AB a̰ AG
ပျား	p j AB a AD
ပျားတူ	b a̰ AG d u AE
ပျားထီး	p j AB a AD d i AD
ပျားရည်	p j AB a AD j AB e AD
ပျိုး	p j AB o AE
ပျူ	p j AB u AE
ပျော့	p j AB ɔ̰ AH
ပျော်	p j AB ɔ AE
ပျော်ပျော်	p j AB ɔ AE b j AB ɔ AE
ပျံ	p j AB a AD ɴ
ပျံတော်မူ	p j AB a AD ɴ t ɔ AE m u AE
ပြ	p j AB a̰ AG
ပြက္ခဒိန်	p j AB ɛ AD ʔ ɡ ə AD d e AD ɪ AD ɴ
ပြင်	p j AB ɪ AD ɴ
ပြင်ပြင်	p j AB ɪ AD ɴ b j AB ɪ AD ɴ
ပြင်သစ်	p j AB ɪ AD ɴ θ ɪ AD ʔ
ပြင်သည်	p j AB ɪ AD ɴ θ i AD
ပြင်း	p j AB ɪ AD ɴ
ပြင်းဟုပ်	p j AB ɪ AD ɴ h AA o AE ʊ AE ʔ
ပြစ်မှု	p j AB ɪ AD ʔ m̥ ṵ
ပြည့်	p j AB ḛ
ပြည့်တန်ဆာ	p j AB ḭ d ə AD z a AD
ပြည်	p j AB i AD
ပြည်ကြီးငါး	p j AB i AD d ʑ i AD ŋ a AD
ပြည်ကြီးမွန်	p j AB i AD d ʑ i AD m ʊ AE ɴ
ပြည်တွင်း	p j AB i AD d w AC ɪ AD ɴ
ပြည်ထောင်စု	p j AB i AD d a AD ʊ AE ɴ z ṵ
ပြည်ထောင်စုတော်လှန်ရေးကောင်စီအဖွဲ့	p j AB i AD d a AD ʊ AE ɴ z ṵ t ɔ AE l̥ a AD ɴ j AB e AD k a AD ʊ AE ɴ s i AD ʔ ə AD pʰ w AC ɛ̰ AG
ပြည်ထောင်စုနေ့	p j AB i AD d a AD ʊ AE ɴ z ṵ n ḛ
ပြည်ထောင်စုလွှတ်တော်	p j AB i AD d a AD ʊ AE ɴ z ṵ l̥ ʊ AE ʔ t ɔ AE
ပြည်နယ်	p j AB i AD n ɛ AD
ပြည်သူ	p j AB i AD ð u AE
ပြည်သူပိုင်	p j AB i AD ð u AE b a AD ɪ AD ɴ
ပြည်သူပိုင်သိမ်း	p j AB i AD ð u AE b a AD ɪ AD ɴ ð e AD ɪ AD ɴ
ပြည်သူပြည်သား	p j AB i AD ð u AE p j AB i AD ð a AD
ပြည်သူ့ဆိုင်	p j AB i AD ð ṵ sʰ a AD ɪ AD ɴ
ပြည်သူ့လွှတ်တော်	p j AB i AD ð ṵ l̥ ʊ AE ʔ t ɔ AE
ပြဌာန်း	p j AB a̰ AG tʰ a AD ɴ
ပြတင်းပေါက်	b ə AD d ɪ AD ɴ b a AD ʊ AE ʔ
ပြတိုက်	p j AB a̰ AG d a AD ɪ AD ʔ
ပြဒါး	b ə AD d a AD
ပြဒါးချိန်	b ə AD d a AD d ʑ e AD ɪ AD ɴ
ပြန်	p j AB a AD ɴ
ပြန်ကြား	p j AB a AD ɴ t ɕ a AD
ပြန်ကြားရေး	p j AB a AD ɴ t ɕ a AD j AB e AD
ပြန်လှန်	p j AB a AD ɴ l̥ a AD ɴ
ပြပွဲ	p j AB a̰ AG b w AC ɛ AD
ပြယုဂ်	p j AB a̰ AG j AB o AE ʊ AE ʔ
ပြသ	p j AB a̰ AG θ a̰ AG
ပြာ	p j AB a AD
ပြာခွက်	p j AB a AD ɡ w AC ɛ AD ʔ
ပြာဋိဟာ	p j AB a AD d ḭ h AA a AD
ပြာတာ	p j AB a AD t a AD
ပြာသာဒ်	p j AB a AD ʔ θ a AD ʔ
ပြာသို	p j AB a AD ð o AE
ပြား	p j AB a AD
ပြိတ္တာ	p j AB e AD ɪ AD ʔ t a AD
ပြိုင်ပွဲ	p j AB a AD ɪ AD ɴ b w AC e AD
ပြီ	p j AB i AD
ပြီး	p i AD
ပြီးတော့	p i AD d ɔ̰ AH
ပြီးပြီ	p i AD b i AD
ပြု	p j AB ṵ
ပြုတ်	p j AB o AE ʊ AE ʔ
ပြုပြင်	p j AB ṵ b j AB ɪ AD ɴ
ပြုံယမ်း	p j AB o AE ʊ AE ɴ j AB a AD ɴ
ပြုံး	p j AB o AE ʊ AE ɴ
ပြော	p j AB ɔ AE
ပြောင်း	p j AB a AD ʊ AE ɴ
ပြောင်းဖူး	p j AB a AD ʊ AE ɴ b u AE
ပြောင်းလဲ	p j AB a AD ʊ AE ɴ l ɛ AD
ပြေး	p j AB e AD
ပြွတ်	p j AB ʊ AE ʔ
ပြွန်	p j AB ʊ AE ɴ
ပြွမ်း	p j AB ʊ AE ɴ
ပြဿဒါး	p j AB a AD ʔ ð ə AD d a AD
ပြဿနာ	p j AB a AD ʔ θ ə AD n a AD
ပွတ်	p ʊ AE ʔ
ပွား	p w AC a AD
ပွိုင့်	p w AC a̰ AG ɪ AD ɴ
ပွေး	p w AC e AD
ပွဲ	p w AC ɛ AD
ပွဲတော်	p w AC ɛ AD d ɔ AE
ဖက်	pʰ ɛ AD ʔ
ဖက်ဆစ်ဝါဒ	pʰ ɛ AD ʔ sʰ ɪ AD ʔ w AC a AD d a̰ AG
ဖက်ရှင်	pʰ ɛ AD ʔ ʃ ɪ AD ɴ
ဖက်ဝန်း	pʰ ɛ AD ʔ w AC ʊ AE ɴ
ဖခင်	pʰ a̰ AG ɡ ɪ AD ɴ
ဖငယ်	pʰ a̰ AG ŋ ɛ AD
ဖင်	pʰ ɪ AD ɴ
ဖင်လန်	pʰ ɪ AD ɴ l a AD ɴ
ဖင်လျက်	pʰ ɪ AD ɴ j AB ɛ AD ʔ
ဖတ်	pʰ a AD ʔ
ဖတ်တီး	pʰ a AD ʔ t i AD
ဖန်ခါး	pʰ a AD ɴ ɡ a AD
ဖန်ခါးသီး	pʰ a AD ɴ ɡ a AD ð i AD
ဖန်တီး	pʰ a AD ɴ d i AD
ဖမ်း	pʰ a AD ɴ
ဖယောင်း	pʰ ə AD j AB a AD ʊ AE ɴ
ဖယောင်းတိုင်	pʰ ə AD j AB a AD ʊ AE ɴ d a AD ɪ AD ɴ
ဖယ်ဒရေးရှင်း	pʰ ɛ AD d ə AD ɹ AI e AD ʃ ɪ AD ɴ
ဖရန့်	pʰ ə AD ɹ AI a̰ AG ɴ
ဖရုံ	pʰ ə AD j AB o AE ʊ AE ɴ
ဖရုံဆွဲ	pʰ ə AD j AB o AE ʊ AE ɴ z w AC ɛ AD
ဖရဲ	pʰ ə AD j AB ɛ AD
ဖလား	pʰ ə AD l a AD
ဖဝါး	pʰ ə AD w AC a AD
ဖဦးထုပ်	pʰ a̰ AG ʔ u AE tʰ o AE ʊ AE ʔ
ဖာခေါင်း	pʰ a AD ɡ a AD ʊ AE ɴ
ဖာမ	pʰ a AD m a̰ AG
ဖာလာ	pʰ a AD l a AD
ဖာလာစေ့	pʰ a AD l a AD s ḛ
ဖာလူဒါ	pʰ a AD l u AE d a AD
ဖာသည်မ	pʰ a AD θ ɛ AD m a̰ AG
ဖား	pʰ a AD
ဖားပြုပ်	pʰ ə AD b j AB o AE ʊ AE ʔ
ဖားလောင်း	pʰ ə AD l a AD ʊ AE ɴ
ဖိတ်	pʰ e AD ɪ AD ʔ
ဖိနပ်	pʰ ə AD n a AD ʔ
ဖိလစ်ပိုင်	pʰ ḭ l ɪ AD ʔ p a AD ɪ AD ɴ
ဖိအား	pʰ ḭ ʔ a AD
ဖိုင်	pʰ a AD ɪ AD ɴ
ဖို့	pʰ o̰ AH
ဖိုးသူတော်	pʰ o AE θ u AE d ɔ AE
ဖီဂျီ	pʰ i AD d ʑ i AD
ဖုတ်	pʰ o AE ʊ AE ʔ
ဖုန်	pʰ o AE ʊ AE ɴ
ဖုန်စုပ်စက်	pʰ o AE ʊ AE ɴ s o AE ʊ AE ʔ s ɛ AD ʔ
ဖုန်းနံပါတ်	pʰ o AE ʊ AE ɴ n a AD ɴ b a AD ʔ
ဖုံး	pʰ o AE ʊ AE ɴ
ဖုဿ	pʰ o AE ʊ AE ʔ θ a̰ AG
ဖုဿဘုရား	pʰ o AE ʊ AE ʔ θ a̰ AG pʰ ə AD j AB a AD
ဖူး	b u AE
ဖေဖော်ဝါရီ	pʰ e AD pʰ ɔ AE w AC a AD ɹ AI i AD
ဖေါ်ပြချက်	pʰ ɔ AE p j AB a̰ AG t ɕʰ ɛ AD ʔ
ဖောက်	pʰ a AD ʊ AE ʔ
ဖောက်သည်	pʰ a AD ʊ AE ʔ θ e AD
ဖောင်	pʰ a AD ʊ AE ɴ
ဖော့ဖျက်	pʰ ɔ̰ AH b j AB ɛ AD ʔ
ဖော့လုံး	pʰ ɔ̰ AH l o AE ʊ AE ɴ
ဖော်	pʰ ɔ AE
ဖော်ပြ	pʰ ɔ AE p j AB a̰ AG
ဖဲ	pʰ ɛ AD
ဖဲကြိုး	pʰ ɛ AD d ʑ o AE
ဖျင်ဖျင်	pʰ j AB ɪ AD ɴ b j AB ɪ AD ɴ
ဖျာ	pʰ j AB a AD
ဖျား	pʰ j AB a AD
ဖျောက်ဆိပ်	pʰ j AB a AD ʊ AE ʔ sʰ e AD ɪ AD ʔ
ဖျံ	pʰ j AB a AD ɴ
ဖြစ်	pʰ j AB ɪ AD ʔ
ဖြည့်	pʰ j AB ḛ
ဖြည်းဖြည်း	pʰ j AB e AD b j AB e AD
ဖြည်းဖြည်းချင်း	pʰ j AB i AD pʰ j AB i AD t ɕʰ ɪ AD ɴ
ဖြားယောင်း	pʰ j AB a AD j AB a AD ʊ AE ɴ
ဖြီး	pʰ i AD
ဖြူ	pʰ j AB u AE
ဖြူး	pʰ j AB u AE
ဖြေ	pʰ j AB e AD
ဖြေဖျောက်	pʰ j AB e AD b j AB a AD ʊ AE ʔ
ဖြေရှင်း	pʰ j AB e AD ʃ ɪ AD ɴ
ဖြောင့်	pʰ j AB a̰ AG ʊ AE ɴ
ဖြောဖြော	pʰ j AB ɔ AE b j AB ɔ AE
ဖြော်ဖြော်	pʰ j AB ɔ AE b j AB ɔ AE
ဖွင့်	pʰ w AC ɪ̰ AG ɴ
ဖွား	pʰ w AC a AD
ဖွဲ့စည်းပုံ	pʰ w AC ɛ̰ AG z i AD b o AE ʊ AE ɴ
ဖွဲ့စည်းပုံအခြေခံဥပဒေ	pʰ w AC ɛ̰ AG z i AD b o AE ʊ AE ɴ ʔ ə AD t ɕʰ e AD ɡ a AD ɴ ʔ ṵ b ə AD d e AD
ဗက်တီးရီးယား	b ɛ AD ʔ t i AD ɹ AI i AD j AB a AD
ဗင်နီဇွဲလား	b ɪ AD ɴ n i AD z w AC ɛ AD l a AD
ဗညား	b ə AD ɲ a AD
ဗထက်ခြိုက်	b a̰ AG tʰ ɛ AD ʔ t ɕʰ a AD ɪ AD ʔ
ဗန်တို	b a AD ɴ d o AE
ဗန်ရှည်	b a AD ɴ ʃ e AD
ဗန်းမော်	b a AD ɴ m ɔ AE
ဗမာ	b ə AD m a AD
ဗမာ့	b ə AD m a̰ AG
ဗလ	b ə AD l a̰ AG
ဗလဝ	b ə AD l ə AD w AC a̰ AG
ဗလာစာအုပ်	b ə AD l a AD s a AD ʔ o AE ʊ AE ʔ
ဗလီ	b ə AD l i AD
ဗဟို	b ə AD h AA o AE
ဗဟုသုတ	b ə AD h AA ṵ θ ṵ t a̰ AG
ဗာတီကန်	b a AD t i AD k a AD ɴ
ဗာတီကန်မြို့ပြနိုင်ငံ	b a AD t i AD k a AD ɴ m j AB o̰ AH p j AB a̰ AG n a AD ɪ AD ɴ ŋ a AD ɴ
ဗာဒံ	b a AD d a AD ɴ
ဗာလ	b a AD l a̰ AG
ဗာလချောင်	b a AD l a̰ AG t ɕʰ a AD ʊ AE ɴ
ဗားနစ်	b a AD n ɪ AD ʔ
ဗိန္ဒု	b e AD ɪ AD ɴ d ṵ
ဗိမာန်	b e AD ɪ AD ʔ m a AD ɴ
ဗိသုကာ	b ḭ ð ə AD ɡ a AD
ဗိုက်	b a AD ɪ AD ʔ
ဗိုက်ကြီး	b a AD ɪ AD ʔ t ɕ i AD
ဗိုက်ဆာတယ်	b a AD ɪ AD ʔ sʰ a AD t ɛ AD
ဗိုင်း	b a AD ɪ AD ɴ
ဗိုင်းရပ်စ်	b a AD ɪ AD ɴ ɹ AI a AD ʔ s
ဗိုလ်	b o AE
ဗိုလ်ကျ	b o AE t ɕ a̰ AG
ဗိုလ်ကြီး	b o AE d ʑ i AD
ဗိုလ်ချုပ်	b o AE d ʑ o AE ʊ AE ʔ
ဗိုလ်ချုပ်ကြီး	b o AE d ʑ o AE ʊ AE ʔ d ʑ i AD
ဗိုလ်ချုပ်မှူးကြီး	b o AE d ʑ o AE ʊ AE ʔ m̥ u AE d ʑ i AD
ဗိုလ်မှူး	b o AE m̥ u AE
ဗိုလ်မှူးကြီး	b o AE m̥ u AE d ʑ i AD
ဗိုလ်မှူးချုပ်	b o AE m̥ u AE d ʑ o AE ʊ AE ʔ
ဗိုလ်လောင်း	b o AE l a AD ʊ AE ɴ
ဗို့	b o̰ AH
ဗို့အား	b o̰ AH ʔ a AD
ဗိဿနိုး	b e AD ɪ AD ʔ θ ə AD n o AE
ဗီဇ	b i AD z a̰ AG
ဗီဇာ	b i AD z a AD
ဗီတာမင်	b i AD t a AD m ɪ AD ɴ
ဗီဒီယို	b i AD d i AD j AB o AE
ဗီယက်နမ်	b i AD j AB ɛ AD ʔ n a AD ɴ
ဗီယင်ကျန်း	b i AD j AB ɪ AD ɴ t ɕ a AD ɴ
ဗီရို	b i AD j AB o AE
ဗုဒ္ဓ	b o AE ʊ AE ʔ d a̰ AG
ဗုဒ္ဓဘာသာ	b o AE ʊ AE ʔ d a̰ AG b a AD θ a AD
ဗုဒ္ဓသာသနာ	θ a AD ð ə AD n a AD
ဗုဒ္ဓဟူး	b o AE ʊ AE ʔ d a̰ AG h AA u AE
ဗုန်း	b o AE ʊ AE ɴ
ဗုံး	b o AE ʊ AE ɴ
ဗေဒ	b e AD d a̰ AG
ဗောဓိညောင်	b ɔ AE d ḭ ɲ a AD ʊ AE ɴ
ဗောဓိသတ်	b ɔ AE d ḭ θ a AD ʔ
ဗော့ဒ်ကာ	b ɔ̰ AH d k a AD
ဗေ့စဘော	b ḛ s ə AD b ɔ AE
ဗျစ်	b j AB ɪ AD ʔ
ဗျည်း	b j AB i AD
ဗျာဓိ	b j AB a AD d ḭ
ဗျိုင်း	b j AB a AD ɪ AD ɴ
ဗျုပ္ပတ်	b j AB o AE ʊ AE ʔ p a AD ʔ
ဗျူရို	b j AB u AE ɹ AI o AE
ဗြဟ္မစိုရ်တရား	b j AB ə AD m ə AD z o AE j AB t ə AD j AB a AD
ဗြဟ္မာ	b j AB ə AD m a AD
ဗြာဟ္မဏ	b j AB a AD h AA m a̰ AG n a̰ AG
ဗြိစ္ဆာ	b j AB e AD ɪ AD ʔ sʰ a AD
ဗြိတိန်	b j AB ḭ t e AD ɪ AD ɴ
ဗြိတိသျှ	b ə AD ɹ AI ḭ t ḭ ʃ a̰ AG
ဗြဲတိုက်	b j AB ɛ AD d a AD ɪ AD ʔ
ဗွေ	b w AC e AD
ဘ	b a̰ AG
ဘကကျောင်း	b a̰ AG k a̰ AG t ɕ a AD ʊ AE ɴ
ဘကုန်း	b a̰ AG k o AE ʊ AE ɴ
ဘက္ကဒီးအစ်	b ɛ AD ʔ k ə AD d i AD ʔ ɪ AD ʔ
ဘက်	b ɛ AD ʔ
ဘက်ထရီ	b ɛ AD ʔ tʰ a̰ AG ɹ AI i AD
ဘကြီး	b a̰ AG d ʑ i AD
ဘင်	b ɪ AD ɴ
ဘင်နာ	b ɪ AD ɴ n a AD
ဘင်း	b ɪ AD ɴ
ဘင်္ဂလားဒေ့ရှ်	b ɪ AD ɴ l a AD d ḛ ʃ
ဘင်္ဂါလီ	b ɪ AD ɴ ɡ a AD l i AD
ဘဏ္ဍာ	b a AD n d a AD
ဘဏ္ဍာရေး	b a AD n d a AD j AB e AD
ဘဏ်	b a AD ɴ
ဘဏ်တိုက်	b a AD ɴ d a AD ɪ AD ʔ
ဘတ်	pʰ a AD ʔ
ဘတ်ဂျက်	b a AD ʔ d ʑ ɛ AD ʔ
ဘတ်စ်ကား	b a AD ʔ s ə AD k a AD
ဘထွေး	b a̰ AG tʰ w AC e AD
ဘဒ္ဒန္တ	b a AD ʔ d a AD ɴ t a̰ AG
ဘန်ကောက်	b a AD ɴ k a AD ʊ AE ʔ
ဘယာ	b ə AD j AB a AD
ဘယ်	b ɛ AD
ဘယ်တုန်းက	b ɛ AD d o AE ʊ AE ɴ ɡ a̰ AG
ဘယ်တော့	b ɛ AD d ɔ̰ AH
ဘယ်နှ	b ɛ AD n̥ a̰ AG
ဘယ်နှစ်	b ɛ AD n̥ ə AD
ဘယ်မှ	b ɛ AD m̥ a̰ AG
ဘယ်ရီလီယမ်	b ɛ AD ɹ AI i AD l i AD j AB a AD ɴ
ဘယ်လို	b ɛ AD l o AE
ဘယ်လောက်	b ɛ AD l a AD ʊ AE ʔ
ဘယ်လ်ဂျီယမ်	b ɛ AD l d ʑ i AD j AB a AD ɴ
ဘယ်သူ	b ə AD θ u AE
ဘယ်သူ့	b ə AD θ ṵ
ဘရင်ဂျီ	b ə AD j AB ɪ AD ɴ d ʑ i AD
ဘရဏီ	b a̰ AG j AB ə AD n i AD
ဘရာစီယာ	b ə AD ɹ AI a AD s i AD j AB a AD
ဘရာဇီး	b ə AD ɹ AI a AD z i AD
ဘရိတ်	b ə AD ɹ AI e AD ɪ AD ʔ
ဘရူနိုင်း	b ə AD ɹ AI u AE n a AD ɪ AD ɴ
ဘလိဇ်	b ə AD l i AD z
ဘလောက်	b a̰ AG l a AD ʊ AE ʔ
ဘလော့ဂ်	b ə AD l o AE ʊ AE ʔ
ဘလေး	b a̰ AG l e AD
ဘဝ	b a̰ AG w AC a̰ AG
ဘဝဲ	b ə AD w AC ɛ AD
ဘဟားမား	b a̰ AG h AA a AD m a AD
ဘာ	b a AD
ဘာကီးနားဖားဆို	b a AD k i AD n a AD pʰ a AD sʰ o AE
ဘာရိန်း	b a AD ɹ AI e AD ɪ AD ɴ
ဘာလင်	b a AD l ɪ AD ɴ
ဘာလိ	b a AD l ḭ
ဘာသာ	b a AD ð a AD
ဘာသာစကား	b a AD θ a AD z ə AD ɡ a AD
ဘာသာပြန်	b a AD ð a AD p j AB a AD ɴ
ဘာသာဗေဒ	b a AD θ a AD b e AD d a̰ AG
ဘား	pʰ a AD
ဘိက္ခု	b e AD ɪ AD ʔ kʰ ṵ
ဘိက္ခုနီ	b i AD k kʰ ṵ n i AD
ဘိန်း	b e AD ɪ AD ɴ
ဘိန်းမုန့်	b e AD ɪ AD ɴ m o̰ AH ʊ AE ɴ
ဘိဘိသန	b ḭ b ḭ θ ə AD n a̰ AG
ဘိလပ်	b ḭ l a AD ʔ
ဘိသိက်	b e AD ɪ AD ʔ θ e AD ɪ AD ʔ
ဘိုကလေး	b o AE ɡ ə AD l e AD
ဘိုက်	b a AD ɪ AD ʔ
ဘိုင်	b a AD ɪ AD ɴ
ဘိုင်စကယ်	b a AD ɪ AD ɴ s ə AD k ɛ AD
ဘိုင်စကုတ်	b a AD ɪ AD ɴ s ə AD k o AE ʊ AE ʔ
ဘိုရွန်	b o AE ɹ AI ʊ AE ɴ
ဘိုလီးဗီးယား	b o AE l i AD b i AD j AB a AD
ဘိုးဘိုး	pʰ o AE pʰ o AE
ဘီ	b i AD
ဘီစကွတ်	b i AD s ə AD k ʊ AE ʔ
ဘီနင်	b i AD n ɪ AD ɴ
ဘီယာ	b i AD j AB a AD
ဘီလာရုဇ်	b i AD l a AD ɹ AI u AE z
ဘီလူး	b ə AD l u AE
ဘီး	b i AD
ဘီးကြယ်	b i AD t ɕ ɛ AD
ဘု	b ṵ
ဘုဉ်းပေး	b o AE ʊ AE ɴ p e AD
ဘုတ်	b o AE ʊ AE ʔ
ဘုန်း	pʰ o AE ʊ AE ɴ
ဘုန်းကြီး	pʰ o AE ʊ AE ɴ d ʑ i AD
ဘုန်းကြီးကျောင်း	pʰ o AE ʊ AE ɴ d ʑ i AD t ɕ a AD ʊ AE ɴ
ဘုန်းကြီးပျံ	pʰ o AE ʊ AE ɴ d ʑ i AD b j AB a AD ɴ
ဘုန်းတော်ကြီးဘုရား	pʰ o AE ʊ AE ɴ d ɔ AE d ʑ i AD pʰ ə AD j AB a AD
ဘုန်းဘုန်း	pʰ o AE ʊ AE ɴ pʰ o AE ʊ AE ɴ
ဘုမ္မစိုး	b o AE ʊ AE ɴ m ə AD z o AE
ဘုရင်	b ə AD j AB ɪ AD ɴ
ဘုရင်ခံ	b ə AD j AB ɪ AD ɴ ɡ a AD ɴ
ဘုရင်မ	b a̰ AG j AB ɪ AD ɴ m a̰ AG
ဘုရား	pʰ ə AD j AB a AD
ဘုရားကိုးဆူ	pʰ ə AD j AB a AD k o AE sʰ u AE
ဘုရားကျောင်း	pʰ ə AD j AB a AD d ʑ a AD ʊ AE ɴ
ဘုရားရှိခိုးကျောင်း	pʰ ə AD j AB a AD ʃ ḭ kʰ o AE d ʑ a AD ʊ AE ɴ
ဘုရားလောင်း	pʰ ə AD j AB a AD l a AD ʊ AE ɴ
ဘုရားအလောင်း	pʰ ə AD j AB a AD ʔ ə AD l a AD ʊ AE ɴ
ဘုံကျောင်း	b o AE ʊ AE ɴ d ʑ a AD ʊ AE ɴ
ဘုံပိုင်	b o AE ʊ AE ɴ b a AD ɪ AD ɴ
ဘူ	b u AE
ဘူဂေးရီးယား	b u AE ɡ e AD ɹ AI i AD j AB a AD
ဘူတန်	b u AE t a AD ɴ
ဘူတာရုံ	b u AE d a AD j AB o AE ʊ AE ɴ
ဘူမိဗေဒ	b u AE m ḭ b e AD d a̰ AG
ဘူမိရူပဗေဒ	b u AE m ḭ j AB u AE p a̰ AG b e AD d a̰ AG
ဘူရွန်ဒီ	b u AE ɹ AI ʊ AE ɴ d i AD
ဘူး	b u AE
ဘူးသီး	b u AE θ i AD
ဘူးသီးတောင်	b u AE ð i AD d a AD ʊ AE ɴ
ဘော	b ɔ AE
ဘောက်ဆူး	b a AD ʊ AE ʔ sʰ u AE
ဘောဂဗေဒ	b ɔ AE ɡ a̰ AG t a̰ AG b e AD d a̰ AG
ဘောင်းဘီ	b a AD ʊ AE ɴ b i AD
ဘောပင်	b ɔ AE p ɪ AD ɴ
ဘောပွဲ	b ɔ AE p w AC ɛ AD
ဘောလုံး	b ɔ AE l o AE ʊ AE ɴ
ဘော့ဆွာနာ	b ɔ̰ AH sʰ w AC a AD n a AD
ဘော်ဒါ	b ɔ AE d a AD
ဘော်ဒါကြေး	b ɔ AE d a AD t ɕ e AD
ဘော်လီဘော	b ɔ AE l i AD b ɔ AE
ဘေ့စ်ဘော	b ḛ s b ɔ AE
ဘေး	b e AD
ဘေးဆိုး	b e AD z o AE
ဘေးဆီးရန်ကာ	b e AD z i AD j AB a AD ɴ ɡ a AD
ဘဲ	b ɛ AD
ဘဲလေး	b ɛ AD l e AD
ဘွား	b w AC a AD
ဘွားဘွား	pʰ w AC a AD pʰ w AC a AD
ဘွဲ့	b w AC ɛ̰ AG
ဘွဲ့ချဉ်	b w AC ɛ̰ AG d ʑ ɪ AD ɴ
မ	m ə AD
မကန်း	m ə AD ɡ a AD ɴ
မကိုဋ်	m ə AD ɡ a AD ɪ AD ʔ
မကုဋ	m ə AD k ṵ t a̰ AG
မက္ကဆီကို	m ɛ AD ʔ k ə AD sʰ i AD k o AE
မက်	m ɛ AD ʔ
မက်စီဒိုးနီးယား	m ɛ AD ʔ s i AD d o AE n i AD j AB a AD
မက်မွန်	m ɛ AD ʔ m ʊ AE ɴ
မကြာမတင်	m ə AD t ɕ a AD m ə AD t ɪ AD ɴ
မကွေး	m ə AD ɡ w AC e AD
မဂ္ဂင်ရှစ်ပါး	m ɛ AD ʔ ɡ ɪ AD ɴ ʃ ɪ AD ʔ b a AD
မဂ္ဂဇင်း	m ɛ AD ʔ ɡ a̰ AG z ɪ AD ɴ
မင့်စ်	m ɪ̰ AG ɴ s
မင်	m̥ ɪ AD ɴ
မင်း	m ɪ AD ɴ
မင်းကြီး	m ɪ AD ɴ d ʑ i AD
မင်းကွတ်	m ɪ AD ɴ ɡ ʊ AE ʔ
မင်းတရား	m ɪ AD ɴ t ə AD j AB a AD
မင်းဘူး	m ɪ AD ɴ b u AE
မင်းမြောက်တန်ဆာ	m ɪ AD ɴ m j AB a AD ʊ AE ʔ d ə AD z a AD
မင်းသမီး	m ɪ AD ɴ ð ə AD m i AD
မင်းသား	m ɪ AD ɴ ð a AD
မင်္ဂလ	m ɪ AD ɴ ɡ ə AD l a̰ AG
မင်္ဂလဘုရား	m ɪ AD ɴ ɡ ə AD l a̰ AG pʰ ə AD j AB a AD
မင်္ဂလသုတ်	m ɪ AD ɴ ɡ ə AD l a̰ AG θ o AE ʊ AE ʔ
မင်္ဂလာ	m ɪ AD ɴ ɡ ə AD l a AD
မင်္ဂလာဆောင်	m ɪ AD ɴ ɡ ə AD l a AD sʰ a AD ʊ AE ɴ
မင်္ဂလာပါ	m ɪ AD ɴ ɡ ə AD l a AD b a AD
မစင်	m a̰ AG s ɪ AD ɴ
မဆလာ	m a̰ AG sʰ ə AD l a AD
မဇ္ဈဒေသ	m ɪ AD ʔ z a̰ AG d e AD θ a̰ AG
မဉ္ဇူ	m j AB ɪ AD ɴ z u AE
မည်	m j AB i AD
မည်စည်	m ɛ AD z ɛ AD
မည်သည်	m i AD ð i AD
မည်သူ	m i AD ð u AE
မည်း	m ɛ AD
မဏိ	m ə AD n ḭ
မဏိတော်	m ə AD n ḭ d ɔ AE
မဏိပူရ	m ə AD n ḭ p u AE j AB a̰ AG
မဏိမေခလာ	m ə AD n ḭ m e AD kʰ ə AD l a AD
မဏိဩဂ	m ə AD n ḭ ʔ ɔ AE ɡ a̰ AG
မဏ္ဍပ်	m a AD ɴ d a AD ʔ
မဏ္ဍိုင်	m a AD ɴ d a AD ɪ AD ɴ
မတော်တဆ	m ə AD t ɔ AE t ə AD sʰ a̰ AG
မတော်တဆမှု	m ə AD t ɔ AE t ə AD sʰ a̰ AG m̥ ṵ
မတ်	m a AD ʔ
မတ်ခွက်	m a AD ʔ kʰ w AC ɛ AD ʔ
မတ်စေ့	m a AD ʔ s ḭ
မတ်ပဲ	m a AD ʔ p ɛ AD
မတ်မတ်	m a AD ʔ m a AD ʔ
မဒါဂတ်စကား	m a̰ AG d a AD ɡ a AD ʔ s ə AD k a AD
မနက်	m ə AD n ɛ AD ʔ
မနက်ဖြန်	m ə AD n ɛ AD ʔ pʰ j AB a AD ɴ
မနုပ်တာနီ	m ə AD n o AE ʊ AE ʔ t a AD n i AD
မနုဿ	m a̰ AG n o AE ʊ AE ʔ θ a AD
မနုဿဗေဒ	m ə AD n o AE ʊ AE ʔ θ a̰ AG b e AD d a̰ AG
မနုဿီဟ	m ə AD n o AE ʊ AE ʔ θ i AD h AA a̰ AG
မနော	m ə AD n ɔ AE
မနောကံ	m ə AD n ɔ AE ɡ a AD ɴ
မနေ့က	m ə AD n ḛ ɡ a̰ AG
မန္တန်	m a AD ɴ d a AD ɴ
မန္တလေး	m a AD ɴ d ə AD l e AD
မန်ကျည်း	m ə AD d ʑ i AD
မန်နေဂျာ	m a AD ɴ n e AD d ʑ a AD
မန်း	m a AD ɴ
မနှစ်	m ə AD n̥ ɪ AD ʔ
မယား	m ə AD j AB a AD
မယ်	m ɛ AD
မယ်ဇယ်	m ɛ AD z ɛ AD
မယ်ဇလီ	m ɛ AD z ə AD l i AD
မယ်တော်	m ɛ AD d ɔ AE
မယ်သီတာ	m ɛ AD θ i AD d a AD
မယ်သီလ	m ɛ AD ð i AD l a̰ AG
မရဏ	m ə AD ɹ AI ə AD n a̰ AG
မရန်း	m ə AD j AB a AD ɴ
မရမာ	m ə AD ɹ AI ə AD m a AD
မရမာကြီး	m ə AD ɹ AI ə AD m a AD d ʑ i AD
မရီး	m ə AD j AB i AD
မလိုင်	m a̰ AG l a AD ɪ AD ɴ
မလုပ်တာနီ	m ə AD l o AE ʊ AE ʔ t a AD n i AD
မလေး	m ə AD l e AD
မလေးရှား	m ə AD l e AD ʃ a AD
မလ္လိကာ	m a AD ɴ l ḭ k a AD
မသာ	m ə AD θ a AD
မသိပါဘူး	m a̰ AG θ ḭ b a AD b u AE
မသိဘူး	m a̰ AG θ ḭ b u AE
မဟာ	m a̰ AG h AA a AD
မဟာကဿပ	m ə AD h AA a AD k a AD ʔ θ ə AD p a̰ AG
မဟာဂီတ	m ə AD h AA a AD ɡ i AD t a̰ AG
မဟာပညာဗလ	m ə AD h AA a AD p j AB ɪ AD ɴ ɲ a AD b ə AD l a̰ AG
မဟာပိန္နဲ	m ə AD h AA a AD p e AD ɪ AD ɴ n ɛ AD
မဟာဘာရတ	m ə AD h AA a AD b a AD ɹ AI ə AD t a̰ AG
မဟာဘွဲ့	m ə AD h AA a AD b w AC ɛ̰ AG
မဟာမိတ်	m ə AD h AA a AD m e AD ɪ AD ʔ
မဟာမောဂ္ဂလာန်	m ə AD h AA a AD m a AD ʊ AE ʔ ɡ ə AD l a AD ɴ
မဟာယာန	m ə AD h AA a AD j AB a AD n a̰ AG
မဟာရဋ္ဌ	m ə AD h AA a AD j AB ə AD tʰ a̰ AG
မဟာလတာ	m ə AD h AA a AD l ə AD t a AD
မဟာဝင်	m ə AD h AA a AD w AC ɪ AD ɴ
မဟာဝိဇ္ဇာဘွဲ့	m ə AD h AA a AD w AC e AD ɪ AD ʔ z a AD b w AC ɛ̰ AG
မဟာသာဝက	m ə AD h AA a AD θ a AD w AC ə AD k a̰ AG
မဟာသိပ္ပံဘွဲ့	m ə AD h AA a AD θ e AD ɪ AD ʔ p a AD ɴ b w AC ɛ̰ AG
မဟေ	m ə AD h AA e AD
မဟေသီ	m ə AD h AA e AD θ i AD
မအေလိုး	m ə AD ʔ e AD l o AE
မာ	m a AD
မာကျောက်	m a AD t ɕ a AD ʊ AE ʔ
မာစကတ်	m a AD s ə AD k a AD ʔ
မာတိကာ	m a AD t ḭ k a AD
မာန်	m a AD ɴ
မာန်အောင်	m a AD n ʔ a AD ʊ AE ɴ
မာရ်	m a AD
မာရ်နတ်	m a AD n a AD ʔ
မာလကာ	m a AD l ə AD k a AD
မာလကာသီး	m a AD l ə AD k a AD θ i AD
မာလဝီ	m a AD l a̰ AG w AC i AD
မာလာ	m a AD l a AD
မာလာရှမ်းကော	m a AD l a AD ʃ a AD ɴ k ɔ AE
မာလာဟင်း	m a AD l a AD h AA ɪ AD ɴ
မာလီ	m a AD l i AD
မိ	m ḭ
မိကျောင်း	m ḭ d ʑ a AD ʊ AE ɴ
မိခင်	m ḭ ɡ ɪ AD ɴ
မိငယ်	m ḭ ŋ ɛ AD
မိတ္တူ	m e AD ɪ AD ʔ t u AE
မိတ္ထီလာ	m e AD ɪ AD ʔ tʰ i AD l a AD
မိတ်	m e AD ɪ AD ʔ
မိတ်ကပ်	m e AD ɪ AD ʔ k a AD ʔ
မိတ်ဆွေ	m e AD ɪ AD ʔ sʰ w AC e AD
မိထွေး	m ḭ d w AC e AD
မိနစ်	m ḭ n ɪ AD ʔ
မိန်းကလေး	m e AD ɪ AD ɴ ɡ ə AD l e AD
မိန်းမ	m e AD ɪ AD ɴ m a̰ AG
မိန်းမလျာ	m e AD ɪ AD ɴ m ə AD ʃ a AD
မိဖုရား	m ḭ b ə AD j AB a AD
မိဘ	m ḭ b a̰ AG
မိဘမဲ့	m ḭ b a̰ AG m ɛ̰ AG
မိသားစု	m ḭ ð a AD z ṵ
မိုက်	m a AD ɪ AD ʔ
မိုက်ကယ်	m a AD ɪ AD ʔ k ɛ AD
မိုင်	m a AD ɪ AD ɴ
မိုင်လို	m a AD ɪ AD ɴ l o AE
မိုင်း	m a AD ɪ AD ɴ
မိုဇမ်ဘစ်	m o AE z a AD ɴ b ɪ AD ʔ
မိုတယ်	m o AE t ɛ AD
မိုနာကို	m o AE n a AD k o AE
မိုဘိုင်းလ်ဖုန်း	m o AE b a AD ɪ AD ɴ pʰ o AE ʊ AE ɴ
မိုး	m o AE
မိုးကာအင်္ကျီ	m o AE ɡ a AD ʔ ɪ AD ɴ d ʑ i AD
မိုးကုတ်	m o AE ɡ o AE ʊ AE ʔ
မိုးကုပ်စက်ဝိုင်း	m o AE ɡ o AE ʊ AE ʔ s ɛ AD ʔ w AC a AD ɪ AD ɴ
မိုးကြိုး	m o AE d ʑ o AE
မိုးခေါ်	m o AE kʰ ɔ AE
မိုးရာသီ	m o AE j AB a AD ð i AD
မိုးလေဝသ	m o AE l e AD w AC ə AD θ a̰ AG
မီတာ	m i AD t a AD
မီနူး	m i AD n u AE
မီး	m i AD
မီးခတ်	m i AD ɡ a AD ʔ
မီးခိုး	m i AD ɡ o AE
မီးခိုးရောင်	m i AD ɡ o AE j AB a AD ʊ AE ɴ
မီးခေါင်း	m i AD ɡ a AD ʊ AE ɴ
မီးခံသေတ္တာ	m i AD ɡ a AD ɴ θ ɪ AD ʔ t a AD
မီးခြစ်	m i AD d ʑ ɪ AD ʔ
မီးခွက်	m i AD ɡ w AC ɛ AD ʔ
မီးတောင်	m i AD d a AD ʊ AE ɴ
မီးပန်း	m i AD b a AD ɴ
မီးပူ	m i AD b u AE
မီးပြတိုက်	m i AD b j AB a̰ AG d a AD ɪ AD ʔ
မီးပွား	m i AD b w AC a AD
မီးပွိုင့်	m i AD p w AC a̰ AG ɪ AD ɴ
မီးဖို	m i AD pʰ o AE
မီးဖိုချောင်	m i AD b o AE d ʑ a AD ʊ AE ɴ
မီးယပ်	m i AD j AB a AD ʔ
မီးယပ်ပညာ	m i AD j AB a AD ʔ p j AB ɪ AD ɴ ɲ a AD
မီးယပ်ရောဂါ	m i AD j AB a AD ʔ j AB ɔ AE ɡ a AD
မီးရထား	m i AD j AB ə AD tʰ a AD
မီးရထားတွဲ	m i AD j AB ə AD tʰ a AD d w AC ɛ AD
မီးရှူးမီးပန်း	m i AD ʃ u AE m i AD b a AD ɴ
မီးလင်းဖို	m i AD l ɪ AD ɴ b o AE
မီးသင်္ဘော	m i AD θ ɪ AD ɴ b ɔ AE
မီးသီး	m i AD θ i AD
မီးသုံးပါး	m i AD θ o AE ʊ AE ɴ b a AD
မီးသွေး	m i AD ð w AC e AD
မီးအိမ်	m i AD ʔ e AD ɪ AD ɴ
မုခ်	m o AE ʊ AE ʔ
မုစလိန္ဒ	m ṵ s ə AD l e AD ɪ AD ɴ d a̰ AG
မုဆိုး	m o AE ʊ AE ʔ sʰ o AE
မုဆိုးဖို	m ṵ sʰ o AE b o AE
မုဆိုးမ	m ṵ sʰ o AE m a̰ AG
မုတ္ထမ	m o AE ʊ AE ʔ t ə AD m a̰ AG
မုတ်ခွံ	m o AE ʊ AE ʔ kʰ ʊ AE ɴ
မုတ်ဆိတ်	m o AE ʊ AE ʔ sʰ e AD ɪ AD ʔ
မုဒိမ်း	m ṵ d e AD ɪ AD ɴ
မုဒ္ဓဇ	m u AE d d ə AD z a̰ AG
မုဒြာ	m ṵ d ɹ AI a AD
မုနိ	m ṵ n ḭ
မုန့်	m o̰ AH ʊ AE ɴ
မုန့်ကျွဲသည်း	m o̰ AH ʊ AE ɴ t ɕ w AC ɛ AD ð ɛ AD
မုန့်ကွမ်းယာ	m o̰ AH ʊ AE ɴ k ʊ AE ɴ j AB a AD
မုန့်ညက်	m o̰ AH ʊ AE ɴ ɲ ɛ AD ʔ
မုန့်တီ	m o̰ AH ʊ AE ɴ t i AD
မုန့်လက်ကောက်	m o̰ AH ʊ AE ɴ l ɛ AD ʔ k a AD ʊ AE ʔ
မုန့်လက်ဆောင်း	m o̰ AH ʊ AE ɴ l ɛ AD ʔ sʰ a AD ʊ AE ɴ
မုန့်လင်မယား	m o̰ AH ʊ AE ɴ l ɪ AD ɴ m ə AD j AB a AD
မုန့်လုံးရေပေါ်	m o̰ AH ʊ AE ɴ l o AE ʊ AE ɴ j AB e AD b ɔ AE
မုန့်ဟင်းခါး	m o̰ AH ʊ AE ɴ h AA ɪ AD ɴ ɡ a AD
မုန့်အုပ်ကလေး	m o̰ AH ʊ AE ɴ ʔ o AE ʊ AE ʔ ɡ ə AD l e AD
မုန့်ဦးနှောက်	m o̰ AH ʊ AE ɴ ʔ o AE ʊ AE ɴ ð i AD
မုန်ညင်း	m o AE ʊ AE ɴ ɲ ɪ AD ɴ
မုန်ညင်းဆီ	m o AE ʊ AE ɴ ɲ ɪ AD ɴ sʰ i AD
မုန်ညင်းဖြူ	m o AE ʊ AE ɴ ɲ ɪ AD ɴ pʰ j AB u AE
မုန်ညှင်းဖြူ	m o AE ʊ AE ɴ ɲ̊ ɪ AD ɴ b j AB u AE
မုန်တိုင်း	m o AE ʊ AE ɴ d a AD ɪ AD ɴ
မုန်လာ	m o AE ʊ AE ɴ l a AD
မုန်လာထုပ်	m o AE ʊ AE ɴ l a AD d o AE ʊ AE ʔ
မုန်လာဥ	m o AE ʊ AE ɴ l a AD ʔ ṵ
မုန်လာဥနီ	m o AE ʊ AE ɴ l a AD ʔ ṵ n i AD
မုန်လာဥဝါ	m o AE ʊ AE ɴ l a AD ʔ ṵ w AC a AD
မုန်း	m o AE ʊ AE ɴ
မုရား	m ə AD j AB a AD
မုသား	m ṵ ð a AD
မုံ	m o AE ʊ AE ɴ
မုံရွာ	m o AE ʊ AE ɴ j AB w AC a AD
မူကြို	m u AE d ʑ o AE
မူကြိုကျောင်း	m u AE d ʑ o AE d ʑ a AD ʊ AE ɴ
မူလ	m u AE l a̰ AG
မူလတန်း	m u AE l a̰ AG t a AD ɴ
မူလတန်းကြိုကျောင်း	m u AE l a̰ AG d a AD ɴ d ʑ o AE d ʑ a AD ʊ AE ɴ
မူလီ	m u AE l i AD
မူး	m u AE
မေ	m e AD
မေဃာလယ	m e AD ɡ a AD l ə AD j AB a̰ AG
မေတ္တာ	m j AB ɪ AD ʔ t a AD
မေတ္တေယျ	m j AB ɪ AD ʔ t e AD j AB a̰ AG
မေဓင်္ကရာ	m e AD d ɪ AD ɴ k ə AD ɹ AI a AD
မေဓင်္ကရာဘုရား	m e AD d ɪ AD ɴ k ə AD ɹ AI a AD pʰ ə AD j AB a AD
မေမေ	m e AD m e AD
မော	m ɔ AE
မောက်ချ	m a AD ʊ AE ʔ t ɕʰ a̰ AG
မောင်	m a AD ʊ AE ɴ
မောင်တော	m a AD ʊ AE ɴ t ɔ AE
မောင်နှမ	m a AD ʊ AE ɴ n̥ ə AD m a̰ AG
မောင်း	m a AD ʊ AE ɴ
မောင်းမမိဿံ	m a AD ʊ AE ɴ m a̰ AG m e AD ɪ AD ʔ θ a AD ɴ
မောရစ်ရှ	m ɔ AE ɹ AI ɪ AD ʔ ʃ a̰ AG
မော်စကို	m ɔ AE s ə AD k o AE
မော်ဇာ	m ɔ AE z a AD
မော်တော်ဆိုင်ကယ်	m ɔ AE t ɔ AE sʰ a AD ɪ AD ɴ k ɛ AD
မော်ရိုကို	m ɔ AE ɹ AI o AE k o AE
မော်ရီတေးနီးယား	m ɔ AE ɹ AI i AD t e AD n i AD j AB a AD
မော်လတာ	m ɔ AE l ə AD t a AD
မော်လဒိုက်	m ɔ AE l ə AD d a AD ɪ AD ʔ
မော်လမြိုင်	m ɔ AE l ə AD m j AB a AD ɪ AD ɴ
မော်လီကျူး	m ɔ AE l i AD t ɕ u AE
မော်လ်ဒိုဗာ	m ɔ AE l d o AE b a AD
မေ့	m ḛ
မေး	m e AD
မေးခိုင်ရောဂါ	m e AD kʰ a AD ɪ AD ɴ j AB ɔ AE ɡ a AD
မေးခွန်း	m e AD ɡ ʊ AE ɴ
မေးစေ့	m e AD z ḭ
မဲ	m ɛ AD
မဲခေါင်မြစ်	m ɛ AD kʰ a AD ʊ AE ɴ m j AB ɪ AD ʔ
မဲဆန္ဒ	m ɛ AD sʰ a AD ɴ d a̰ AG
မဲဆန္ဒနယ်	m ɛ AD sʰ a AD ɴ d a̰ AG n ɛ AD
မဲဆန္ဒရှင်	m ɛ AD sʰ a AD ɴ d a̰ AG ʃ ɪ AD ɴ
မဲဆောက်	m ɛ AD sʰ a AD ʊ AE ʔ
မဲဇလီ	m ɛ AD z ə AD l i AD
မဲပေး	m ɛ AD p e AD
မံ	m a AD ɴ
မံသ	m a AD ɴ θ a̰ AG
မျက်ခုံး	m j AB ɛ AD ʔ kʰ o AE ʊ AE ɴ
မျက်ခွံ	m j AB ɛ AD ʔ kʰ ʊ AE ɴ
မျက်စိ	m j AB ɛ AD ʔ s ḭ
မျက်တောင်	m j AB ɛ AD ʔ t a AD ʊ AE ɴ
မျက်နှာ	m j AB ɛ AD ʔ n̥ a AD
မျက်နှာကြက်	m j AB ɛ AD ʔ n̥ a AD d ʑ ɛ AD ʔ
မျက်နှာဖုံး	m j AB ɛ AD ʔ n̥ ə AD pʰ o AE ʊ AE ɴ
မျက်နှာသုတ်ပဝါ	m j AB ɛ AD ʔ n̥ a AD θ o AE ʊ AE ʔ p a̰ AG w AC a AD
မျက်ပါး	m j AB ɛ AD ʔ p a AD
မျက်မှန်	m j AB ɛ AD ʔ m̥ a AD ɴ
မျက်ရည်	m j AB ɛ AD ʔ j AB e AD
မျက်လုံး	m j AB ɛ AD ʔ l o AE ʊ AE ɴ
မျက်လွှာ	m j AB ɛ AD ʔ l̥ w AC a AD
မျက်လှည့်	m j AB ɛ AD ʔ l̥ ɛ̰ AG
မျည်းတံ	m j AB i AD d a AD ɴ
များ	m j AB a AD
များများ	m j AB a AD m j AB a AD
မျို	m j AB o AE
မျိုး	m j AB o AE
မျိုးချစ်စိတ်	m j AB o AE t ɕʰ ɪ AD ʔ s e AD ɪ AD ʔ
မျိုးစိတ်	m j AB o AE z e AD ɪ AD ʔ
မျိုးစု	m j AB o AE z ṵ
မျိုးဆက်	m j AB o AE z ɛ AD ʔ
မျိုးဥအိမ်	m j AB o AE ʔ ṵ ʔ e AD ɪ AD ɴ
မျော	m j AB ɔ AE
မျောက်	m j AB a AD ʊ AE ʔ
မျောက်ချော	m j AB a AD ʊ AE ʔ t ɕʰ ɔ AE
မျောက်လုတ်	m j AB a AD ʊ AE ʔ l o AE ʊ AE ʔ
မျောက်လောင်း	m j AB a AD ʊ AE ʔ l a AD ʊ AE ɴ
မျှင်	m̥ j AB ɪ AD ɴ
မျှစ်	m̥ j AB ɪ AD ʔ
မျှို့	m̥ j AB o̰ AH
မျှော်	m̥ j AB ɔ AE
မျှော်လင့်	m̥ j AB ɔ AE l ɪ̰ AG ɴ
မျှော်လင့်ချက်	m̥ j AB ɔ AE l ɪ̰ AG ɴ d ʑ ɛ AD ʔ
မြ	m j AB a̰ AG
မြက်	m j AB ɛ AD ʔ
မြက်ခင်း	m j AB ɛ AD ʔ kʰ ɪ AD ɴ
မြက်ခုတ်ဓား	m j AB ɛ AD ʔ kʰ o AE ʊ AE ʔ d a AD
မြက်ခြောက်	m j AB ɛ AD ʔ t ɕʰ a AD ʊ AE ʔ
မြင့်	m j AB ɪ̰ AG ɴ
မြင်	m j AB ɪ AD ɴ
မြင်း	m j AB ɪ AD ɴ
မြင်းကလေး	m j AB ɪ AD ɴ ɡ ə AD l e AD
မြင်းကျား	m j AB ɪ AD ɴ d ʑ a AD
မြင်းခြံ	m j AB ɪ AD ɴ d ʑ a AD ɴ
မြင်းခွာ	m j AB ɪ AD ɴ kʰ w AC a AD
မြင်းခွာရွက်သုပ်	m j AB ɪ AD ɴ kʰ w AC a AD j AB w AC ɛ AD ʔ θ o AE ʊ AE ʔ
မြင်းစားဂျုံ	m j AB ɪ AD ɴ z a AD d ʑ o AE ʊ AE ɴ
မြင်းဆေး	m j AB ɪ AD ɴ z e AD
မြင်းမ	m j AB ɪ AD ɴ m a̰ AG
မြင်းမကလေး	m j AB ɪ AD ɴ m a̰ AG ɡ ə AD l e AD
မြင်းမိုရ်	m j AB ɪ AD ɴ m o AE
မြင်းမိုရ်တောင်	m j AB ɪ AD ɴ m o AE t a AD ʊ AE ɴ
မြင်းလှည်း	m j AB ɪ AD ɴ l̥ ɛ AD
မြင်းသံခွာ	m j AB ɪ AD ɴ θ a AD ɴ kʰ w AC a AD
မြစ်	m j AB ɪ AD ʔ
မြစ်ကြီးနား	m j AB ɪ AD ʔ t ɕ i AD n a AD
မြည်း	m j AB i AD
မြတ်လေး	m j AB a AD ʔ l e AD
မြန်	m j AB a AD ɴ
မြန်နှုန်းပြကိရိယာ	m j AB a AD ɴ n̥ o AE ʊ AE ɴ p j AB a̰ AG k ḭ j AB ḭ j AB a AD
မြန်မာ	m j AB a AD ɴ m a AD
မြန်မာ့	m j AB a AD ɴ m a̰ AG
မြန်မြန်	m j AB a AD ɴ m j AB a AD ɴ
မြမ္မာ	m j AB a AD ɴ m a AD
မြဝတီ	m j AB a̰ AG w AC ə AD d i AD
မြား	m̥ j AB a AD
မြိတ်	b e AD ɪ AD ʔ
မြို့	m j AB o̰ AH
မြို့စား	m j AB o̰ AH z a AD
မြို့တော်	m j AB o̰ AH d ɔ AE
မြို့တော်ဝန်	m j AB o̰ AH d ɔ AE w AC ʊ AE ɴ
မြို့နယ်	m j AB o̰ AH n ɛ AD
မြို့ပြနိုင်ငံ	m j AB o̰ AH p j AB a̰ AG n a AD ɪ AD ɴ ŋ a AD ɴ
မြို့ဝန်	m j AB o̰ AH w AC ʊ AE ɴ
မြီ	m j AB i AD
မြီးရှေ	m j AB i AD ʃ e AD
မြုံ	m j AB o AE ʊ AE ɴ
မြူ	m j AB u AE
မြူစွမ်	m j AB u AE s w AC a AD ɴ
မြေ	m j AB e AD
မြေကွက်	m j AB e AD ɡ w AC ɛ AD ʔ
မြေခွေး	m j AB e AD ɡ w AC e AD
မြေစာ	m j AB e AD z a AD
မြေနင်းခွာစိုက်	m j AB e AD n ɪ AD ɴ kʰ w AC a AD z a AD ɪ AD ʔ
မြေနုကျွန်းပေါ်	m j AB e AD n ṵ t ɕ ʊ AE ɴ b ɔ AE
မြေပုံ	m j AB e AD b o AE ʊ AE ɴ
မြေပုံသီး	m j AB e AD b o AE ʊ AE ɴ ð i AD
မြေပဲ	m j AB e AD b ɛ AD
မြေပြင်	m j AB e AD b j AB ɪ AD ɴ
မြေပြန့်	m j AB e AD b j AB a̰ AG ɴ
မြေဖြူခဲ	m j AB e AD b j AB u AE ɡ ɛ AD
မြေရိုင်း	m j AB e AD j AB a AD ɪ AD ɴ
မြေရှင်	m j AB e AD ʃ ɪ AD ɴ
မြေအောက်	m j AB e AD ʔ a AD ʊ AE ʔ
မြေအောက်မီးရထား	m j AB e AD ʔ a AD ʊ AE ʔ m i AD j AB ə AD tʰ a AD
မြေဩဇာ	m j AB e AD ʔ ɔ AE z a AD
မြောက်	m j AB a AD ʊ AE ʔ
မြောက်ကိုရီးယား	m j AB a AD ʊ AE ʔ k o AE ɹ AI i AD j AB a AD
မြောင်း	m j AB a AD ʊ AE ɴ
မြေး	m j AB e AD
မြေးမ	m j AB e AD m a̰ AG
မြံမာ	m j AB a AD ɴ m a AD
မြွက်	m j AB w AC ɛ AD ʔ
မြွေ	m w AC e AD
မြွေပါ	m w AC e AD b a AD
မြွေဟောက်	m j AB w AC e AD h AA a AD ʊ AE ʔ
မြှား	m̥ j AB a AD
မြှောက်	m̥ j AB a AD ʊ AE ʔ
မြှောက်ရကိန်း	m̥ j AB a AD ʊ AE ʔ j AB a̰ AG k e AD ɪ AD ɴ
မွတ်	m ʊ AE ʔ
မွတ်စလင်	m ʊ AE ʔ s ə AD l ɪ AD ɴ
မွန်	m ʊ AE ɴ
မွန်ဂိုးလီးယား	m ʊ AE ɴ ɡ o AE l i AD j AB a AD
မွန်တီနီဂရိုး	m ʊ AE ɴ t i AD n i AD ɡ ə AD ɹ AI o AE
မွာချီး	m w AC a AD t ɕʰ i AD
မွေး	m w AC e AD
မွေးနေ့	m w AC e AD n ḛ
မွေးနေ့မင်္ဂလာပါ	m w AC e AD n ḛ m ɪ AD ɴ ɡ ə AD l a AD b a AD
မွဲ	m w AC ɛ AD
မွှား	m̥ w AC a AD
မွှေး	m̥ w AC e AD
မှ	m̥ a̰ AG
မှတ်ကျောက်	m̥ a AD ʔ t ɕ a AD ʊ AE ʔ
မှတ်စု	m̥ a AD ʔ s ṵ
မှတ်စုစာအုပ်	m̥ a AD ʔ s ṵ s a AD ʔ o AE ʊ AE ʔ
မှတ်ဉာဏ်	m̥ a AD ʔ ɲ a AD n
မှတ်တိုင်	m̥ a AD ʔ t a AD ɪ AD ɴ
မှတ်မိ	m̥ a AD ʔ m ḭ
မှန်	m̥ a AD ɴ
မှန်စာ	m̥ a AD ɴ z a AD
မှန်စီရွှေချ	m̥ a AD ɴ z i AD ʃ w AC e AD t ɕʰ a̰ AG
မှန်တော့	m̥ a AD ɴ d ɔ̰ AH
မှန်ပါ့ဘုရား	m̥ a AD ɴ b a̰ AG pʰ ə AD j AB a AD
မှန်ပြောင်း	m̥ a AD ɴ b j AB a AD ʊ AE ɴ
မှန်ဖြူ	m̥ a AD ɴ b j AB u AE
မှန်ဘီလူး	m̥ a AD ɴ b ə AD l u AE
မှန်မှန်	m̥ a AD ɴ m̥ a AD ɴ
မှန်လာ	m̥ a AD ɴ l a AD
မှာ	m̥ a AD
မှား	m̥ a AD
မှို	m̥ o AE
မှု	m̥ ṵ
မှုတ်	m̥ o AE ʊ AE ʔ
မှုန့်	m̥ o̰ AH ʊ AE ɴ
မှုန်	m̥ o AE ʊ AE ɴ
မှဲ့	m̥ ɛ̰ AG
ယက်	j AB ɛ AD ʔ
ယခု	j AB ə AD kʰ ṵ
ယင်	j AB ɪ AD ɴ
ယင်ကောင်	j AB ɪ AD ɴ ɡ a AD ʊ AE ɴ
ယင်းမာ	j AB ɪ AD ɴ m a AD
ယစ်ထုတ်	j AB ɪ AD ʔ tʰ o AE ʊ AE ʔ
ယဉ်	j AB ɪ AD ɴ
ယဉ်ကျေးမှု	j AB ɪ AD ɴ t ɕ e AD m̥ ṵ
ယတြာ	j AB ə AD d ə AD j AB a AD
ယနေ့	j AB a̰ AG n ḛ
ယန္တရား	j AB a AD ɴ d ə AD j AB a AD
ယပက်လက်	j AB a̰ AG p ɛ AD ʔ l ɛ AD ʔ
ယပင့်	j AB a̰ AG p ɪ̰ AG ɴ
ယပ်	j AB a AD ʔ
ယမက	j AB ə AD m ə AD k a̰ AG
ယမင်း	j AB ə AD m ɪ AD ɴ
ယမနေ	j AB ə AD m ə AD n e AD
ယမန်နှစ်	j AB ə AD m a AD ɴ n̥ ɪ AD ʔ
ယမမင်း	j AB ə AD m a̰ AG m ɪ AD ɴ
ယမုန်နာ	j AB ə AD m o AE ʊ AE ɴ n a AD
ယမ်း	j AB a AD ɴ
ယမ်းတောင့်	j AB a AD ɴ d a̰ AG ʊ AE ɴ
ယမ်းမှုန့်	j AB a AD ɴ m̥ o̰ AH ʊ AE ɴ
ယဝဒီပ	j AB a̰ AG w AC a̰ AG d i AD p a̰ AG
ယသောဓရာ	j AB a̰ AG θ ɔ AE d ə AD j AB a AD
ယာဉ်	j AB ɪ AD ɴ
ယာဉ်မောင်း	j AB ɪ AD ɴ m a AD ʊ AE ɴ
ယာဉ်ရပ်	j AB ɪ AD ɴ j AB a AD ʔ
ယာဘ	j AB a AD b a̰ AG
ယာမာ	j AB a AD m a AD
ယာယီ	j AB a AD j AB i AD
ယို	j AB o AE
ယိုးဒယား	j AB o AE d ə AD j AB a AD
ယီမင်	j AB i AD m ɪ AD ɴ
ယုဂ်	j AB o AE ʊ AE ʔ
ယုဇန	j AB ṵ z a̰ AG n a̰ AG
ယုတ္တိ	j AB o AE ʊ AE ʔ t ḭ
ယုတ္တိဗေဒ	j AB o AE ʊ AE ʔ t ḭ b e AD d a̰ AG
ယုန်	j AB o AE ʊ AE ɴ
ယုံ	j AB o AE ʊ AE ɴ
ယုံကြည်	j AB o AE ʊ AE ɴ t ɕ i AD
ယူ	j AB u AE
ယူကရိန်း	j AB u AE k ə AD ɹ AI e AD ɪ AD ɴ
ယူဂန်းဒါး	j AB u AE ɡ a AD ɴ d a AD
ယူနိုက်တက်ကင်းဒမ်း	j AB u AE n a AD ɪ AD ʔ t ɛ AD ʔ k ɪ AD ɴ d a AD ɴ
ယူနီယန်	j AB u AE n i AD j AB a AD ɴ
ယူရို	j AB u AE ɹ AI o AE
ယူရေးရှား	j AB u AE ɹ AI e AD ʃ a AD
ယေရှု	j AB e AD ʃ ṵ
ယောက္ခထီး	j AB a AD ʊ AE ʔ kʰ ə AD tʰ i AD
ယောက္ခမ	j AB a AD ʊ AE ʔ kʰ ə AD m a̰ AG
ယောက်	j AB a AD ʊ AE ʔ
ယောက်ဖ	j AB a AD ʊ AE ʔ pʰ a̰ AG
ယောက်မ	j AB a AD ʊ AE ɴ m a̰ AG
ယောက်ျား	j AB a AD ʊ AE ʔ t ɕ a AD
ယောက်ျားလျာ	j AB a AD ʊ AE ʔ k ə AD ʃ a AD
ယောဂ	j AB ɔ AE ɡ a̰ AG
ယောဇနာ	j AB ɔ AE z ə AD n a AD
ယောနိ	j AB ɔ AE n ḭ
ယဲ့ယဲ့	j AB ɛ̰ AG j AB ɛ̰ AG
ယွန်း	j AB ʊ AE ɴ
ယွန်းထည်	j AB ʊ AE ɴ tʰ ɛ AD
ယွန်းယွန်း	j AB ʊ AE ɴ j AB ʊ AE ɴ
ယှဉ်ဖက်	ʃ ɪ AD ɴ pʰ ɛ AD ʔ
ယှဉ်း	ʃ ɪ AD ɴ
ရ	ɹ AI a̰ AG
ရကောက်	j AB a̰ AG k a AD ʊ AE ʔ
ရက်	j AB ɛ AD ʔ
ရက်ကန်း	j AB ɛ AD ʔ k a AD ɴ
ရက်ကန်းစင်	j AB ɛ AD ʔ k a AD ɴ z ɪ AD ɴ
ရက်စွဲ	j AB ɛ AD ʔ s w AC ɛ AD
ရက်ရာဇာ	j AB ɛ AD ʔ j AB a AD z a AD
ရက်သတ္တပတ်	j AB ɛ AD ʔ θ a AD ʔ d ə AD b a AD ʔ
ရခိုင်	j AB ə AD kʰ a AD ɪ AD ɴ
ရင်	j AB ɪ AD ɴ
ရင်ခံ	j AB ɪ AD ɴ kʰ a AD ɴ
ရင်ထိုးတံဆိပ်	j AB ɪ AD ɴ d o AE d ə AD z e AD ɪ AD ʔ
ရင်ပတ်	j AB ɪ AD ɴ b a AD ʔ
ရင်ပြင်	j AB ɪ AD ɴ b j AB ɪ AD ɴ
ရင်ဘတ်	j AB ɪ AD ɴ b a AD ʔ
ရင်းရဲ	j AB ɪ AD ɴ j AB ɛ AD
ရည်	j AB i AD
ရည်းစား	j AB i AD z a AD
ရတနာ	j AB ɛ AD d ə AD n a AD
ရတနာပုံ	j AB ɛ AD d ə AD n a AD b o AE ʊ AE ɴ
ရတနာပူရ	j AB ɛ AD d ə AD n a AD p u AE ɹ AI a̰ AG
ရတနာသိင်္ဃ	j AB ə AD d ə AD n a AD θ e AD ɪ AD ɴ ɡ a̰ AG
ရတနာသုံးပါး	j AB ɛ AD d ə AD n a AD θ o AE ʊ AE ɴ b a AD
ရတီ	j AB ə AD t i AD
ရတု	j AB a̰ AG t ṵ
ရထား	j AB ə AD tʰ a AD
ရနံ့	j AB ə AD n a̰ AG ɴ
ရန်	j AB a AD ɴ
ရန်ကုန်	j AB a AD ɴ ɡ o AE ʊ AE ɴ
ရန်ပြု	j AB a AD ɴ p j AB ṵ
ရန်ဖြစ်	j AB a AD ɴ pʰ j AB ɪ AD ʔ
ရန်သူ	j AB a AD ɴ ð u AE
ရန်သူမျိုးငါးပါး	j AB a AD ɴ ð u AE m j AB o AE ŋ a AD b a AD
ရပါတယ်	j AB a̰ AG b a AD d ɛ AD
ရပ်	j AB a AD ʔ
ရပ်ကွက်	j AB a AD ʔ k w AC ɛ AD ʔ
ရမ္မက်	j AB ə AD m ɛ AD ʔ
ရမ်	ɹ AI a AD ɴ
ရမ်းရမ်း	j AB a AD ɴ j AB a AD ɴ
ရယ်	j AB i AD
ရရစ်	j AB a̰ AG j AB ɪ AD ʔ
ရဝမ်ဒါ	ɹ AI ə AD w AC a AD ɴ d a AD
ရဝိန်	j AB ə AD w AC e AD ɪ AD ɴ
ရဝေ	j AB ə AD w AC e AD
ရသ	j AB a̰ AG ð a AD
ရဟတ်	j AB ə AD h AA a AD ʔ
ရဟန်း	j AB ə AD h AA a AD ɴ
ရာ	j AB a AD
ရာခိုင်နှုန်း	j AB a AD kʰ a AD ɪ AD ɴ n̥ o AE ʊ AE ɴ
ရာဂ	j AB a AD ɡ a̰ AG
ရာစု	j AB a AD z ṵ
ရာစုနှစ်	j AB a AD z ṵ n̥ ɪ AD ʔ
ရာဇ	j AB a AD z a̰ AG
ရာဇဂုရု	j AB a AD z a̰ AG ɡ ṵ ɹ AI ṵ
ရာဇဌာန်	ɹ AI a AD z ə AD tʰ a AD n
ရာဇဝင်	j AB a AD z ə AD w AC ɪ AD ɴ
ရာဇဝတ်	j AB a AD z ə AD w AC ʊ AE ʔ
ရာဇဝတ်ကောင်	j AB a AD z ə AD w AC ʊ AE ʔ k a AD ʊ AE ɴ
ရာဇသတ်	j AB a AD z ə AD θ a AD ʔ
ရာဇာ	j AB a AD z a AD
ရာဇာဓိရာဇဂုရု	j AB a AD z a̰ AG d ḭ j AB a AD z a̰ AG ɡ ṵ ɹ AI ṵ
ရာဘ	j AB a AD b a̰ AG
ရာဘာ	j AB a AD b a AD
ရာမ	j AB a AD m a̰ AG
ရာမည	ɹ AI a AD m ə AD ɲ a̰ AG
ရာဝဏ	ɹ AI a AD w AC ə AD n a̰ AG
ရာသီ	j AB a AD ð i AD
ရာသီဥတု	j AB a AD ð i AD ʔ ṵ d ṵ
ရာဟုလာ	j AB a AD h AA ṵ l a AD
ရိက္ခါ	j AB e AD ɪ AD ʔ kʰ a AD
ရိက္ခာ	j AB e AD ɪ AD ʔ kʰ a AD
ရိတ်	j AB e AD ɪ AD ʔ
ရိတ်သိမ်း	j AB e AD ɪ AD ʔ θ e AD ɪ AD ɴ
ရိပ်ရိပ်	j AB e AD ɪ AD ʔ j AB e AD ɪ AD ʔ
ရိုက်	j AB a AD ɪ AD ʔ
ရိုင်ဖယ်	ɹ AI a AD ɪ AD ɴ pʰ ɛ AD
ရိုင်ရိုင်	j AB a AD ɪ AD ɴ j AB a AD ɪ AD ɴ
ရိုဟင်ဂျာ	ɹ AI o AE h AA ɪ AD ɴ d ʑ a AD
ရိုး	j AB o AE
ရိုးရာအမည်	j AB o AE j AB a AD ʔ ə AD m j AB i AD
ရိုးရိုး	j AB o AE j AB o AE
ရုက္ခစိုး	j AB o AE ʊ AE ʔ ɡ ə AD z o AE
ရုက္ခဗေဒ	j AB o AE ʊ AE ʔ kʰ a̰ AG b e AD d a̰ AG
ရုပ်	j AB o AE ʊ AE ʔ
ရုပ်ကလာပ်	j AB o AE ʊ AE ʔ k ə AD l a AD ʔ
ရုပ်တု	j AB o AE ʊ AE ʔ t ṵ
ရုပ်ပုံ	j AB o AE ʊ AE ʔ p o AE ʊ AE ɴ
ရုပ်မြင်သံကြား	j AB o AE ʊ AE ʔ m j AB ɪ AD ɴ θ a AD ɴ d ʑ a AD
ရုပ်ရှင်	j AB o AE ʊ AE ʔ ʃ ɪ AD ɴ
ရုပ်ရှင်ရုံ	j AB o AE ʊ AE ʔ ʃ ɪ AD ɴ j AB o AE ʊ AE ɴ
ရုပ်သေး	j AB o AE ʊ AE ʔ θ e AD
ရုပ်သေးအစိုးရ	j AB o AE ʊ AE ʔ θ e AD ʔ ə AD s o AE j AB a̰ AG
ရုရု	j AB ṵ j AB ṵ
ရုရှား	ɹ AI ṵ ʃ a AD
ရုံ	j AB o AE ʊ AE ɴ
ရုံး	j AB o AE ʊ AE ɴ
ရုံးပတီ	j AB o AE ʊ AE ɴ b ə AD t i AD
ရူပ	j AB u AE p a̰ AG
ရူပကအလင်္ကာ	j AB u AE p ə AD k a̰ AG ʔ ə AD l i AD ɡ a AD
ရူပနက္ခတ္တဗေဒ	j AB u AE p a̰ AG n ɛ AD ʔ kʰ a AD ʔ t a̰ AG b e AD d a̰ AG
ရူပဗေဒ	j AB u AE p a̰ AG b e AD d a̰ AG
ရူမေးနီးယား	ɹ AI u AE m e AD n i AD j AB a AD
ရေ	j AB e AD
ရေကတော့	j AB e AD ɡ ə AD d ɔ̰ AH
ရေကာတာ	j AB e AD ɡ a AD d a AD
ရေကူး	j AB e AD k u AE
ရေကူးကန်	j AB e AD k u AE ɡ a AD ɴ
ရေကြီး	j AB e AD t ɕ i AD
ရေကြီးခြင်း	j AB e AD t ɕ i AD d ʑ ɪ AD ɴ
ရေခဲ	j AB e AD ɡ ɛ AD
ရေခဲမုန့်	j AB e AD ɡ ɛ AD m o̰ AH ʊ AE ɴ
ရေခဲသေတ္တာ	j AB e AD ɡ ɛ AD θ ɪ AD ʔ t a AD
ရေချိုး	j AB e AD t ɕʰ o AE
ရေခွက်	j AB e AD ɡ w AC ɛ AD ʔ
ရေငတ်တယ်	j AB e AD ŋ a AD ʔ t ɛ AD
ရေငွေ့	j AB e AD ŋ w AC ḛ
ရေစစ္စရီ	j AB e AD s ɪ AD ʔ s ə AD ɹ AI i AD
ရေညှိ	j AB e AD ɲ̊ ḭ
ရေတပ်	j AB e AD d a AD ʔ
ရေတံခွန်	j AB e AD d a AD ɡ ʊ AE ɴ
ရေတွက်	j AB e AD t w AC ɛ AD ʔ
ရေတွင်း	j AB e AD d w AC ɪ AD ɴ
ရေဒီယို	ɹ AI e AD d i AD j AB o AE
ရေနဂါး	j AB e AD n ə AD ɡ a AD
ရေနံ	j AB e AD n a AD ɴ
ရေနံချောင်း	j AB e AD n a AD ɴ t ɕʰ a AD ʊ AE ɴ
ရေနံဆီ	j AB e AD n a AD ɴ z i AD
ရေပန်း	j AB e AD b a AD ɴ
ရေပိုက်	j AB e AD p a AD ɪ AD ʔ
ရေမိုင်	j AB e AD m a AD ɪ AD ɴ
ရေမြင်း	j AB e AD m j AB ɪ AD ɴ
ရေမွှေး	j AB e AD m̥ w AC e AD
ရေမှုတ်	j AB e AD m̥ o AE ʊ AE ʔ
ရေယုန်	j AB e AD j AB o AE ʊ AE ɴ
ရေလက်ဝါး	j AB e AD l ɛ AD ʔ w AC a AD
ရေလုပ်သား	j AB e AD l o AE ʊ AE ʔ θ a AD
ရေဝတ	ɹ AI e AD w AC ə AD t a̰ AG
ရေဝတဘုရား	j AB e AD w AC ə AD t a̰ AG pʰ ə AD j AB a AD
ရေသူ	j AB e AD ð u AE
ရေသူမ	j AB e AD ð u AE m a̰ AG
ရောက်	j AB a AD ʊ AE ʔ
ရောဂန္တရကပ်	j AB ɔ AE ɡ a AD ɴ t ə AD ɹ AI a̰ AG k a AD ʔ
ရောဂါ	j AB ɔ AE ɡ a AD
ရောဂါဗေဒ	j AB ɔ AE ɡ a AD b e AD d a̰ AG
ရောင်	j AB a AD ʊ AE ɴ
ရောင်ခြည်	j AB a AD ʊ AE ɴ d ʑ i AD
ရောင်း	j AB a AD ʊ AE ɴ
ရောမ	ɹ AI ɔ AE m a̰ AG
ရော်ဘာ	ɹ AI ɔ AE b a AD
ရေး	j AB e AD
ရေးချ	j AB e AD t ɕʰ a̰ AG
ရေးရေး	j AB e AD j AB e AD
ရဲ	j AB ɛ AD
ရဲစခန်း	j AB ɛ AD s ə AD kʰ a AD ɴ
ရဲတိုက်	j AB ɛ AD d a AD ɪ AD ʔ
ရဲဘော်	j AB ɛ AD b ɔ AE
ရဲရင့်	j AB ɛ AD j AB ɪ̰ AG ɴ
ရဲရဲ	j AB ɛ AD j AB ɛ AD
ရဲသား	j AB ɛ AD ð a AD
ရဲ့	j AB ɛ̰ AG
ရွတ်ရွတ်	j AB ʊ AE ʔ j AB ʊ AE ʔ
ရွပ်ရွပ်	j AB ʊ AE ʔ j AB ʊ AE ʔ
ရွရွ	j AB w AC a̰ AG j AB w AC a̰ AG
ရွာ	j AB w AC a AD
ရွာစား	j AB w AC a AD z a AD
ရွာသူ	j AB w AC a AD ð u AE
ရွေး	j AB w AC e AD
ရွေးကောက်ပွဲ	j AB w AC e AD k a AD ʊ AE ʔ p w AC ɛ AD
ရွှေ	ʃ w AC e AD
ရွှေကြည်	ʃ w AC e AD d ʑ i AD
ရွှေချည်ထိုး	ʃ w AC e AD d ʑ i AD d o AE
ရွှေချီ	ʃ w AC e AD d ʑ i AD
ရွှေတိုက်	ʃ w AC e AD d a AD ɪ AD ʔ
ရွှေတောင်	ʃ w AC e AD d a AD ʊ AE ɴ
ရွှေတောင်ခေါက်ဆွဲ	ʃ w AC e AD d a AD ʊ AE ɴ kʰ a AD ʊ AE ʔ sʰ w AC ɛ AD
ရွှေထမင်း	ʃ w AC e AD tʰ ə AD m ɪ AD ɴ
ရွှေနန်းရွှေပြာသာဒ်သခင်	ʃ w AC e AD n a AD ɴ ʃ w AC e AD p j AB a AD ʔ θ a AD ʔ θ ə AD kʰ ɪ AD ɴ
ရွှေနန်းရှင်ဘုရား	ʃ w AC e AD n a AD ɴ ʃ ɪ AD ɴ pʰ ə AD j AB a AD
ရွှေပြည်စိုး	ʃ w AC e AD p j AB i AD s o AE
ရွှေဖရုံသီး	ʃ w AC e AD pʰ ə AD j AB o AE ʊ AE ɴ ð i AD
ရွှေဖြူ	ʃ w AC e AD b j AB u AE
ရွှေဘို	ʃ w AC e AD b o AE
ရွှေမျက်ပါး	ʃ w AC e AD m j AB ɛ AD ʔ p a AD
ရွှေရင်အေး	ʃ w AC e AD j AB ɪ AD ɴ ʔ e AD
ရွှေ့	ʃ w AC ḛ
ရွှဲ	ʃ w AC ɛ AD
ရွှံ့	ʃ ʊ̰ AH ɴ
ရွှံ့ပွက်	ʃ ʊ̰ AH ɴ b w AC ɛ AD ʔ
ရှက်	ʃ ɛ AD ʔ
ရှင့်	ʃ ɪ̰ AG ɴ
ရှင်	ʃ ɪ AD ɴ
ရှင်တို့	ʃ ɪ AD ɴ d o̰ AH
ရှင်ပြု	ʃ ɪ AD ɴ p j AB ṵ
ရှင်ဘုရင်	ʃ ɪ AD ɴ b ə AD j AB ɪ AD ɴ
ရှင်ရှင်	ʃ ɪ AD ɴ ʃ ɪ AD ɴ
ရှင်းရှင်း	ʃ ɪ AD ɴ ʃ ɪ AD ɴ
ရှစ်	ʃ ɪ AD ʔ
ရှစ်လ	ʃ ɪ AD ʔ l a̰ AG
ရှဉ့်	ʃ ɪ̰ AG ɴ
ရှည်	ʃ e AD
ရှည်မျော	ʃ e AD m j AB ɔ AE
ရှမ်း	ʃ a AD ɴ
ရှမ်းခေါက်ဆွဲ	ʃ a AD ɴ kʰ a AD ʊ AE ʔ sʰ w AC ɛ AD
ရှယ်	ʃ ɛ AD
ရှလကာရည်	ʃ a AD l ə AD k a AD j AB e AD
ရှလပတ်ရည်	ʃ a̰ AG l ə AD p a AD ʔ j AB e AD
ရှာ	ʃ a AD
ရှား	ʃ a AD
ရှိ	ʃ ḭ
ရှိန်းခို	ʃ e AD ɪ AD ɴ ɡ o AE
ရှိုက်	ʃ a AD ɪ AD ʔ
ရှို့	ʃ o̰ AH
ရှိုး	ʃ o AE
ရှူ	ʃ u AE
ရှူတင်	ʃ u AE t ɪ AD ɴ
ရှူရှိုက်	ʃ u AE ʃ a AD ɪ AD ʔ
ရှူးဖိနပ်	ʃ u AE pʰ ə AD n a AD ʔ
ရှောက်	ʃ a AD ʊ AE ʔ
ရှောက်နု	ʃ a AD ʊ AE ʔ n ṵ
ရှေ့	ʃ ḛ
ရှေ့ဆက်	ʃ ḛ z ɛ AD ʔ
ရှေ့နေ	ʃ ḛ n e AD
ရှေ့ရုံး	ʃ ḛ j AB o AE ʊ AE ɴ
ရှေး	ʃ e AD
ရဿ	ɹ AI a AD ʔ θ a̰ AG
လ	l a̰ AG
လက္ခဏ	l ɛ AD ʔ kʰ ə AD n a̰ AG
လက္ခဏာ	l ɛ AD ʔ kʰ ə AD n a AD
လက္ခဏာရေးသုံးပါး	l ɛ AD ʔ kʰ ə AD n a AD j AB e AD θ o AE ʊ AE ɴ b a AD
လက်	l ɛ AD ʔ
လက်ကိုင်ပဝါ	l ɛ AD ʔ k a AD ɪ AD ɴ p a̰ AG w AC a AD
လက်ကောက်	l ɛ AD ʔ k a AD ʊ AE ʔ
လက်ကွက်	l ɛ AD ʔ k w AC ɛ AD ʔ
လက်ခံ	l ɛ AD ʔ kʰ a AD ɴ
လက်ချောင်း	l ɛ AD ʔ t ɕʰ a AD ʊ AE ɴ
လက်စွပ်	l ɛ AD ʔ s ʊ AE ʔ
လက်ဆောင်	l ɛ AD ʔ sʰ a AD ʊ AE ɴ
လက်ဆွဲသေတ္တာ	l ɛ AD ʔ sʰ w AC ɛ AD θ ɪ AD ʔ t a AD
လက်တင်	l ɛ AD ʔ t ɪ AD ɴ
လက်တင်အမေရိက	l ɛ AD ʔ t ɪ AD ɴ ʔ ə AD m e AD ɹ AI ḭ k a̰ AG
လက်တန်း	l ɛ AD ʔ t a AD ɴ
လက်ထပ်	l ɛ AD ʔ tʰ a AD ʔ
လက်နက်	l ɛ AD ʔ n ɛ AD ʔ
လက်နှိပ်စက်	l ɛ AD ʔ n̥ e AD ɪ AD ʔ s ɛ AD ʔ
လက်ပတ်နာရီ	l ɛ AD ʔ p a AD ʔ n a AD j AB i AD
လက်ပံ	l ɛ AD ʔ p a AD ɴ
လက်ပံခါး	l ɛ AD ʔ p a AD ɴ ɡ a AD
လက်ဖက်	l ɛ AD ʔ pʰ ɛ AD ʔ
လက်ဖက်ထုပ်	l ə AD pʰ ɛ AD ʔ tʰ o AE ʊ AE ʔ
လက်ဖက်ရည်	l ə AD pʰ ɛ AD ʔ j AB e AD
လက်ဖက်ရည်ဆိုင်	l ə AD pʰ ɛ AD ʔ j AB e AD z a AD ɪ AD ɴ
လက်ဖက်သုပ်	l ə AD pʰ ɛ AD ʔ θ o AE ʊ AE ʔ
လက်ဘနွန်	l ɛ AD ʔ b ə AD n ʊ AE ɴ
လက်မှတ်	l ɛ AD ʔ m̥ a AD ʔ
လက်ရန်း	l ɛ AD ʔ j AB a AD ɴ
လက်ဝါး	l ɛ AD ʔ w AC a AD
လက်ဝါးကပ်တိုင်	l ɛ AD ʔ w AC ə AD ɡ a AD ʔ t a AD ɪ AD ɴ
လက်ဝှေ့	l ɛ AD ʔ ʍ AF ḛ
လက်သည်	l ɛ AD ʔ θ ɛ AD
လက်သည်း	l ɛ AD ʔ θ ɛ AD
လက်သည်းကွင်း	l ɛ AD ʔ θ e AD ɡ w AC ɪ AD ɴ
လက်သမား	l ɛ AD ʔ θ a̰ AG m a AD
လက်သီး	l ɛ AD ʔ θ i AD
လက်သုတ်ပဝါ	l ɛ AD ʔ θ o AE ʊ AE ʔ p a̰ AG w AC a AD
လက်သုပ်စုံ	l ɛ AD ʔ θ o AE ʊ AE ʔ s o AE ʊ AE ɴ
လက်အိတ်	l ɛ AD ʔ ʔ e AD ɪ AD ʔ
လကွယ်	l a̰ AG ɡ w AC ɛ AD
လခြမ်း	l a̰ AG d ʑ a AD ɴ
လခြမ်းဆိုင်း	l a̰ AG d ʑ a AD ɴ sʰ a AD ɪ AD ɴ
လငယ်	l a̰ AG ŋ ɛ AD
လင်	l ɪ AD ɴ
လင်ကောင်ပိုး	l ɪ AD ɴ ɡ a AD ʊ AE ɴ b o AE
လင်ပန်း	l ɪ AD ɴ b a AD ɴ
လင်မယား	l ɪ AD ɴ m ə AD j AB a AD
လင်း	l ɪ AD ɴ
လင်းဆွဲ	l ɪ AD ɴ z w AC ɛ AD
လင်းဇင်း	l ɪ AD ɴ z ɪ AD ɴ
လင်းတ	l ɪ AD ɴ d a̰ AG
လင်းနို့	l ɪ AD ɴ n o̰ AH
လင်းပိုင်	l ɪ AD ɴ b a AD ɪ AD ɴ
လင်းယဉ်	l ɪ AD ɴ j AB ɪ AD ɴ
လင်းယုန်	l ɪ AD ɴ j AB o AE ʊ AE ɴ
လစဉ်	l a̰ AG z ɪ AD ɴ
လစ်	l ɪ AD ʔ
လစ်တန်စတိန်း	l ɪ AD ʔ t a AD ɴ s ə AD t e AD ɪ AD ɴ
လစ်ဗျား	l ɪ AD ʔ b j AB a AD
လစ်သူယေးနီးယား	l ɪ AD ʔ θ u AE j AB e AD n i AD j AB a AD
လဆန်း	l a̰ AG z a AD ɴ
လဆုတ်	l a̰ AG z o AE ʊ AE ʔ
လဆွဲ	l a̰ AG sʰ w AC ɛ AD
လည်	l ɛ AD
လည်ချောင်း	l ɛ AD d ʑ a AD ʊ AE ɴ
လည်စည်း	l e AD z i AD
လည်ပင်း	l ɛ AD b ɪ AD ɴ
လည်ပင်းကြီးရောဂါ	l i AD b ɪ AD ɴ d ʑ i AD j AB ɔ AE ɡ a AD
လည်း	l ɛ AD
လတ်	l a AD ʔ
လတ်ဗီယာ	l a AD ʔ b i AD j AB a AD
လန်ဒန်	l a AD ɴ d a AD ɴ
လပို့	l ə AD b o̰ AH
လပ်	l a AD ʔ
လပြည့်	l a̰ AG p j AB ḛ
လပြည့်နေ့	l a̰ AG p j AB ḭ n ḛ
လပြည့်ဝန်း	l a̰ AG b j AB ḛ w AC ʊ AE ɴ
လမု	l ə AD m ṵ
လမုန့်	l a̰ AG m o̰ AH ʊ AE ɴ
လမ်း	l a AD ɴ
လမ်းကြား	l a AD ɴ d ʑ a AD
လမ်းဆုံ	l a AD ɴ z o AE ʊ AE ɴ
လမ်းပြ	l a AD ɴ p j AB a̰ AG
လမ်းဘေးဆိုင်	l a AD ɴ b e AD z a AD ɪ AD ɴ
လမ်းလျှောက်	l a AD ɴ ʃ a AD ʊ AE ʔ
လမ်းသရဲ	l a AD ɴ θ ə AD j AB ɛ AD
လယ်	l ɛ AD
လယ်ထွန်	l ɛ AD tʰ ʊ AE ɴ
လယ်ထွန်မင်္ဂလာ	l ɛ AD tʰ ʊ AE ɴ m ɪ AD ɴ ɡ ə AD l a AD
လယ်ပြင်	l ɛ AD b j AB ɪ AD ɴ
လယ်ယာ	l ɛ AD j AB a AD
လယ်သမား	l ɛ AD ð ə AD m a AD
လဟု	l ə AD h AA ṵ
လာ	l a AD
လာဘ်	l a AD ʔ
လာအို	l a AD ʔ o AE
လား	l a AD
လိင်	l e AD ɪ AD ɴ
လိင်ဆက်ဆံ	l e AD ɪ AD ɴ sʰ ɛ AD ʔ sʰ a AD ɴ
လိင်တံ	l e AD ɪ AD ɴ d a AD ɴ
လိင်ပညာ	l e AD ɪ AD ɴ p j AB ɪ AD ɴ ɲ a AD
လိပ်	l e AD ɪ AD ʔ
လိပ်ကျောက်	l e AD ɪ AD ʔ t ɕ a AD ʊ AE ʔ
လိပ်ခေါင်း	l e AD ɪ AD ʔ ɡ a AD ʊ AE ɴ j AB ɔ AE ɡ a AD
လိပ်ခေါင်းရောဂါ	l e AD ɪ AD ʔ ɡ a AD ʊ AE ɴ j AB ɔ AE ɡ a AD
လိပ်စာ	l e AD ɪ AD ʔ s a AD
လိပ်ပြာ	l e AD ɪ AD ʔ p j AB a AD
လိမ္မော်	l e AD ɪ AD ɴ m ɔ AE
လိမ်	l e AD ɪ AD ɴ
လိမ်း	l e AD ɪ AD ɴ
လိမ်းဆေး	l e AD ɪ AD ɴ z e AD
လို	l o AE
လိုက်	l a AD ɪ AD ʔ
လိုက်ချီး	l a AD ɪ AD ʔ t ɕʰ i AD
လိုက်ပြေး	l a AD ɪ AD ʔ p j AB e AD
လိုက်ဘေးရီးယား	l a AD ɪ AD ʔ b e AD ɹ AI i AD j AB a AD
လိုချင်	l o AE d ʑ ɪ AD ɴ
လိုင်စင်	l a AD ɪ AD ɴ s ɪ AD ɴ
လိုင်း	l a AD ɪ AD ɴ
လိုဏ်	l̥ a AD ɪ AD ɴ
လိုဏ်ခေါင်း	l̥ a AD ɪ AD ɴ ɡ a AD ʊ AE ɴ
လိုအပ်	l o AE ʔ a AD ʔ
လို့	l o̰ AH
လိုး	l o AE
လီဆိုသို	l i AD sʰ o AE θ o AE
လီဆူ	l i AD sʰ u AE
လီတာ	l i AD t a AD
လီသီယမ်	l i AD θ i AD j AB a AD ɴ
လီး	l i AD
လုပ်	l o AE ʊ AE ʔ
လုပ်ခ	l o AE ʊ AE ʔ kʰ a̰ AG
လုပ်ငန်း	l o AE ʊ AE ʔ ŋ a AD ɴ
လုပ်ရတ်	l o AE ʊ AE ʔ j AB a AD ʔ
လုပ်သား	l o AE ʊ AE ʔ θ a AD
လုပ်အား	l o AE ʊ AE ʔ ʔ a AD
လုံချည်	l o AE ʊ AE ɴ d ʑ i AD
လုံခြုံရေး	l o AE ʊ AE ɴ d ʑ o AE ʊ AE ɴ j AB e AD
လုံး	l o AE ʊ AE ɴ
လုံးလုံး	l o AE ʊ AE ɴ l o AE ʊ AE ɴ
လူ	l u AE
လူကြီး	l u AE d ʑ i AD
လူငယ်	l u AE ŋ ɛ AD
လူစုလူဝေး	l u AE z ṵ l u AE w AC e AD
လူဇင်ဘတ်	l u AE z ɪ AD ɴ b a AD ʔ
လူတော	l u AE d ɔ AE
လူပျို	l u AE b j AB o AE
လူပျိုနာ	l u AE b j AB o AE n a AD
လူမျိုး	l u AE m j AB o AE
လူမျိုးစုလွှတ်တော်	l u AE m j AB o AE z ṵ l̥ ʊ AE ʔ t ɔ AE
လူမျိုးရေးဝါဒ	l u AE m j AB o AE j AB e AD w AC a AD d a̰ AG
လူမှုကွန်ရက်	l u AE m̥ ṵ k ʊ AE ɴ j AB ɛ AD ʔ
လူဝင်မှုကြီးကြပ်ရေး	l u AE w AC ɪ AD ɴ m̥ ṵ t ɕ i AD t ɕ a AD ʔ j AB e AD
လူဝံ	l u AE w AC ʊ AE ɴ
လူသတ်မှု	l u AE ð a AD ʔ m̥ ṵ
လူသား	l u AE ð a AD
လူဦးရေ	l u AE ʔ u AE j AB e AD
လူ့ဘောင်	l ṵ b a AD ʊ AE ɴ
လူ့အဖွဲ့အစည်း	l ṵ ʔ ə AD pʰ w AC ɛ̰ AG ʔ ə AD s i AD
လေ	l e AD
လေကတော့	l e AD ɡ ə AD d ɔ̰ AH
လေချဉ်တက်	l e AD d ʑ ɪ AD ɴ t ɛ AD ʔ
လေချွန်	l e AD t ɕʰ ʊ AE ɴ
လေစုန်	l e AD z o AE ʊ AE ɴ
လေဆိပ်	l e AD z e AD ɪ AD ʔ
လေထိုးတံ	l e AD tʰ o AE d a AD ɴ
လေထီး	l e AD d i AD
လေထု	l e AD d ṵ
လေပွေ	l e AD b w AC e AD
လေဖိအား	l e AD pʰ ḭ ʔ a AD
လေဖုတ်	l e AD pʰ o AE ʊ AE ʔ
လေဖြတ်ရောဂါ	l e AD pʰ j AB a AD ʔ j AB ɔ AE ɡ a AD
လေမုန်တိုင်း	l e AD m o AE ʊ AE ɴ d a AD ɪ AD ɴ
လေယာဉ်	l e AD j AB ɪ AD ɴ
လေယာဉ်ပျံ	l e AD j AB ɪ AD ɴ b j AB a AD ɴ
လေရဟတ်	l e AD j AB ə AD h AA a AD ʔ
လေလည်	l e AD l e AD
လေသာခန်း	l e AD ð a AD ɡ a AD ɴ
လေသာပေါက်	l e AD ð a AD b a AD ʊ AE ʔ
လေသိုက်	l e AD θ a AD ɪ AD ʔ
လေအေးစက်	l e AD ʔ e AD z ɛ AD ʔ
လောက	l ɔ AE k a̰ AG
လောကနတ်	l ɔ AE k a̰ AG n a AD ʔ
လောကဝတ်	l ɔ AE ɡ ə AD w AC ʊ AE ʔ
လောက်	l a AD ʊ AE ʔ
လောင်	l a AD ʊ AE ɴ
လောင်စာ	l a AD ʊ AE ɴ z a AD
လောင်း	l a AD ʊ AE ɴ
လောဘ	l ɔ AE b a̰ AG
လောလော	l ɔ AE l ɔ AE
လေ့ကျင့်	l ḛ t ɕ ɪ̰ AG ɴ
လေ့ကျင့်ခန်း	l ḛ t ɕ ɪ̰ AG ɴ ɡ a AD ɴ
လေ့လာ	l ḛ l a AD
လေး	l e AD
လေးကြိုး	l e AD d ʑ o AE
လေးညှင်း	l e AD ɲ̊ ɪ AD ɴ
လေးညှင်းပွင့်	l e AD ɲ̊ ɪ AD ɴ b w AC ɪ̰ AG ɴ
လေးထောင့်	l e AD d a̰ AG ʊ AE ɴ
လေးလ	l e AD l a̰ AG
လေးလံ	l e AD l a AD ɴ
လဲ	l ɛ AD
လဲ့လဲ့	l ɛ̰ AG l ɛ̰ AG
လံဗား	l a AD ɴ b a AD
လျက်	j AB ɛ AD ʔ
လျားလျား	j AB a AD j AB a AD
လျောင်း	l j AB a AD ʊ AE ɴ
လျှင်	l̥ j AB ɪ AD ɴ
လျှပ်	l̥ j AB a AD ʔ
လျှပ်စစ်ဓာတ်	l̥ j AB a AD ʔ s ɪ AD ʔ d a AD ʔ
လျှပ်စီး	l̥ j AB a AD ʔ s i AD
လျှာ	ʃ a AD
လျှာနာခွာနာ	ʃ a AD n a AD kʰ w AC a AD n a AD
လျှာရည်	ʃ a AD j AB i AD
လျှောက်	ʃ a AD ʊ AE ʔ
လွတ်လပ်	l ʊ AE ʔ l a AD ʔ
လွတ်လပ်ခွင့်	l ʊ AE ʔ l a AD ʔ kʰ w AC ɪ̰ AG ɴ
လွတ်လပ်ရေးနေ့	l ʊ AE ʔ l a AD ʔ j AB e AD n ḛ
လွန်	l ʊ AE ɴ
လွန်ဆွဲ	l ʊ AE ɴ sʰ w AC ɛ AD
လွယ်	l w AC ɛ AD
လွိုင်ကော်	l w AC a AD ɪ AD ɴ k ɔ AE
လွှ	l̥ w AC a̰ AG
လွှတ်တော်	l̥ ʊ AE ʔ t ɔ AE
လွှတ်ရုံးငါးရပ်	l̥ ʊ AE ʔ j AB o AE ʊ AE ɴ ŋ a AD j AB a AD ʔ
လှ	l̥ a̰ AG
လှည့်	l̥ ɛ̰ AG
လှည်း	l̥ ɛ AD
လှည်းကူး	l̥ i AD k u AE
လှပ	l̥ a̰ AG p a̰ AG
လှပ်လှပ်	l̥ a AD ʔ l̥ a AD ʔ
လှလှ	l̥ a̰ AG l̥ a̰ AG
လှိုင်း	l̥ a AD ɪ AD ɴ
လှုပ်ရှား	l̥ o AE ʊ AE ʔ ʃ a AD
လှုပ်လှုပ်	l̥ o AE ʊ AE ʔ l̥ o AE ʊ AE ʔ
လှုလှု	l̥ ṵ l̥ ṵ
လှုံ	l̥ o AE ʊ AE ɴ
လှေ	l̥ e AD
လှေကား	l̥ e AD ɡ a AD
လှောက်	l̥ a AD ʊ AE ʔ
လှော်ကား	l̥ ɔ AE ɡ a AD
လှေး	l̥ e AD
လှဲ	l̥ ɛ AD
လှံ	l̥ a AD ɴ
ဝ	w AC a̰ AG
ဝက်	w AC ɛ AD ʔ
ဝက်ကြွပ်	w AC ɛ AD ʔ t ɕ ʊ AE ʔ
ဝက်ခြံ	w AC ɛ AD ʔ t ɕʰ a AD ɴ
ဝက်ဆီ	w AC ɛ AD ʔ sʰ i AD
ဝက်ထီး	w AC ɛ AD ʔ tʰ i AD
ဝက်ဘ်ဆိုဒ်	w AC ɛ AD ʔ b sʰ a AD ɪ AD ʔ
ဝက်မ	w AC ɛ AD ʔ m a̰ AG
ဝက်မှင်ဘီး	w AC ɛ AD ʔ m̥ ɪ AD ɴ b i AD
ဝက်ဝံ	w AC ɛ AD ʔ w AC ʊ AE ɴ
ဝက်သား	w AC ɛ AD ʔ θ a AD
ဝက်သားချဉ်	w AC ɛ AD ʔ θ a AD t ɕʰ ɪ AD ɴ
ဝက်သားတုတ်ထိုး	w AC ɛ AD ʔ θ a AD d o AE ʊ AE ʔ tʰ o AE
ဝက်သားမျှစ်ချဉ်	w AC ɛ AD ʔ θ a AD m̥ j AB ɪ AD ʔ t ɕʰ ɪ AD ɴ
ဝက်အူ	w AC ɛ AD ʔ ʔ u AE
ဝက်အူချောင်း	w AC ɛ AD ʔ ʔ u AE d ʑ a AD ʊ AE ɴ
ဝင်	w AC ɪ AD ɴ
ဝင်ရိုး	w AC ɪ AD ɴ j AB o AE
ဝင်း	w AC ɪ AD ɴ
ဝစီ	w AC ə AD z i AD
ဝစီကံ	w AC ə AD z i AD ɡ a AD ɴ
ဝစ်ရှင်နရီ	w AC ɪ AD ʔ ʃ ɪ AD ɴ n ə AD ɹ AI i AD
ဝဆွဲ	w AC a̰ AG sʰ w AC ɛ AD
ဝဇီရာ	w AC ə AD z i AD j AB a AD
ဝဏ္ဏ	w AC ʊ AE ɴ n a̰ AG
ဝတီ	w AC ə AD d i AD
ဝတ္ထု	w AC ʊ AE ʔ tʰ ṵ
ဝတ်	w AC ʊ AE ʔ
ဝတ်ကျောင်း	w AC ʊ AE ʔ t ɕ a AD ʊ AE ɴ
ဝတ်စုံ	w AC ʊ AE ʔ s o AE ʊ AE ɴ
ဝတ်လုံ	w AC ʊ AE ʔ l o AE ʊ AE ɴ
ဝနာ	w AC ə AD n a AD
ဝန်	w AC ʊ AE ɴ
ဝန်ကြီး	w AC ʊ AE ɴ d ʑ i AD
ဝန်ကြီးချုပ်	w AC ʊ AE ɴ d ʑ i AD d ʑ o AE ʊ AE ʔ
ဝန်ကြီးချုပ်ကတော်	w AC ʊ AE ɴ d ʑ i AD d ʑ o AE ʊ AE ʔ ɡ ə AD d ɔ AE
ဝန်ကြီးဌာန	w AC ʊ AE ɴ d ʑ i AD tʰ a AD n a̰ AG
ဝန်ခံ	w AC ʊ AE ɴ kʰ a AD ɴ
ဝန်စည်စလယ်	w AC ʊ AE ɴ z i AD z ə AD l ɛ AD
ဝန်ထောက်	w AC ʊ AE ɴ d a AD ʊ AE ʔ
ဝန်ရှင်တော်	w AC ʊ AE ɴ ʃ ɪ AD ɴ d ɔ AE
ဝပ်	w AC ʊ AE ʔ
ဝမ်း	w AC ʊ AE ɴ
ဝမ်းကျ	w AC a AD ɴ d ʑ a̰ AG
ဝမ်းဆက်	w AC ʊ AE ɴ sʰ ɛ AD ʔ
ဝမ်းဆွဲ	w AC ʊ AE ɴ z w AC ɛ AD
ဝမ်းတဖိုး	w AC ʊ AE ɴ d a̰ AG pʰ o AE
ဝမ်းနည်း	w AC a AD ɴ n e AD
ဝမ်းဘဲ	w AC ʊ AE ɴ b ɛ AD
ဝမ်းရောဂါ	w AC ʊ AE ɴ j AB ɔ AE ɡ a AD
ဝမ်းသာ	w AC ʊ AE ɴ θ a AD
ဝယ်	w AC ɛ AD
ဝရဏဗေဒ	w AC ə AD j AB ə AD n a̰ AG d a̰ AG b e AD d a̰ AG
ဝရန်တာ	w AC ə AD ɹ AI a AD ɴ d a AD
ဝလာဟကမြင်း	w AC ə AD l a AD h AA ə AD k a̰ AG m j AB ɪ AD ɴ
ဝသန္တ	w AC a̰ AG θ a AD ɴ t a̰ AG
ဝသုန္ဓရာ	w AC ə AD θ o AE ʊ AE ɴ d ə AD ɹ AI a AD
ဝသုန္ဓရေ	w AC ə AD θ o AE ʊ AE ɴ d ə AD ɹ AI e AD
ဝါ	w AC a AD
ဝါကျ	w AC e AD ɪ AD ʔ t ɕ a̰ AG
ဝါခေါင်	w AC a AD ɡ a AD ʊ AE ɴ
ဝါဂွမ်း	w AC a AD ɡ w AC a AD ɴ
ဝါစင်္ဂ	w AC a AD z ɪ AD ɴ ɡ a̰ AG
ဝါဆို	w AC a AD sʰ o AE
ဝါဆော	w AC a AD sʰ ɔ AE
ဝါဏိဇ္ဇ	w AC a AD n e AD ɪ AD ʔ z a̰ AG
ဝါဏိဇ္ဇပဋိပက္ခ	w AC a AD n e AD ɪ AD ʔ z a̰ AG p ə AD d ḭ p ɛ AD ʔ kʰ a̰ AG
ဝါဏိဇ္ဇဗေဒ	w AC a AD n e AD ɪ AD ʔ z a̰ AG b e AD d a̰ AG
ဝါဒ	w AC a AD d a̰ AG
ဝါရှင်တန်	w AC a AD ʃ ɪ AD ɴ t a AD ɴ
ဝါရှာ	w AC a AD ʃ a AD
ဝါသနာ	w AC a AD ð a̰ AG n a AD
ဝါသနာရှင်	w AC a AD ð ə AD n a AD ʃ ɪ AD ɴ
ဝါး	w AC a AD
ဝိဇယပူရ	w AC ḭ z ə AD j AB a̰ AG p u AE ɹ AI a̰ AG
ဝိဇ္ဇာ	w AC e AD ɪ AD ʔ z a AD
ဝိဇ္ဇာပညာ	w AC e AD ɪ AD ʔ z a AD p j AB ɪ AD ɴ ɲ a AD
ဝိဇ္ဇာဘွဲ့	w AC e AD ɪ AD ʔ z a AD b w AC ɛ̰ AG
ဝိညာဉ်	w AC e AD ɪ AD ɴ ɲ ɪ AD ɴ
ဝိတိုရိယ	w AC ḭ t o AE ɹ AI ḭ j AB a̰ AG
ဝိတ်	w AC e AD ɪ AD ʔ
ဝိတ်ချ	w AC e AD ɪ AD ʔ t ɕʰ a̰ AG
ဝိတ်လျှော့	w AC e AD ɪ AD ʔ ʃ ɔ̰ AH
ဝိနည်း	w AC ḭ n i AD
ဝိနိစ္ဆယ	w AC ḭ n e AD ɪ AD ʔ s ə AD j AB a̰ AG j AB a̰ AG
ဝိပတ္တိတရားလေးပါး	w AC ḭ p a AD ʔ t ḭ t ə AD j AB a AD l e AD b a AD
ဝိပဿနာ	w AC ḭ p a AD ʔ θ ə AD n a AD
ဝိပဿီ	w AC ḭ p ə AD t θ i AD
ဝိပဿီဘုရား	w AC ḭ p a AD ʔ θ i AD pʰ ə AD j AB a AD
ဝိဘတ်	w AC ḭ b a AD ʔ
ဝိသေသ	w AC ḭ θ e AD θ a̰ AG
ဝိသေသလက္ခဏာ	w AC ḭ θ e AD θ a̰ AG l ɛ AD ʔ kʰ ə AD n a AD
ဝိဟာရ	w AC ḭ h AA a AD j AB a̰ AG
ဝိုက်ချ	w AC a AD ɪ AD ʔ t ɕʰ a̰ AG
ဝိုင်	w AC a AD ɪ AD ɴ
ဝိုင်ယာကြိုး	w AC a AD ɪ AD ɴ j AB a AD d ʑ o AE
ဝိုင်း	w AC a AD ɪ AD ɴ
ဝီကီပိဒိယ	w AC i AD k i AD p ḭ d ḭ j AB a̰ AG
ဝီကီပီးဒီးယား	w AC i AD k i AD p i AD d i AD j AB a AD
ဝီစကီ	w AC i AD s ə AD k i AD
ဝီစီ	w AC i AD s i AD
ဝီရ	w AC i AD j AB a̰ AG
ဝီရိယ	w AC ə AD ɹ AI ḭ j AB a̰ AG
ဝေဒနာ	w AC e AD d ə AD n a AD
ဝေလ	w AC e AD l a̰ AG
ဝေလငါး	w AC e AD l a̰ AG ŋ a AD
ဝေသာလီ	w AC e AD θ a AD l i AD
ဝေဟင်	w AC e AD h AA ɪ AD ɴ
ဝေါ	w AC ɔ AE
ဝေါဟာရ	w AC ɔ AE h AA a AD ɹ AI a̰ AG
ဝေါဟာရဗေဒ	θ a AD ʔ d a̰ AG b e AD d a̰ AG
ဝေး	w AC e AD
ဝေးကွာ	w AC e AD k w AC a AD
ဝေဿ	w AC ɪ AD ʔ θ a̰ AG
ဝေဿဘူ	w AC e AD t θ ə AD b u AE
ဝေဿဘူဘုရား	w AC e AD t θ a̰ AG b u AE pʰ ə AD j AB a AD
ဝံ	w AC ʊ AE ɴ
ဝံပုလွေ	w AC ʊ AE ɴ b ə AD l w AC e AD
ဝံသ	w AC ʊ AE ɴ θ a̰ AG
ဝှက်	ʍ AF ɛ AD ʔ
ဝှေးစေ့	ʍ AF e AD z ḭ
သ	θ ə AD
သကာ	ð ə AD ɡ a AD
သကုဏဗေဒ	θ a̰ AG k ṵ n a̰ AG b e AD d a̰ AG
သက္ကတ	θ ɛ AD ʔ k ə AD t a̰ AG
သက်ဆိုင်	θ ɛ AD ʔ sʰ a AD ɪ AD ɴ
သက်တင်	θ ɛ AD ʔ t ɪ AD ɴ
သက်တံ	θ ɛ AD ʔ t a AD ɴ
သက်သာ	θ ɛ AD ʔ θ a AD
သက်သေ	θ ɛ AD ʔ θ e AD
သက်ဦးဆံပိုင်	θ ɛ AD ʔ ʔ u AE sʰ a AD ɴ b a AD ɪ AD ɴ
သကြား	ð ə AD d ʑ a AD
သကြားလုံး	ð ə AD d ʑ a AD l o AE ʊ AE ɴ
သခွား	θ ə AD kʰ w AC a AD
သခွားမသီး	θ ə AD kʰ ə AD m a̰ AG ð i AD
သင်	θ ɪ AD ɴ
သင်ကြား	θ ɪ AD ɴ t ɕ a AD
သင်ခန်းစာ	θ ɪ AD ɴ ɡ a AD ɴ z a AD
သင်တုန်းဓား	θ ɪ AD ɴ d o AE ʊ AE ɴ d a AD
သင်ပန်း	θ ɪ AD ɴ b a AD ɴ
သင်ပေါင်း	θ ɪ AD ɴ b a AD ʊ AE ɴ
သင်း	θ ɪ AD ɴ
သင်းဝင်	θ ɪ AD ɴ w AC ɪ AD ɴ
သင်္ကဒူး	θ ɪ AD ɴ ɡ ə AD d u AE
သင်္ကန်း	θ ɪ AD ɴ ɡ a AD ɴ
သင်္ကေတ	θ ɪ AD ɴ k e AD t a̰ AG
သင်္ကြန်	θ ɪ AD ɴ d ʑ a AD ɴ
သင်္ကြန်ထမင်း	ð ə AD d ʑ a AD ɴ tʰ ə AD m ɪ AD ɴ
သင်္ကြန်မိုး	θ ɪ AD ɴ d ʑ a AD ɴ m o AE
သင်္ချာ	θ ɪ AD ɴ t ɕʰ a AD
သင်္ချိုင်း	θ ɪ AD ɴ d ʑ a AD ɪ AD ɴ
သင်္ဂဟ	θ ɪ̰ AG ɴ ɡ ə AD h AA a̰ AG
သင်္ဂဟတရားလေးပါး	θ ɪ AD ɴ ɡ a̰ AG h AA a̰ AG t a̰ AG j AB a AD l e AD p a AD
သင်္ဘော	θ ɪ AD ɴ b ɔ AE
သင်္ဘောကြမ်း	θ ɪ AD ɴ b ɔ AE d ʑ a AD ɴ
သင်္ဘောဆိပ်	θ ɪ AD ɴ b ɔ AE z e AD ɪ AD ʔ
သင်္ဘောမညှိုးပန်း	θ ɪ AD ɴ b ɔ AE m ə AD ɲ̊ o AE b a AD ɴ
သင်္ဘောသီး	θ ɪ AD ɴ b ɔ AE ð i AD
သင်္ဘောသီးသုပ်	θ ɪ AD ɴ b ɔ AE θ i AD θ o AE ʊ AE ʔ
သင်္သကရိုက်	θ ɪ AD ɴ θ ə AD k ə AD ɹ AI a AD ɪ AD ʔ
သစ္စာ	θ ɪ AD ʔ s a AD
သစ္စာဖောက်	θ ɪ AD ʔ s a AD pʰ a AD ʊ AE ʔ
သစ္စာလေးပါး	θ ɪ AD ʔ s a AD l e AD p a AD
သစ်	θ ɪ AD ʔ
သစ်ကတိုး	θ ɪ AD ʔ ɡ ə AD d o AE
သစ်ကုလားအုတ်	θ ɪ AD ʔ k ə AD l ə AD ʔ o AE ʊ AE ʔ
သစ်ကျုတ်	θ ɪ AD ʔ t ɕ o AE ʊ AE ʔ
သစ်ကြံပိုး	θ ɪ AD ʔ d ʑ ə AD b o AE
သစ်စေး	s ɪ AD ʔ s i AD
သစ်ဆိမ့်	θ ɪ AD ʔ sʰ ḛ ɪ AD ɴ
သစ်တို	θ ɪ AD ʔ t o AE
သစ်တော	θ ɪ AD ʔ t ɔ AE
သစ်ပင်	θ ɪ AD ʔ p ɪ AD ɴ
သစ်ပုပ်	θ ɪ AD ʔ p o AE ʊ AE ʔ
သစ်ဖြူ	θ ɪ AD ʔ pʰ j AB u AE
သစ်သစ်	θ ɪ AD ʔ θ ɪ AD ʔ
သစ်သီး	θ ɪ AD ʔ θ i AD
သစ်သီးရည်	θ ɪ AD ʔ θ i AD j AB e AD
သဇင်	ð ə AD z ɪ AD ɴ
သဉ္ဇာ	θ ɪ AD ɴ z a AD
သဉ္ဇာလီ	θ ɪ AD ɴ z a AD l i AD
သည့်	θ ḭ
သည်	θ e AD
သည်မှာ	ð i AD m̥ a AD
သည်း	θ i AD
သည်းခြေ	θ i AD d ʑ e AD
သဏ္ဍာန်	θ ə AD d a AD ɴ
သတင်း	ð a̰ AG d ɪ AD ɴ
သတင်းစာ	ð ə AD d ɪ AD ɴ z a AD
သတင်းစာဆရာ	ð ə AD d ɪ AD ɴ z a AD sʰ ə AD j AB a AD
သတင်းပို့	ð ə AD d ɪ AD ɴ p o̰ AH
သတို့သမီး	ð ə AD d o̰ AH θ ə AD m i AD
သတို့သား	ð ə AD d o̰ AH θ a AD
သတ္တဗေဒ	θ a AD ʔ t a̰ AG b e AD d a̰ AG
သတ္တမ	θ a AD ʔ t ə AD m a̰ AG
သတ္တဝါ	θ a AD ʔ t ə AD w AC a AD
သတ္တိ	θ a AD ʔ t ḭ
သတ္တု	θ a AD ʔ t ṵ
သတ္တုစပ်	θ a AD ʔ t ṵ z a AD ʔ
သတ္တုတွင်း	θ a AD ʔ t ṵ d w AC ɪ AD ɴ
သတ္တုဗေဒ	θ a AD ʔ t ṵ b e AD d a̰ AG
သတ္တုရိုင်း	θ a AD ʔ t ṵ j AB a AD ɪ AD ɴ
သတ္ထန္တရကပ်	θ a AD ʔ tʰ a AD ɴ t ə AD ɹ AI a̰ AG k a AD ʔ
သတ်	θ a AD ʔ
သတ်ဖြတ်	θ a AD ʔ pʰ j AB a AD ʔ
သဒ္ဒဗေဒ	θ a AD ʔ d a̰ AG b e AD d a̰ AG
သဒ္ဒါ	ð ə AD d a AD
သဒ္ဒါဆယ်ပါး	ð ə AD d a AD sʰ ɛ AD b a AD
သဒ္ဓါ	θ a AD d d a AD
သဒ္ဓါကြေး	θ ə AD d a AD t ɕ e AD
သနပ်	θ ə AD n a AD ʔ
သနပ်ခါး	θ ə AD n ə AD kʰ a AD
သန္တာ	θ a AD ɴ d a AD
သန္ဓေ	θ a AD ɴ d e AD
သန္ဓေဗေဒ	θ a AD ɴ d e AD b e AD d a̰ AG
သန္ဓေသား	ð ə AD d e AD ð a AD
သန်ကောင်	θ a AD ɴ ɡ a AD ʊ AE ɴ
သန်တူ	θ a AD ɴ t u AE
သန်လျက်	θ a AD ɴ j AB ɛ AD ʔ
သန်လျင်	θ ə AD ɲ ɪ AD ɴ
သန်လျင်း	θ a AD ɴ l ə AD j AB ɪ AD ɴ
သန်လျင်းချိတ်	θ a AD ɴ j AB ɪ AD ɴ d ʑ e AD ɪ AD ʔ
သန်း	θ a AD ɴ
သန်းခေါင်	ð ə AD ɡ a AD ʊ AE ɴ
သပိတ်	ð ə AD b e AD ɪ AD ʔ
သပ်	θ a AD ʔ
သပြု	ð ə AD b j AB ṵ
သပြေ	ð ə AD b j AB e AD
သဘက်ခါ	θ ə AD b ɛ AD ʔ kʰ a AD
သဘာပတိ	θ ə AD b a AD p ə AD t ḭ
သဘာဝ	ð ə AD b a AD w AC a̰ AG
သဘာဝတ္ထဗေဒ	θ ə AD b a AD w AC ʊ AE ʔ tʰ a̰ AG b e AD d a̰ AG
သဘော	ð ə AD b ɔ AE
သဘောတူ	ð ə AD b ɔ AE t u AE
သမက်	θ ə AD m ɛ AD ʔ
သမဂ္ဂ	θ a̰ AG m ɛ AD ʔ ɡ a̰ AG
သမင်	θ ə AD m ɪ AD ɴ
သမင်မ	θ ə AD m ɪ AD ɴ m a̰ AG
သမာသမတ်	θ ə AD m a AD θ ə AD m a AD ʔ
သမား	θ ə AD m a AD
သမိန်	θ ə AD m e AD ɪ AD ɴ
သမိုင်း	θ ə AD m a AD ɪ AD ɴ
သမီး	θ ə AD m i AD
သမုဒ္ဒရာ	θ ə AD m o AE ʊ AE ʔ d ə AD j AB a AD
သမ္ဗန္ဓ	θ a AD ɴ b a AD ɴ d a̰ AG
သမ္မတ	θ ə AD m ə AD d a̰ AG
သမ္မတကတော်	θ ə AD m a̰ AG d a̰ AG ɡ ə AD d ɔ AE
သမ္မတနိုင်ငံ	θ ə AD m ə AD d a̰ AG n a AD ɪ AD ɴ ŋ a AD ɴ
သမ္မာကျမ်း	θ ə AD m a AD t ɕ a AD ɴ
သမ်း	θ a AD ɴ
သယ်	θ ɛ AD
သရ	θ ə AD ɹ AI a̰ AG
သရက်	θ ə AD j AB ɛ AD ʔ
သရက်ရွက်	θ ə AD j AB ɛ AD ʔ j AB w AC ɛ AD ʔ
သရက်သီးသနပ်	θ ə AD j AB ɛ AD ʔ θ i AD θ a̰ AG n a AD ʔ
သရဏဂုံသုံးပါး	θ ə AD j AB ə AD n ə AD ɡ o AE ʊ AE ɴ θ o AE ʊ AE ɴ b a AD
သရဏင်္ကရာ	θ ə AD ɹ AI ə AD n ɪ AD ɴ k ə AD ɹ AI a AD
သရဏင်္ကရာဘုရား	θ ə AD ɹ AI ə AD n ɪ AD ɴ k ə AD ɹ AI a AD pʰ ə AD j AB a AD
သရဖူ	θ ə AD ɹ AI ə AD pʰ u AE
သရီရ	θ ə AD ɹ AI i AD ɹ AI a̰ AG
သရုပ်	θ ə AD j AB o AE ʊ AE ʔ
သရုပ်ဆောင်	θ ə AD j AB o AE ʊ AE ʔ sʰ a AD ʊ AE ɴ
သရုပ်ဖော်	θ ə AD j AB o AE ʊ AE ʔ pʰ ɔ AE
သရဲ	θ ə AD j AB ɛ AD
သလား	θ a̰ AG l a AD
သလိပ်	θ ə AD l e AD ɪ AD ʔ
သလုံး	θ ə AD l o AE ʊ AE ɴ
သလဲသီး	θ ə AD l ɛ AD θ i AD
သလွဲ	θ ə AD l w AC ɛ AD
သဝဏ်လွှာ	θ ə AD w AC ʊ AE ɴ l̥ w AC a AD
သာဂူ	θ a AD ɡ u AE
သာဂူပြင်	θ a AD ɡ u AE b j AB ɪ AD ɴ
သာဓက	θ a AD d a̰ AG k a̰ AG
သာဓု	θ a AD d ṵ
သာမဏေ	θ a AD m ə AD n e AD
သာမိုမီတာ	θ a AD m o AE m i AD t a AD
သာယာဝတီ	θ a AD j AB a AD w AC ə AD d i AD
သာရိပုတ္တရာ	θ a AD j AB ḭ p o AE ʊ AE ʔ t ə AD j AB a AD
သာဝက	θ a AD w AC ə AD k a̰ AG
သာဝတ္ထိ	θ a AD w AC ʊ AE ʔ tʰ ḭ
သာသနာ	θ a AD ð ə AD n a AD
သာသနာ့အာဇာနည်	θ a AD θ ə AD n a̰ AG ʔ a AD z a AD n i AD
သား	θ a AD
သားကြီး	θ a AD d ʑ i AD
သားပိုက်ကောင်	θ a AD b a AD ɪ AD ʔ k a AD ʊ AE ɴ
သားမြီးယပ်	θ a AD m j AB i AD j AB a AD ʔ
သားရေ	θ ə AD j AB e AD
သားလောင်း	θ a AD l a AD ʊ AE ɴ
သားလှောင်	θ a AD l̥ a AD ʊ AE ɴ
သားသတ်ရုံ	θ a AD ð a AD ʔ j AB o AE ʊ AE ɴ
သားအိမ်	θ ə AD ʔ e AD ɪ AD ɴ
သားအိမ်ခေါင်း	θ ə AD ʔ e AD ɪ AD ɴ ɡ a AD ʊ AE ɴ
သားအိမ်လမ်းကြောင်း	θ ə AD ʔ e AD ɪ AD ɴ l a AD ɴ d ʑ a AD ʊ AE ɴ
သားဥ	θ a AD ʔ ṵ
သားဥအိမ်	θ a AD ʔ ṵ ʔ e AD ɪ AD ɴ
သိ	θ ḭ
သိက္ခါ	θ e AD ɪ AD ʔ kʰ a AD
သိကြား	ð ə AD d ʑ a AD
သိခီဘုရား	θ ḭ kʰ i AD pʰ ə AD j AB a AD
သိင်္ဂီ	θ e AD ɪ AD ɴ ɡ i AD
သိထိလ	θ ḭ tʰ ḭ l a̰ AG
သိဒ္ဓတ္ထ	θ e AD ɪ AD ʔ d a AD ʔ tʰ a̰ AG
သိဒ္ဓတ္ထဘုရား	θ i AD d d a AD ʔ tʰ a̰ AG pʰ ə AD j AB a AD
သိဒ္ဓတ်မင်း	θ e AD ɪ AD ʔ d a AD ʔ m ɪ AD ɴ
သိဒ္ဓိ	θ e AD ɪ AD ʔ d ḭ
သိန်း	θ e AD ɪ AD ɴ
သိပ္ပံ	θ e AD ɪ AD ʔ p a AD ɴ
သိပ္ပံဘွဲ့	θ e AD ɪ AD ʔ p a AD ɴ b w AC ɛ̰ AG
သိပ်	θ e AD ɪ AD ʔ
သိမ်	θ e AD ɪ AD ɴ
သိရှိ	θ ḭ ʃ ḭ
သိဝ	θ ḭ w AC a̰ AG
သိုက်	θ a AD ɪ AD ʔ
သို့ပေမဲ့	ð o̰ AH b e AD m ɛ̰ AG
သို့မဟုတ်	ð o̰ AH m ə AD h AA o AE ʊ AE ʔ
သို့ရာတွင်	ð o̰ AH j AB a AD d w AC ɪ AD ɴ
သို့သော်	ð o̰ AH ð ɔ AE
သိုး	θ o AE
သိုးဆောင်း	θ o AE sʰ a AD ʊ AE ɴ
သိုးထိန်း	θ o AE d e AD ɪ AD ɴ
သိုးထီး	θ o AE d i AD
သိုးမ	θ o AE m a̰ AG
သိုးမွေး	θ o AE m w AC e AD
သိုးအုပ်	θ o AE ʔ o AE ʊ AE ʔ
သီချင်း	θ ə AD t ɕʰ ɪ AD ɴ
သီဂိရိယ	θ i AD ɡ ḭ ɹ AI ḭ j AB a̰ AG
သီတဂူ	θ i AD d ə AD ɡ u AE
သီတင်း	ð ə AD d ɪ AD ɴ
သီတင်းကျွတ်	ð ə AD d ɪ AD ɴ d ʑ ʊ AE ʔ
သီတင်းသီလ	ð ə AD d ɪ AD ɴ θ i AD l a̰ AG
သီတာ	θ i AD d a AD
သီတာဒေဝီ	θ i AD d a AD d e AD w AC i AD
သီရိ	θ i AD ɹ AI ḭ
သီရိလင်္ကာ	θ i AD ɹ AI ḭ l ɪ AD ɴ k a AD
သီလ	θ i AD l a̰ AG
သီလရှင်	θ i AD l a̰ AG ʃ ɪ AD ɴ
သီဟ	θ i AD h AA a̰ AG
သီဟိုဠ်	θ i AD h AA o AE
သီဟိုဠ်သရက်	θ i AD h AA o AE θ ə AD j AB ɛ AD ʔ
သီအိုရီ	θ i AD ʔ o AE ɹ AI i AD
သီး	θ i AD
သီးစုံချဉ်ရည်	θ i AD z o AE ʊ AE ɴ t ɕʰ ɪ AD ɴ j AB i AD
သီးပင်	θ i AD b ɪ AD ɴ
သီးသီး	θ i AD ð i AD
သု	θ ṵ
သုက်	θ o AE ʊ AE ʔ
သုက်ကောင်	θ o AE ʊ AE ʔ k a AD ʊ AE ɴ
သုက်ပိုး	θ o AE ʊ AE ʔ p o AE
သုက်ရည်	θ o AE ʊ AE ʔ j AB e AD
သုခ	θ ṵ kʰ a̰ AG
သုခေါဒယ	θ ṵ kʰ ɔ AE d ə AD j AB a̰ AG
သုဇာတဘုရား	θ ṵ z a AD t a̰ AG pʰ ə AD j AB a AD
သုည	θ o AE ʊ AE ɴ ɲ a̰ AG
သုတ	θ ṵ t a̰ AG
သုတေသန	θ ṵ t e AD θ ə AD n a̰ AG
သုတေသီ	θ ṵ t e AD θ i AD
သုတ်	θ o AE ʊ AE ʔ
သုဒ္ဒ	θ o AE ʊ AE ʔ d a̰ AG
သုဒ္ဒကိန်း	θ o AE ʊ AE ʔ d a̰ AG k e AD ɪ AD ɴ
သုဒ္ဒကြိယာ	θ o AE ʊ AE ʔ d a̰ AG k ə AD ɹ AI ḭ j AB a AD
သုဒ္ဓေါဒန	θ u AE d d ɔ AE d ə AD n a̰ AG
သုဓမ္မပူရ	θ ṵ d ə AD m a̰ AG p u AE ɹ AI a̰ AG
သုဓမ္မသိင်္ဂီ	θ ṵ d a AD ɴ m a̰ AG θ e AD ɪ AD ɴ ɡ i AD
သုဓာ	θ o AE ʊ AE ʔ d a AD
သုပ်	θ o AE ʊ AE ʔ
သုမန	θ ṵ m ə AD n a̰ AG
သုမနဘုရား	θ ṵ m ə AD n a̰ AG pʰ ə AD j AB a AD
သုမေဓာ	θ ṵ m e AD d a AD
သုမေဓာဘုရား	θ ṵ m e AD d a AD pʰ ə AD j AB a AD
သုဝဏ္ဏ	θ ṵ w AC ʊ AE ɴ n a̰ AG
သုသာန်	θ o AE ʊ AE ʔ θ a AD ɴ
သုံး	θ o AE ʊ AE ɴ
သုံးဆယ်	θ o AE ʊ AE ɴ sʰ ɛ AD
သုံးဆောင်	θ o AE ʊ AE ɴ sʰ a AD ʊ AE ɴ
သုံးလ	θ o AE ʊ AE ɴ l a̰ AG
သူ	θ u AE
သူကောင်	θ u AE ɡ a AD ʊ AE ɴ
သူကောင်တင်	θ u AE ɡ a AD ʊ AE ɴ d ɪ AD ɴ
သူကောင်း	θ u AE ɡ a AD ʊ AE ɴ
သူကောင်းပြု	θ u AE ɡ a AD ʊ AE ɴ p j AB ṵ
သူကောင်းမြှောက်	θ u AE ɡ a AD ʊ AE ɴ m̥ j AB a AD ʊ AE ʔ
သူကောင်းသား	θ u AE ɡ a AD ʊ AE ɴ ð a AD
သူကျက်	θ u AE d ʑ ɛ AD ʔ
သူကြီး	θ u AE d ʑ i AD
သူကြွယ်	θ u AE t ɕ w AC ɛ AD
သူခိုး	θ ə AD kʰ o AE
သူငယ်	θ ə AD ŋ ɛ AD
သူငယ်ချင်း	θ ə AD ŋ ɛ AD d ʑ ɪ AD ɴ
သူငယ်တန်း	θ u AE ŋ ɛ AD d a AD ɴ
သူငယ်မ	θ ə AD ŋ ɛ AD m a̰ AG
သူစိမ်း	ð ə AD z e AD ɪ AD ɴ
သူစိမ်းတစ်ရံဆံ	ð ə AD z e AD ɪ AD ɴ t ə AD j AB a AD ɴ z a AD ɴ
သူဆင်းရဲ	θ u AE sʰ ɪ AD ɴ j AB ɛ AD
သူဇာ	θ u AE z a AD
သူဌေး	θ ə AD tʰ e AD
သူတကာ	θ u AE d ə AD ɡ a AD
သူတစ်ခွန်းငါတစ်ခွန်း	θ u AE t ə AD kʰ ʊ AE ɴ ŋ a AD t ə AD kʰ ʊ AE ɴ
သူတစ်ထူး	θ u AE t ə AD tʰ u AE
သူတစ်ပါး	θ u AE d ə AD b a AD
သူတစ်ပြန်ငါတစ်ပြန်	θ u AE d ə AD b j AB a AD ɴ ŋ a AD d ə AD b j AB a AD ɴ
သူတစ်လူငါတစ်မင်း	θ u AE t ə AD l u AE ŋ a AD t ə AD m ɪ AD ɴ
သူတို့	θ u AE d o̰ AH
သူတောင်းစား	ð ə AD d a AD ʊ AE ɴ z a AD
သူတော်	θ u AE d ɔ AE
သူတော်ကောင်း	θ u AE d ɔ AE ɡ a AD ʊ AE ɴ
သူတော်စင်	θ u AE d ɔ AE z ɪ AD ɴ
သူတော်သူမြတ်	θ u AE d ɔ AE θ u AE m j AB a AD ʔ
သူနာ	θ u AE n a AD
သူနာတင်ကား	θ u AE n a AD t ɪ AD ɴ k a AD
သူနာတင်ယာဉ်	θ u AE n a AD t ɪ AD ɴ j AB ɪ AD ɴ
သူနာပြု	θ u AE n a AD b j AB ṵ
သူနိုင်ငါညှဉ်းလုပ်	θ u AE n a AD ɪ AD ɴ ŋ a AD ɲ̊ ɪ AD ɴ l o AE ʊ AE ʔ
သူပုန်	ð ə AD b o AE ʊ AE ɴ
သူပုန်ထ	ð ə AD b o AE ʊ AE ɴ tʰ a̰ AG
သူပုန်သူကန်	ð ə AD b ə AD ð u AE ɡ a AD ɴ
သူပြောငါပြော	θ u AE p j AB ɔ AE ŋ a AD p j AB ɔ AE
သူဖုန်းစား	θ u AE pʰ o AE ʊ AE ɴ s a AD
သူမ	θ u AE m a̰ AG
သူမသာကိုယ်မသာ	θ u AE m ə AD θ a AD k o AE j AB m ə AD θ a AD
သူမသာငါမသာ	θ u AE m ə AD θ a AD ŋ a AD m ə AD θ a AD
သူမိုက်	θ u AE m a AD ɪ AD ʔ
သူများ	θ u AE m j AB a AD
သူများနည်းတူ	θ u AE m j AB a AD n i AD t u AE
သူယုတ်မာ	θ u AE j AB o AE ʊ AE ʔ m a AD
သူယောင်	θ u AE j AB a AD ʊ AE ɴ
သူယောင်မယ်	θ u AE j AB a AD ʊ AE ɴ m ɛ AD
သူရ	θ u AE j AB a̰ AG
သူရကန်	θ u AE ɹ AI ə AD k a AD ɴ
သူရင်းငှား	θ ə AD j AB ɪ AD ɴ ŋ̊ a AD
သူရင်းတိုင်	θ ə AD j AB ɪ AD ɴ d a AD ɪ AD ɴ
သူရသတ္တိ	θ u AE j AB a̰ AG θ a AD ʔ t ḭ
သူရိန်	θ u AE j AB e AD ɪ AD ɴ
သူရိယမာသ	θ u AE ɹ AI ḭ j AB a̰ AG m a AD θ a̰ AG
သူရဲ	θ ə AD j AB ɛ AD
သူရဲကောင်း	θ u AE j AB ɛ AD ɡ a AD ʊ AE ɴ
သူရဲကြီး	θ u AE j AB ɛ AD d ʑ i AD
သူရဲကြီးအလံ	θ u AE j AB ɛ AD d ʑ i AD ʔ ə AD l a AD ɴ
သူရဲခို	θ ə AD j AB ɛ AD kʰ o AE
သူရဲပြေး	θ ə AD j AB ɛ AD p j AB e AD
သူရဲဘောကြောင်	θ ə AD j AB ɛ AD b ɔ AE d ʑ a AD ʊ AE ɴ
သူရဲဘောနည်း	θ ə AD j AB ɛ AD b ɔ AE n i AD
သူရဿတီ	θ u AE ɹ AI a̰ AG θ ə AD t i AD
သူလိုငါလို	θ u AE l o AE ŋ a AD l o AE
သူလျှို	ð ə AD ʃ o AE
သူသူငါငါ	θ u AE θ u AE ŋ a AD ŋ a AD
သူသေ	θ u AE θ e AD
သူဟောင်းစကား	θ u AE h AA a AD ʊ AE ɴ z ə AD ɡ a AD
သူအို	θ u AE ʔ o AE
သူ့	θ ṵ
သေ	θ e AD
သေခြင်း	θ e AD d ʑ ɪ AD ɴ
သေတ္တာ	θ ɪ AD ʔ t a AD
သေနတ်	θ ə AD n a AD ʔ
သော	θ ɔ AE
သောက္ကတဲ	θ a AD ʊ AE ʔ k ə AD t ɛ AD
သောက်	θ a AD ʊ AE ʔ
သောကြာ	θ a AD ʊ AE ʔ t ɕ a AD
သောကြာဂြိုဟ်	θ a AD ʊ AE ʔ t ɕ a AD d ʑ o AE
သောင်း	θ a AD ʊ AE ɴ
သောင်းသောင်း	θ a AD ʊ AE ɴ ð a AD ʊ AE ɴ
သောဘိတ	θ ɔ AE b ḭ t a̰ AG
သောဘိတဘုရား	θ ɔ AE b ḭ t a̰ AG pʰ ə AD j AB a AD
သောမနဿ	θ ɔ AE m ə AD n a AD ʔ θ a̰ AG
သောသော	θ ɔ AE ð ɔ AE
သော့	θ ɔ̰ AH
သော့တံ	θ ɔ̰ AH d a AD ɴ
သော်	ð ɔ AE
သော်တာ	θ ɔ AE d a AD
သေး	θ e AD
သဲ	θ ɛ AD
သဲကန္တာရ	θ e AD ɡ a AD ɴ d a AD j AB a̰ AG
သဲကျောက်	θ ɛ AD d ʑ a AD ʊ AE ʔ
သဲ့သဲ့	θ ɛ̰ AG ð ɛ̰ AG
သံ	θ a AD ɴ
သံကြိုး	θ a AD ɴ d ʑ o AE
သံကြိုးစာ	θ a AD ɴ d ʑ o AE z a AD
သံကြွပ်	θ a AD ɴ d ʑ ʊ AE ʔ
သံချပ်	θ ə AD d ʑ a AD ʔ
သံချေး	θ a AD ɴ d ʑ i AD
သံခွာ	θ a AD ɴ kʰ w AC a AD
သံဃာ	θ a AD ɴ ɡ a AD
သံစုံတီးဝိုင်း	θ a AD ɴ z o AE ʊ AE ɴ t i AD w AC a AD ɪ AD ɴ
သံတမန်	θ a AD ɴ t ə AD m a AD ɴ
သံတော်ဆင့်	θ a AD ɴ d ɔ AE z ɪ̰ AG ɴ
သံတွဲ	θ a AD ɴ d w AC ɛ AD
သံပန်း	θ a AD ɴ b a AD ɴ
သံပရာ	θ a AD ɴ b ə AD j AB a AD
သံပရို	θ a AD ɴ b a̰ AG j AB o AE
သံပေါက်	θ a AD ɴ b a AD ʊ AE ʔ
သံပြိုင်	θ a AD ɴ b j AB a AD ɪ AD ɴ
သံဖြူ	θ a AD ɴ b j AB u AE
သံမဏိ	θ a AD ɴ m ə AD n ḭ
သံရုံး	θ a AD ɴ j AB o AE ʊ AE ɴ
သံလမ်း	θ a AD ɴ l a AD ɴ
သံလမ်းရထား	θ a AD ɴ l a AD ɴ j AB ə AD tʰ a AD
သံလိုက်	θ a AD ɴ l a AD ɪ AD ʔ
သံလိုက်စက်ကွင်း	θ a AD ɴ l a AD ɪ AD ʔ s ɛ AD ʔ k w AC ɪ AD ɴ
သံလွင်	θ a AD ɴ l w AC ɪ AD ɴ
သံဝါသ	θ a AD ɴ w AC a AD θ a̰ AG
သံသယ	θ a AD ɴ θ ə AD j AB a̰ AG
သံအမတ်	θ a AD ɴ ʔ ə AD m a AD ʔ
သံ့သံ့	θ a̰ AG ɴ ð a̰ AG ɴ
သျှင်	ʃ ɪ AD ɴ
သျှမ်း	ʃ a AD ɴ
သျှောင်	j AB a AD ʊ AE ɴ
သွင်သွင်	θ w AC ɪ AD ɴ ð w AC ɪ AD ɴ
သွင်း	θ w AC ɪ AD ɴ
သွတ်သွတ်	θ ʊ AE ʔ θ ʊ AE ʔ
သွန်းသွန်း	θ ʊ AE ɴ ð ʊ AE ɴ
သွပ်	θ ʊ AE ʔ
သွား	θ w AC a AD
သွားကြားထိုးတံ	θ w AC a AD d ʑ a AD tʰ o AE d a AD ɴ
သွားတိုက်ဆေး	θ w AC a AD d a AD ɪ AD ʔ sʰ e AD
သွားပွတ်တံ	ð ə AD b ʊ AE ʔ t a AD ɴ
သွားဖုံး	θ ə AD pʰ o AE ʊ AE ɴ
သွားရည်	θ ə AD j AB i AD
သွေ	θ w AC e AD
သွေး	θ w AC e AD
သွေးကြော	θ w AC e AD d ʑ ɔ AE
သွေးတိုးရောဂါ	θ w AC e AD t o AE j AB ɔ AE ɡ a AD
သွေးပေါ်	θ w AC e AD p ɔ AE
သွေးအုပ်စု	θ w AC e AD ʔ o AE ʊ AE ʔ s ṵ
ဟ	h AA a̰ AG
ဟင့်အင်း	h AA ɪ̰ AG ɴ ʔ ɪ AD ɴ
ဟင်း	h AA ɪ AD ɴ
ဟင်းခါး	h AA ɪ AD ɴ ɡ a AD
ဟင်းရည်	h AA ɪ AD ɴ j AB e AD
ဟင်းသီးဟင်းရွက်	h AA ɪ AD ɴ ð i AD h AA ɪ AD ɴ j AB w AC ɛ AD ʔ
ဟင်္သာ	h AA ɪ AD ɴ θ a AD
ဟင်္သာတ	h AA ɪ AD ɴ θ ə AD t a̰ AG
ဟထိုး	h AA a̰ AG tʰ o AE
ဟနူမာန်	h AA ə AD n u AE m a AD n
ဟန်ဂေရီ	h AA a AD ɴ ɡ e AD ɹ AI i AD
ဟန်နီ	h AA a AD ɴ n i AD
ဟမ်ဘာဂါ	h AA a AD ɴ b a AD ɡ a AD
ဟယ်လီကော့ပတာ	h AA ɛ AD l i AD k ɔ̰ AH p ə AD t a AD
ဟရိဘုဉ္ဇ	h AA ə AD ɹ AI ḭ b o AE ʊ AE ɴ z a̰ AG
ဟလဝါ	h AA a̰ AG l ə AD w AC a AD
ဟာနွိုင်း	h AA a AD n w AC a AD ɪ AD ɴ
ဟာသ	h AA a AD θ a̰ AG
ဟားခါး	h AA a AD kʰ a AD
ဟိတ်	h AA e AD ɪ AD ʔ
ဟိန္ဒီ	h AA e AD ɪ AD ɴ d i AD
ဟိန္ဒူ	h AA e AD ɪ AD ɴ d u AE
ဟိမဝန္တာ	h AA ḭ m a̰ AG w AC ʊ AE ɴ t a AD
ဟိမာလယ	h AA ḭ m a AD l ə AD j AB a̰ AG
ဟို	h AA o AE
ဟိုက်ဒရိုဂျင်	h AA a AD ɪ AD ʔ d ə AD ɹ AI o AE d ʑ ɪ AD ɴ
ဟိုင်းအီနာ	h AA a AD ɪ AD ɴ ʔ i AD n a AD
ဟိုတယ်	h AA o AE t ɛ AD
ဟိုမှာ	h AA o AE m̥ a AD
ဟိုဟာ	h AA o AE h AA a AD
ဟီ	h AA i AD
ဟီနယာန	h AA i AD n a̰ AG j AB a AD n a̰ AG
ဟီလီယမ်	h AA i AD l i AD j AB a AD ɴ
ဟုတ်	h AA o AE ʊ AE ʔ
ဟုတ်ကဲ့	h AA o AE ʊ AE ʔ k ɛ̰ AG
ဟုတ်တာပေါ့	h AA o AE ʊ AE ʔ t a AD p ɔ̰ AH
ဟူ	h AA u AE
ဟူးရား	h AA u AE j AB a AD
ဟူးဟူး	h AA u AE h AA u AE
ဟေတီ	h AA e AD t i AD
ဟေမန္တ	h AA e AD m a AD ɴ t a̰ AG
ဟေမန်	h AA e AD m a AD ɴ
ဟေမာ	h AA e AD m a AD
ဟော	h AA ɔ AE
ဟောက်	h AA a AD ʊ AE ʔ
ဟောင်ကောင်	h AA a AD ʊ AE ɴ k a AD ʊ AE ɴ
ဟောင်း	h AA a AD ʊ AE ɴ
ဟော်	h AA ɔ AE
ဟော်ကီ	h AA ɔ AE k i AD
ဟော်တယ်	h AA ɔ AE t ɛ AD
ဟော်လန်	h AA ɔ AE l a AD ɴ
ဟဲလို	h AA ɛ AD l o AE
ဟွန်ဒူးရပ်စ်	h AA ʊ AE ɴ d u AE ɹ AI a AD ʔ s
ဠ	l a̰ AG
ဠကြီး	l a̰ AG t ɕ i AD
အ	ʔ a̰ AG
အက	ʔ ə AD k a̰ AG
အကယ်၍	ʔ ə AD k ɛ AD j AB w AC ḛ
အကာ	ʔ ə AD k a AD
အကိတ်	ʔ ə AD k e AD ɪ AD ʔ
အကို	ʔ ə AD k o AE
အကိုင်း	ʔ ə AD k a AD ɪ AD ɴ
အကုန်	ʔ ə AD k o AE ʊ AE ɴ
အကူ	ʔ ə AD k u AE
အကောက်	ʔ ə AD k a AD ʊ AE ʔ
အကောက်ဆိပ်	ʔ ə AD k a AD ʊ AE ʔ sʰ e AD ɪ AD ʔ
အကောင့်	ʔ ə AD k a̰ AG ʊ AE ɴ
အကော်ဒီယံ	ʔ ə AD k ɔ AE d i AD j AB a AD ɴ
အက္ခရာ	ʔ ɛ AD ʔ kʰ ə AD j AB a AD
အက်	ʔ ɛ AD ʔ
အက်စစ်	ʔ ɛ AD ʔ s ɪ AD ʔ
အက်စတိုးနီးယား	ʔ ɛ AD ʔ s ə AD t o AE n i AD j AB a AD
အက်တမ်	ʔ ɛ AD ʔ t a AD ɴ
အကျဉ်း	ʔ ə AD t ɕ ɪ AD ɴ
အကျဉ်းထောင်	ʔ ə AD t ɕ ɪ AD ɴ d a AD ʊ AE ɴ
အကျည်း	ʔ ə AD t ɕ i AD
အကျည်းတန်	ʔ ə AD t ɕ i AD t a AD ɴ
အကျယ်	ʔ ə AD t ɕ ɛ AD
အကျိတ်	ʔ ə AD t ɕ e AD ɪ AD ʔ
အကျိုး	ʔ ə AD t ɕ o AE
အကျော်	ʔ ə AD t ɕ ɔ AE
အကျော်ဇေယျ	ʔ ə AD t ɕ ɔ AE z e AD j AB a̰ AG
အကြမ်းဖက်ဝါဒ	ʔ ə AD t ɕ a AD ɴ pʰ ɛ AD ʔ w AC a AD d a̰ AG
အကြမ်းဖက်သမား	ʔ ə AD t ɕ a AD ɴ pʰ ɛ AD ʔ θ ə AD m a AD
အကြောင်း	ʔ ə AD t ɕ a AD ʊ AE ɴ
အကြော်	ʔ a̰ AG t ɕ ɔ AE
အကြေး	ʔ ə AD t ɕ e AD
အကြံ	ʔ ə AD t ɕ a AD ɴ
အကြံပေးချက်	ʔ ə AD t ɕ a AD ɴ p e AD d ʑ ɛ AD ʔ
အကြွေး	ʔ ə AD t ɕ w AC e AD
အကြွေးဝယ်ကတ်ပြား	ʔ ə AD t ɕ w AC e AD w AC ɛ AD k a AD ʔ p j AB a AD
အကွ	ʔ ə AD k w AC a̰ AG
အကွာအဝေး	ʔ ə AD k w AC a AD ʔ ə AD w AC e AD
အခန်း	ʔ ə AD kʰ a AD ɴ
အခမဲ့	ʔ ə AD kʰ a̰ AG m ɛ̰ AG
အခါတစ်ပါး	ʔ ə AD kʰ a AD d ə AD b a AD
အခိုး	ʔ ə AD kʰ o AE
အခု	ʔ ə AD kʰ ṵ
အခေါက်	ʔ ə AD kʰ a AD ʊ AE ʔ
အချက်	ʔ ə AD t ɕʰ ɛ AD ʔ
အချင်း	ʔ ə AD t ɕʰ ɪ AD ɴ
အချင်းဝက်	ʔ ə AD t ɕʰ ɪ AD ɴ w AC ɛ AD ʔ
အချစ်	ʔ ə AD t ɕʰ ɪ AD ʔ
အချပ်	ʔ ə AD t ɕʰ a AD ʔ
အချိတ်	ʔ ə AD t ɕʰ e AD ɪ AD ʔ
အချိန်	ʔ ə AD t ɕʰ e AD ɪ AD ɴ
အချိန်စာရင်း	ʔ ə AD t ɕʰ e AD ɪ AD ɴ s ə AD j AB ɪ AD ɴ
အချို	ʔ ə AD t ɕʰ o AE
အချိုပွဲ	ʔ ə AD t ɕʰ o AE b w AC ɛ AD
အချိုမှုန့်	ʔ ə AD t ɕʰ o AE m̥ o̰ AH ʊ AE ɴ
အချို့	ʔ ə AD t ɕʰ o̰ AH
အချိုး	ʔ ə AD t ɕʰ o AE
အချုပ်ခန်း	ʔ ə AD t ɕʰ o AE ʊ AE ʔ kʰ a AD ɴ
အချုပ်အခြာအာဏာ	ʔ ə AD t ɕʰ o AE ʊ AE ʔ ʔ ə AD t ɕʰ a AD ʔ a AD n a AD
အချွဲ	ʔ ə AD t ɕʰ w AC ɛ AD
အခြား	ʔ ə AD t ɕʰ a AD
အခြေ	ʔ ə AD t ɕʰ e AD
အခြောက်	ʔ ə AD t ɕʰ a AD ʊ AE ʔ
အခွင့်	ʔ ə AD kʰ w AC ɪ̰ AG ɴ
အခွင့်ထူးခံ	ʔ ə AD kʰ w AC ɪ̰ AG ɴ tʰ u AE ɡ a AD ɴ
အခွင့်အရေး	ʔ ə AD kʰ w AC ɪ̰ AG ɴ ʔ ə AD j AB e AD
အခွန်	ʔ ə AD kʰ ʊ AE ɴ
အခွံ	ʔ ə AD kʰ ʊ AE ɴ
အခွံမာသီး	ʔ ə AD kʰ ʊ AE ɴ m a AD ð i AD
အဂတိ	ʔ a̰ AG ɡ ə AD d ḭ
အဂ္ဂမဟာပဏ္ဍိတ	ʔ ɛ AD ʔ ɡ a̰ AG m ə AD h AA a AD p a AD ɴ d ḭ t a̰ AG
အဂ္ဂမဟာသေနာပတိ	ʔ ɛ AD ʔ ɡ a̰ AG m ə AD h AA a AD θ e AD n a AD p ə AD t ḭ
အဂ္ဂမဟေသီ	ʔ ɛ AD ʔ ɡ a̰ AG m ə AD h AA e AD θ i AD
အငတ်	ʔ ə AD ŋ a AD ʔ
အင်ဂိုလာ	ʔ ɪ AD ɴ ɡ o AE l a AD
အင်ဂျင်	ʔ ɪ AD ɴ d ʑ ɪ AD ɴ
အင်ဂျင်နီယာ	ʔ ɪ AD ɴ d ʑ ɪ AD ɴ n i AD j AB a AD
အင်တာနက်	ʔ ɪ AD ɴ t a AD n ɛ AD ʔ
အင်တာဗျူး	ʔ ɪ AD ɴ t ə AD b j AB u AE
အင်ဒိုချိုင်းနား	ʔ ɪ AD ɴ d o AE t ɕʰ a AD ɪ AD ɴ n a AD
အင်ဒိုနီးရှား	ʔ ɪ AD ɴ d o AE n i AD ʃ a AD
အင်ဒိုရာ	ʔ ɪ AD ɴ d o AE ɹ AI a AD
အင်ပါယာ	ʔ ɪ AD ɴ p a AD j AB a AD
အင်း	ʔ ɪ AD ɴ
အင်းကျီ	ʔ ɪ AD ɴ d ʑ i AD
အင်းစိန်	ʔ ɪ AD ɴ s e AD ɪ AD ɴ
အင်းဆက်	ʔ ɪ AD ɴ sʰ ɛ AD ʔ
အင်းဝ	ʔ ɪ AD ɴ w AC a̰ AG
အင်းသား	ʔ ɪ AD ɴ ð a AD
အင်္ကျီ	ʔ ɪ AD ɴ d ʑ i AD
အင်္ဂတေ	ʔ ɪ AD ɴ ɡ ə AD d e AD
အင်္ဂလန်	ʔ ɪ AD ɴ ɡ ə AD l a AD ɴ
အင်္ဂလိပ်	ʔ ɪ AD ɴ ɡ ə AD l e AD ɪ AD ʔ
အင်္ဂါ	ʔ ɪ AD ɴ ɡ a AD
အင်္ဂါဇာတ်	ʔ ɪ AD ɴ ɡ a AD z a AD ʔ
အငြိမ့်	ʔ ə AD ɲ ḛ ɪ AD ɴ
အငြိမ့်တီးမျိုး	ʔ a̰ AG ɲ ḛ ɪ AD ɴ t i AD m j AB o AE
အငွေ့	ʔ a̰ AG ŋ w AC ḛ
အစ	ʔ ə AD s a̰ AG
အစက်	ʔ ə AD s ɛ AD ʔ
အစဉ်	ʔ ə AD s ɪ AD ɴ
အစည်းအရုံး	ʔ ə AD s i AD ʔ ə AD j AB o AE ʊ AE ɴ
အစည်းအဝေး	ʔ ə AD s i AD ʔ ə AD w AC e AD
အစမ်း	ʔ ə AD s a AD ɴ
အစား	ʔ ə AD s a AD
အစားအစာ	ʔ ə AD s a AD ʔ ə AD s a AD
အစိမ်း	ʔ ə AD s e AD ɪ AD ɴ
အစိုးရ	ʔ ə AD s o AE j AB a̰ AG
အစီရင်	ʔ ə AD s i AD j AB ɪ AD ɴ
အစီရင်ခံ	ʔ ə AD s i AD j AB ɪ AD ɴ kʰ a AD ɴ
အစီရင်ခံစာ	ʔ ə AD s i AD j AB ɪ AD ɴ kʰ a AD ɴ z a AD
အစီအစဉ်	ʔ ə AD s i AD ʔ ə AD s ɪ AD ɴ
အစီအလျဉ်	ʔ ə AD s i AD ʔ ə AD l j AB ɪ AD ɴ
အစု	ʔ ə AD s ṵ
အစုရှင်	ʔ ə AD s ṵ ʃ ɪ AD ɴ
အစုံအစုံ	ʔ ə AD s o AE ʊ AE ɴ ʔ ə AD s o AE ʊ AE ɴ
အစေအပါး	ʔ ə AD s e AD ʔ ə AD p a AD
အစောင့်	ʔ ə AD s a̰ AG ʊ AE ɴ
အစေ့	ʔ ə AD s ḭ
အစ္စရေး	ʔ ɪ AD ʔ z ə AD ɹ AI e AD
အစ္စလမ်	ʔ ɪ AD ʔ s ə AD l a AD ɴ
အစ်	ʔ ɪ AD ʔ
အစ်ကို	ʔ ə AD k o AE
အစ်မ	ʔ ə AD m a̰ AG
အစွန်း	ʔ ə AD s ʊ AE ɴ
အဆင့်	ʔ ə AD sʰ ɪ̰ AG ɴ
အဆန်	ʔ ə AD sʰ a AD ɴ
အဆိပ်	ʔ ə AD sʰ e AD ɪ AD ʔ
အဆိုတော်	ʔ ə AD sʰ o AE d ɔ AE
အဆီ	ʔ ə AD sʰ i AD
အဆုတ်	ʔ ə AD sʰ o AE ʊ AE ʔ
အဆုတ်ရောင်ရောဂါ	ʔ a̰ AG sʰ o AE ʊ AE ʔ j AB a AD ʊ AE ɴ j AB ɔ AE ɡ a AD
အဆုံး	ʔ ə AD sʰ o AE ʊ AE ɴ
အဆောက်အအုံ	ʔ ə AD sʰ a AD ʊ AE ʔ ʔ ə AD ʔ u AE
အဆောက်အဦ	ʔ ə AD sʰ a AD ʊ AE ʔ ʔ ə AD ʔ u AE
အဆောင်	ʔ ə AD sʰ a AD ʊ AE ɴ
အဆွေး	ʔ ə AD sʰ w AC e AD
အဇာဘိုင်ဂျန်	ʔ a̰ AG z ə AD b a AD ɪ AD ɴ d ʑ a AD ɴ
အဉ္ဇလီ	ʔ ɪ AD ɴ z ə AD l i AD
အညစ်အကြေး	ʔ ə AD ɲ ɪ AD ʔ ʔ ə AD t ɕ e AD
အညစ်အထည်း	ʔ ə AD ɲ ɪ AD ʔ ʔ ə AD tʰ i AD
အညာသား	ʔ ə AD ɲ a AD ð a AD
အညို	ʔ ə AD ɲ o AE
အညီ	ʔ ə AD ɲ i AD
အဋ္ဌမ	ʔ a AD ʔ tʰ ə AD m a̰ AG
အဏုဇီဝဗေဒ	ʔ ə AD n ṵ z i AD w AC a̰ AG b e AD d a̰ AG
အဏ္ဏဝါ	ʔ a AD ɴ n ə AD w AC a AD
အဏ္ဏဝါဗေဒ	ʔ a AD n n ə AD w AC a AD b e AD d a̰ AG
အတင်း	ʔ ə AD t ɪ AD ɴ
အတန်း	ʔ ə AD t a AD ɴ
အတာ	ʔ ə AD t a AD
အတာအိုး	ʔ ə AD t a AD ʔ o AE
အတိတ်	ʔ ə AD t e AD ɪ AD ʔ
အတိုင်ပင်ခံ	ʔ ə AD t a AD ɪ AD ɴ b ɪ AD ɴ ɡ a AD ɴ
အတိုင်း	ʔ ə AD t a AD ɪ AD ɴ
အတိုး	ʔ ə AD t o AE
အတီမျှ	ʔ ə AD t i AD m̥ j AB a̰ AG
အတူ	ʔ ə AD t u AE
အတူတူ	ʔ ə AD t u AE d u AE
အတောင်	ʔ ə AD t a AD ʊ AE ɴ
အတ္တဒဿီ	ʔ a AD ʔ t a̰ AG d a AD ʔ θ i AD
အတ္တဒဿီဘုရား	ʔ a AD ʔ t a̰ AG d ə AD t θ i AD pʰ ə AD j AB a AD
အတွင်း	ʔ ə AD t w AC ɪ AD ɴ
အတွင်းခံ	ʔ ə AD t w AC ɪ AD ɴ ɡ a AD ɴ
အတွင်းစကား	ʔ ə AD t w AC ɪ AD ɴ z ə AD ɡ a AD
အတွင်းတာရာ	ʔ ə AD t w AC ɪ AD ɴ t a AD j AB a AD
အတွင်းရန်	ʔ ə AD t w AC ɪ AD ɴ j AB a AD ɴ
အတွင်းဝန်	ʔ ə AD t w AC ɪ AD ɴ w AC ʊ AE ɴ
အတွဲ	ʔ ə AD t w AC ɛ AD
အထက်	ʔ ə AD tʰ ɛ AD ʔ
အထက်လွှတ်တော်	ʔ ə AD tʰ ɛ AD ʔ l̥ ʊ AE ʔ t ɔ AE
အထက်သား	ʔ ə AD tʰ ɛ AD ʔ ð a AD
အထင်	ʔ ə AD tʰ ɪ AD ɴ
အထပ်	ʔ ə AD tʰ a AD ʔ
အထိ	ʔ ə AD tʰ ḭ
အထိန်း	ʔ ə AD tʰ e AD ɪ AD ɴ
အထိမ်းအမှတ်	ʔ ə AD tʰ e AD ɪ AD ɴ ʔ ə AD m̥ a AD ʔ
အထီး	ʔ ə AD tʰ i AD
အထုပ်	ʔ ə AD tʰ o AE ʊ AE ʔ
အထုံးအဖွဲ့	ʔ ə AD tʰ o AE ʊ AE ɴ ʔ ə AD pʰ w AC ɛ̰ AG
အထဲ	ʔ ə AD tʰ ɛ AD
အဓမ္မ	ʔ ə AD d ə AD m a̰ AG
အဓိက	ʔ a̰ AG d ḭ ɡ a̰ AG
အဓိကရုဏ်း​	ʔ ə AD d ḭ k a̰ AG j AB o AE ʊ AE ɴ
အဓိဌာန်	ʔ ə AD d e AD ɪ AD ʔ tʰ a AD ɴ
အဓိပ္ပါယ်	ʔ ə AD d e AD ɪ AD ʔ b ɛ AD
အနက်	ʔ ə AD n ɛ AD ʔ
အနန္တ	ʔ ə AD n a AD ɴ d a̰ AG
အနန္တောအနန္တငါးပါး	ʔ ə AD n a AD ɴ d ɔ AE ʔ ə AD n d a̰ AG ŋ a AD p a AD
အနာကြီးရောဂါ	ʔ ə AD n a AD d ʑ i AD j AB ɔ AE ɡ a AD
အနာဂတ်	ʔ ə AD n a AD ɡ a AD ʔ
အနား	ʔ ə AD n a AD
အနားယူ	ʔ ə AD n a AD j AB u AE
အနိစ္စ	ʔ ə AD n e AD s s a̰ AG
အနို့	ʔ ə AD n o̰ AH
အနီ	ʔ ə AD n i AD
အနုတ်လက္ခဏာ	ʔ ə AD n̥ o AE ʊ AE ʔ l ɛ AD ʔ kʰ ə AD n a AD
အနုပညာ	ʔ ə AD n ṵ p j AB ɪ AD ɴ ɲ a AD
အနုရာဓပူရ	ʔ ə AD n ṵ j AB a AD d a̰ AG p u AE ɹ AI a̰ AG
အနုရုဒ္ဓါ	ʔ ə AD n ṵ j AB o AE ʊ AE ʔ d a AD
အနောက်	ʔ ə AD n a AD ʊ AE ʔ
အနောက်ဝန်	ʔ ə AD n a AD ʊ AE ʔ w AC ʊ AE ɴ
အနောမဒဿီ	ʔ ə AD n ɔ AE m ə AD d ə AD t θ i AD
အနောမဒဿီဘုရား	ʔ ə AD n ɔ AE m ə AD d a AD ʔ θ i AD pʰ ə AD j AB a AD
အနော်ရထာ	ʔ ə AD n ɔ AE j AB ə AD tʰ a AD
အနံ့	ʔ ə AD n a̰ AG ɴ
အန္တရာယ်	ʔ a AD ɴ d ə AD j AB ɛ AD
အန္တာတိက	ʔ a AD ɴ t a AD t ḭ k a̰ AG
အန်	ʔ a AD ɴ
အန်ကယ်	ʔ a AD ɴ k ɛ AD
အန်တီ	ʔ a AD ɴ t i AD
အန်နီမဲ	ʔ a AD ɴ n i AD m ɛ AD
အနွယ်	ʔ ə AD n w AC ɛ AD
အနှစ်	ʔ ə AD n̥ ɪ AD ʔ
အနှိပ်	ʔ ə AD n̥ e AD ɪ AD ʔ
အနှီဟာ	ʔ ə AD n̥ i AD h AA a AD
အနှီး	ʔ ə AD n̥ i AD
အပင်	ʔ ə AD p ɪ AD ɴ
အပတ်စဉ်	ʔ a̰ AG p a AD ʔ z ɪ AD ɴ
အပိုင်း	ʔ ə AD p a AD ɪ AD ɴ
အပိုဒ်	ʔ ə AD p a AD ɪ AD ʔ
အပူ	ʔ ə AD p u AE
အပေါင်	ʔ ə AD p a AD ʊ AE ɴ
အပေါင်းလက္ခဏာ	ʔ ə AD p a AD ʊ AE ɴ l ɛ AD ʔ kʰ ə AD n a AD
အပေါ့	ʔ ə AD p ɔ̰ AH
အပေါ်	ʔ ə AD p ɔ AE
အပ်	ʔ a AD ʔ
အပ်ချည်	ʔ a AD ʔ t ɕʰ i AD
အပ်ချုပ်စက်	ʔ a AD ʔ t ɕʰ o AE ʊ AE ʔ s ɛ AD ʔ
အပ်ထောက်	ʔ a AD ʔ tʰ a AD ʊ AE ʔ
အပြင်	ʔ ə AD p j AB ɪ AD ɴ
အပြစ်	ʔ ə AD p j AB ɪ AD ʔ
အပြာ	ʔ ə AD p j AB a AD
အပြာကား	ʔ ə AD p j AB a AD k a AD
အပြာမယ်	ʔ ə AD p j AB a AD m ɛ AD
အပြိုင်	ʔ ə AD p j AB a AD ɪ AD ɴ
အပြီးသတ်	ʔ ə AD p j AB i AD ð a AD ʔ
အပြုအမူ	ʔ ə AD p j AB ṵ ʔ ə AD m u AE
အပြုံး	ʔ ə AD p j AB o AE ʊ AE ɴ
အပြော	ʔ ə AD p j AB ɔ AE
အပွင့်	ʔ ə AD p w AC ɪ̰ AG ɴ
အဖ	ʔ ə AD pʰ a̰ AG
အဖတ်	ʔ ə AD pʰ a AD ʔ
အဖို	ʔ ə AD pʰ o AE
အဖို့	ʔ ə AD pʰ o̰ AH
အဖိုး	ʔ ə AD pʰ o AE
အဖိုးကြီး	ʔ ə AD pʰ o AE t ɕ i AD
အဖုံဖုံ	ʔ ə AD pʰ o AE ʊ AE ɴ b o AE ʊ AE ɴ
အဖုံး	ʔ ə AD pʰ o AE ʊ AE ɴ
အဖေ	ʔ ə AD pʰ e AD
အဖော်	ʔ ə AD pʰ ɔ AE
အဖေ့	ʔ ə AD pʰ ḛ
အဖျား	ʔ ə AD pʰ j AB a AD
အဖျားဖြတ်ဆေး	ʔ a̰ AG pʰ j AB a AD pʰ j AB a AD ʔ sʰ e AD
အဖြူ	ʔ ə AD pʰ j AB u AE
အဖြေ	ʔ ə AD pʰ j AB e AD
အဖွဲ့	ʔ ə AD pʰ w AC ɛ̰ AG
အဖွဲ့ချုပ်	ʔ ə AD pʰ w AC ɛ̰ AG d ʑ o AE ʊ AE ʔ
အဖွဲ့ဝင်	ʔ ə AD pʰ w AC ɛ̰ AG w AC ɪ AD ɴ
အဘိဓာန်	ʔ ə AD b ḭ d a AD ɴ
အဘိုး	ʔ ə AD pʰ o AE
အဘိုးကြီး	ʔ ə AD pʰ o AE d ʑ i AD
အဘွား	ʔ ə AD pʰ w AC a AD
အမ	ʔ ə AD m a̰ AG
အမည်	ʔ ə AD m j AB i AD
အမည်း	ʔ ə AD m ɛ AD
အမတ်	ʔ ə AD m a AD ʔ
အမယ်	ʔ ə AD m ɛ AD
အမရပူရ	ʔ ə AD m ə AD j AB a̰ AG p u AE j AB a̰ AG
အမာ	ʔ a̰ AG m a AD
အမိ	ʔ ə AD m ḭ
အမိန့်	ʔ ə AD m ḛ ɪ AD ɴ
အမိန့်ရှိပါ	ʔ ə AD m ḛ ɪ AD ɴ ʃ ḭ b a AD
အမိုး	ʔ ə AD m o AE
အမူအရာ	ʔ ə AD m u AE ʔ ə AD j AB a AD
အမေ	ʔ ə AD m e AD
အမေရိက	ʔ ə AD m e AD ɹ AI ḭ k a̰ AG
အမေရိကန်	ʔ ə AD m e AD ɹ AI ḭ k a AD ɴ
အမေရိကန်ပြည်ထောင်စု	ʔ ə AD m e AD ɹ AI ḭ k a AD ɴ p j AB i AD d a AD ʊ AE ɴ z ṵ
အမေလိုး	ʔ ə AD m e AD l o AE
အမေး	ʔ ə AD m e AD
အမဲလိုက်	ʔ ə AD m ɛ AD l a AD ɪ AD ʔ
အမဲသား	ʔ ə AD m ɛ AD ð a AD
အမဲသားမစားပါဘူး	ʔ ə AD m ɛ AD ð a AD m ə AD s a AD b a AD b u AE
အမျိုး	ʔ ə AD m j AB o AE
အမျိုးဇာတ်	ʔ ə AD m j AB o AE z a AD ʔ
အမျိုးလေးပါး	ʔ ə AD m j AB o AE l e AD b a AD
အမျိုးသမီး	ʔ ə AD m j AB o AE ð ə AD m i AD
အမျိုးသမီးလစဉ်သုံးပစ္စည်း	ʔ a̰ AG m j AB o AE ð ə AD m i AD l a̰ AG z ɪ AD ɴ θ o AE ʊ AE ɴ p j AB ɪ AD ʔ s i AD
အမျိုးသား	ʔ ə AD m j AB o AE ð a AD
အမျိုးသားစိတ်	ʔ ə AD m j AB o AE ð a AD s e AD ɪ AD ʔ
အမျိုးသားနေ့	ʔ ə AD m j AB o AE ð a AD n ḛ
အမျိုးသားလွှတ်တော်	ʔ ə AD m j AB o AE ð a AD l̥ ʊ AE ʔ t ɔ AE
အမျိုးသားသီချင်း	ʔ ə AD m j AB o AE ð a AD θ ə AD t ɕʰ ɪ AD ɴ
အမျိုးအနွယ်	ʔ ə AD m j AB o AE ʔ ə AD n w AC ɛ AD
အမျှင်	ʔ ə AD m̥ j AB ɪ AD ɴ
အမြစ်	ʔ ə AD m j AB ɪ AD ʔ
အမြန်	ʔ ə AD m j AB a AD ɴ
အမြီး	ʔ ə AD m̥ i AD
အမြောက်	ʔ ə AD m j AB a AD ʊ AE ʔ
အမြဲ	ʔ ə AD m j AB ɛ AD
အမြဲတမ်း	ʔ ə AD m j AB ɛ AD d a AD ɴ
အမြွှာ	ʔ ə AD m̥ w AC a AD
အမြှုပ်	ʔ ə AD m̥ j AB o AE ʊ AE ʔ
အမြှောက်လက္ခဏာ	ʔ ə AD m̥ j AB a AD ʊ AE ʔ l ɛ AD ʔ kʰ ə AD n a AD
အမွေ	ʔ ə AD m w AC e AD
အမွေခံ	ʔ ə AD m w AC e AD ɡ a AD ɴ
အမွေခွဲ	ʔ ə AD m w AC e AD kʰ w AC ɛ AD
အမွေအနှစ်	ʔ ə AD m w AC e AD ʔ ə AD n̥ ɪ AD ʔ
အမွေး	ʔ ə AD m w AC e AD
အမွှေး	ʔ ə AD m̥ w AC e AD
အမွှေးတိုင်	ʔ ə AD m̥ w AC e AD d a AD ɪ AD ɴ
အမှတ်	ʔ ə AD m̥ a AD ʔ
အမှတ်တံဆိပ်	ʔ ə AD m̥ a AD ʔ d ə AD z e AD ɪ AD ʔ
အမှန်တရား	ʔ ə AD m̥ a AD ɴ t ə AD j AB a AD
အမှာ	ʔ ə AD m̥ a AD
အမှား	ʔ ə AD m̥ a AD
အမှိုက်	ʔ ə AD m̥ a AD ɪ AD ʔ
အမှုန့်	ʔ ə AD m̥ o̰ AH ʊ AE ɴ
အမှုန်	ʔ ə AD m̥ o AE ʊ AE ɴ
အယုဓျာ	ʔ ə AD j AB o AE ʊ AE ʔ d ə AD j AB a AD
အယူ	ʔ ə AD j AB u AE
အယူဝါဒ	ʔ ə AD j AB u AE w AC a AD d a̰ AG
အယ်ဆာဗေဒို	ʔ ɛ AD sʰ a AD b e AD d o AE
အယ်လဘမ်	ʔ ɛ AD l ə AD b a AD ɴ
အယ်လ်ဂျီးရီးယား	ʔ ɛ AD l d ʑ i AD ɹ AI i AD j AB a AD
အယ်လ်ဘေးနီးယား	ʔ ɛ AD l b e AD n i AD j AB a AD
အရက်	ʔ ə AD j AB ɛ AD ʔ
အရက်ဆိုင်	ʔ ə AD j AB ɛ AD ʔ sʰ a AD ɪ AD ɴ
အရင်း	ʔ ə AD j AB ɪ AD ɴ
အရင်းရှင်ဝါဒ	ʔ ə AD j AB ɪ AD ɴ ʃ ɪ AD ɴ w AC a AD d a̰ AG
အရည်	ʔ ə AD j AB i AD
အရမ်း	ʔ ə AD j AB a AD ɴ
အရသာ	ʔ ə AD j AB a̰ AG ð a AD
အရာ	ʔ ə AD j AB a AD
အရာခံဗိုလ်	ʔ ə AD j AB a AD ɡ a AD ɴ b o AE
အရိပ်	ʔ ə AD j AB e AD ɪ AD ʔ
အရိမဒ္ဒနာပူရ	ʔ a̰ AG ɹ AI ḭ m a AD d d ə AD n a AD p u AE ɹ AI a̰ AG
အရိုး	ʔ ə AD j AB o AE
အရိုးစု	ʔ ə AD j AB o AE z ṵ
အရိုးပျော့နာ	ʔ a̰ AG j AB o AE p j AB ɔ̰ AH n a AD
အရီး	ʔ ə AD j AB i AD
အရီးကြီး	ʔ ə AD j AB i AD d ʑ i AD
အရီးလေး	ʔ ə AD j AB i AD l e AD
အရုဏ်	ʔ ə AD j AB u AE n
အရုပ်	ʔ ə AD j AB o AE ʊ AE ʔ
အရုပ်စာ	ʔ ə AD j AB o AE ʊ AE ʔ s a AD
အရေ	ʔ ə AD j AB e AD
အရေပြား	ʔ ə AD j AB e AD b j AB a AD
အရေပြားရောဂါ	ʔ ə AD j AB e AD b j AB a AD j AB ɔ AE ɡ a AD
အရောင်	ʔ ə AD j AB a AD ʊ AE ɴ
အရောင်တင်မှုန့်	ʔ ə AD j AB a AD ʊ AE ɴ t ɪ AD ɴ m̥ o̰ AH ʊ AE ɴ
အရောင်းအဝယ်	ʔ ə AD j AB a AD ʊ AE ɴ ʔ ə AD w AC ɛ AD
အရေး	ʔ a̰ AG j AB e AD
အရေးကြီး	ʔ a̰ AG j AB e AD t ɕ i AD
အရေးတော်ပုံ	ʔ ə AD j AB e AD d ɔ AE b o AE ʊ AE ɴ
အရံဂြိုဟ်	ʔ ə AD j AB a AD ɴ d ʑ o AE
အရွက်	ʔ ə AD j AB w AC ɛ AD ʔ
အရွတ်	ʔ ə AD j AB ʊ AE ʔ
အရွယ်ဆယ်ပါး	ʔ ə AD j AB w AC ɛ AD sʰ ɛ AD b a AD
အရှင်	ʔ ə AD ʃ ɪ AD ɴ
အရှင်ဘုရား	ʔ ə AD ʃ ɪ AD ɴ pʰ ə AD j AB a AD
အရှိန်	ʔ ə AD ʃ e AD ɪ AD ɴ
အရှေ့	ʔ ə AD ʃ ḛ
အလက်	ʔ ə AD l ɛ AD ʔ
အလင်း	ʔ ə AD l ɪ AD ɴ
အလင်းတန်း	ʔ ə AD l ɪ AD ɴ d a AD ɴ
အလင်္ကာ	ʔ ə AD l ɪ AD ɴ ɡ a AD
အလား	ʔ ə AD l a AD
အလို	ʔ ə AD l o AE
အလီ	ʔ ə AD l i AD
အလုပ်	ʔ ə AD l o AE ʊ AE ʔ
အလုပ်ပိတ်ရက်	ʔ ə AD l o AE ʊ AE ʔ p e AD ɪ AD ʔ j AB ɛ AD ʔ
အလုပ်ရုံ	ʔ ə AD l o AE ʊ AE ʔ j AB o AE ʊ AE ɴ
အလုပ်ရှင်	ʔ ə AD l o AE ʊ AE ʔ ʃ ɪ AD ɴ
အလုပ်လုပ်	ʔ ə AD l o AE ʊ AE ʔ l o AE ʊ AE ʔ
အလုပ်သမား	ʔ ə AD l o AE ʊ AE ʔ θ ə AD m a AD
အလုပ်သမားနေ့	ʔ ə AD l o AE ʊ AE ʔ θ ə AD m a AD n ḛ
အလုံး	ʔ ə AD l o AE ʊ AE ɴ
အလူမီနီယမ်	ʔ ə AD l u AE m i AD n i AD j AB a AD ɴ
အလောင်း	ʔ ə AD l a AD ʊ AE ɴ
အလေး	ʔ ə AD l e AD
အလံ	ʔ ə AD l a AD ɴ
အလ္လာဟ်	ʔ a AD l l a AD h AA
အလျင်	ʔ ə AD l j AB ɪ AD ɴ
အလျား	ʔ ə AD l j AB a AD
အလွန်	ʔ ə AD l ʊ AE ɴ
အလှဆီ	ʔ ə AD l̥ a̰ AG z i AD
အလှမ်း	ʔ ə AD l̥ a AD ɴ
အလှူရှင်	ʔ ə AD l̥ u AE ʃ ɪ AD ɴ
အဝင်	ʔ ə AD w AC ɪ AD ɴ
အဝတာရ	ʔ a̰ AG w AC a̰ AG t a AD j AB a̰ AG
အဝတ်	ʔ ə AD w AC ʊ AE ʔ
အဝတ်လျှောက်စက်	ʔ ə AD w AC ʊ AE ʔ ʃ a AD ʊ AE ʔ s ɛ AD ʔ
အဝတ်အစား	ʔ ə AD w AC ʊ AE ʔ ʔ ə AD s a AD
အဝါ	ʔ ə AD w AC a AD
အသက်	ʔ ə AD θ ɛ AD ʔ
အသက်ဦးဆံပိုင်	ʔ ə AD θ ɛ AD ʔ ʔ u AE sʰ a AD ɴ b a AD ɪ AD ɴ
အသင်	ʔ ə AD θ ɪ AD ɴ
အသင်း	ʔ ə AD θ ɪ AD ɴ
အသည်း	ʔ ə AD θ ɛ AD
အသည်းနှလုံး	ʔ ə AD θ ɛ AD n̥ ə AD l o AE ʊ AE ɴ
အသတ်	ʔ a̰ AG θ a AD ʔ
အသား	ʔ ə AD θ a AD
အသားညှပ်မုန့်	ʔ ə AD θ a AD ɲ̊ a AD ʔ m o̰ AH ʊ AE ɴ
အသားမာ	ʔ ə AD θ ə AD m a AD
အသားဝါရောဂါ	ʔ a̰ AG θ a AD w AC a AD j AB ɔ AE ɡ a AD
အသိ	ʔ ə AD θ ḭ
အသိတရား	ʔ ə AD θ ḭ t ə AD j AB a AD
အသိပညာ	ʔ ə AD θ ḭ p j AB ɪ AD ɴ ɲ a AD
အသိပညာရှင်	ʔ ə AD θ ḭ p j AB ɪ AD ɴ ɲ a AD ʃ ɪ AD ɴ
အသိုက်	ʔ ə AD θ a AD ɪ AD ʔ
အသီး	ʔ ə AD θ i AD
အသုပ်	ʔ ə AD θ o AE ʊ AE ʔ
အသုပ်စုံ	ʔ ə AD θ o AE ʊ AE ʔ s o AE ʊ AE ɴ
အသုဘ	ʔ a̰ AG θ ṵ b a̰ AG
အသုံး	ʔ ə AD θ o AE ʊ AE ɴ
အသုံးပြု	ʔ ə AD θ o AE ʊ AE ɴ p j AB ṵ
အသေ	ʔ ə AD θ e AD
အသော	ʔ ə AD θ ɔ AE
အသံ	ʔ ə AD θ a AD ɴ
အသံထွက်	ʔ ə AD θ a AD ɴ d w AC ɛ AD ʔ
အသျှင်	ʔ ə AD ʃ ɪ AD ɴ
အသွားအလာ	ʔ ə AD θ w AC a AD ʔ ə AD l a AD
အာကာသ	ʔ a AD k a AD θ a̰ AG
အာကာသစိုး	ʔ a AD k a AD θ a̰ AG z o AE
အာကာသယာဉ်	ʔ a AD k a AD θ a̰ AG j AB ɪ AD ɴ
အာခါ	ʔ a AD kʰ a AD
အာဂျင်တီးနား	ʔ a AD d ʑ ɪ AD ɴ t i AD n a AD
အာဃာတ	ʔ a AD ɡ a AD t a̰ AG
အာစရိယ	ʔ a AD s a̰ AG ɹ AI ḭ j AB a̰ AG
အာဇာနည်	ʔ a AD z a AD n i AD
အာဇာနည်နေ့	ʔ a AD z a AD n i AD n ḛ
အာဏာ	ʔ a AD n a AD
အာဏာရှင်	ʔ a AD n a AD ʃ ɪ AD ɴ
အာဏာသား	ʔ a AD n a AD ð a AD
အာဏာသိမ်း	ʔ a AD n a AD θ e AD ɪ AD ɴ
အာတိတ်	ʔ a AD t e AD ɪ AD ʔ
အာနီ	ʔ a AD n i AD
အာနုဘော်	ʔ a AD n ṵ b ɔ AE
အာဖဂန်နစ်စတန်	ʔ a AD pʰ ə AD ɡ a AD ɴ n ɪ AD ʔ s ə AD t a AD ɴ
အာဖရိက	ʔ a AD pʰ ə AD ɹ AI ḭ k a̰ AG
အာမခံ	ʔ a AD m a̰ AG ɡ a AD ɴ
အာမခံသေတ္တာ	ʔ a AD m a̰ AG ɡ a AD ɴ θ ɪ AD ʔ t a AD
အာမေဍိတ်	ʔ a AD m e AD d e AD ɪ AD ʔ
အာမေးနီးယား	ʔ a AD m e AD n i AD j AB a AD
အာယုဗ္ဗေဒ	ʔ a AD j AB o AE ʊ AE ʔ b e AD d a̰ AG
အာရပ်	ʔ a AD ɹ AI a AD ʔ
အာရာမ	ʔ a AD j AB a AD m a̰ AG
အာရာမ်	ʔ a AD j AB a AD ɴ
အာရိုက်	ʔ a AD j AB a AD ɪ AD ʔ
အာရုံကြော	ʔ a AD j AB o AE ʊ AE ɴ d ʑ ɔ AE
အာရှ	ʔ a AD ʃ a̰ AG
အာလယ	ʔ a AD l ə AD j AB a̰ AG
အာလာပသလ္လာပ	ʔ a AD l a AD p a̰ AG θ ə AD l a AD p a̰ AG
အာလူး	ʔ a AD l u AE
အာလူးပူရီ	ʔ a AD l u AE p u AE j AB i AD
အာလူးဖုတ်	ʔ a AD l u AE pʰ o AE ʊ AE ʔ
အာဝါဟဝိဝါဟ	ʔ a AD w AC a AD h AA a̰ AG w AC ḭ w AC a AD h AA a̰ AG
အာဟာရ	ʔ a AD h AA a AD j AB a̰ AG
အာဟာရဗေဒ	ʔ a AD h AA a AD j AB a̰ AG b e AD d a̰ AG
အား	ʔ a AD
အားကစား	ʔ a AD ɡ ə AD z a AD
အားကိုး	ʔ a AD k o AE
အားနည်း	ʔ a AD n ɛ AD
အားနာ	ʔ a AD n a AD
အားနာပါးနာ	ʔ a AD n a AD p a AD n a AD
အားလပ်ရက်	ʔ a AD l a AD ʔ j AB ɛ AD ʔ
အားလုံး	ʔ a AD l o AE ʊ AE ɴ
အိတ်	ʔ e AD ɪ AD ʔ
အိန္ဒိယ	ʔ e AD ɪ AD ɴ d ḭ j AB a̰ AG
အိန္ဒြာ	ʔ e AD ɪ AD ɴ d ɹ AI a AD
အိန္ဒြေ	ʔ e AD ɪ AD ɴ d ɹ AI e AD
အိပ်	ʔ e AD ɪ AD ʔ
အိပ်ခန်း	ʔ e AD ɪ AD ʔ kʰ a AD ɴ
အိပ်မက်	ʔ e AD ɪ AD ʔ m ɛ AD ʔ
အိပ်ရာ	ʔ e AD ɪ AD ʔ j AB a AD
အိပ်ရာလိပ်	ʔ e AD ɪ AD ʔ j AB a AD l e AD ɪ AD ʔ
အိမ်	ʔ e AD ɪ AD ɴ
အိမ်တက်မင်္ဂလာ	ʔ e AD ɪ AD ɴ t ɛ AD ʔ m ɪ AD ɴ ɡ ə AD l a AD
အိမ်ထောင်	ʔ e AD ɪ AD ɴ tʰ a AD ʊ AE ɴ
အိမ်ထောင်ပြု	ʔ e AD ɪ AD ɴ d a AD ʊ AE ɴ p j AB ṵ
အိမ်နီးချင်း	ʔ e AD ɪ AD ɴ n i AD d ʑ ɪ AD ɴ
အိမ်မြှောင်	ʔ e AD ɪ AD ɴ m̥ j AB a AD ʊ AE ɴ
အိမ်ရှေ့မင်း	ʔ e AD ɪ AD ɴ ʃ ḛ m ɪ AD ɴ
အိမ်ရှေ့မင်းသား	ʔ e AD ɪ AD ɴ ʃ ḛ m ɪ AD ɴ ð a AD
အိမ်လည်	ʔ e AD ɪ AD ɴ l e AD
အိမ်သာ	ʔ e AD ɪ AD ɴ ð a AD
အိမ်သူ	ʔ e AD ɪ AD ɴ ð u AE
အို	ʔ o AE
အိုက်စလန်	ʔ a AD ɪ AD ʔ s ə AD l a AD ɴ
အိုက်တင်	ʔ a AD ɪ AD ʔ t ɪ AD ɴ
အိုင်ဒီယာ	ʔ a AD ɪ AD ɴ d i AD j AB a AD
အိုင်ဗရီကို့စ်	ʔ a AD ɪ AD ɴ b ə AD ɹ AI i AD k o̰ AH s
အိုင်ယာလန်	ʔ a AD ɪ AD ɴ j AB ə AD l a AD ɴ
အိုင်အိုင်	ʔ a AD ɪ AD ɴ ʔ a AD ɪ AD ɴ
အိုဗာတင်း	ʔ o AE b a AD t ɪ AD ɴ
အိုမန်	ʔ o AE m a AD ɴ
အိုရှန်းနီးယား	ʔ o AE ʃ a AD ɴ n i AD j AB a AD
အိုလံပစ်	ʔ o AE l a AD ɴ p ɪ AD ʔ
အိုး	ʔ o AE
အီကြာကွေး	ʔ i AD t ɕ a AD k w AC e AD
အီကွေတာ	ʔ i AD k w AC e AD t a AD
အီကွေတာဂီနီ	ʔ i AD k w AC e AD t a AD ɡ i AD n i AD
အီကွေဒေါ	ʔ i AD k w AC e AD d ɔ AE
အီဂျစ်	ʔ i AD d ʑ ɪ AD ʔ
အီစတာ	ʔ i AD s ə AD t a AD
အီတလီ	ʔ i AD t a̰ AG l i AD
အီနောင်	ʔ i AD n a AD ʊ AE ɴ
အီရတ်	ʔ i AD ɹ AI a AD ʔ
အီရန်	ʔ i AD ɹ AI a AD ɴ
အီရီထရီးယား	ʔ i AD ɹ AI i AD tʰ ə AD ɹ AI i AD j AB a AD
အီသီယိုးပီးယား	ʔ i AD θ i AD j AB o AE p i AD j AB a AD
အီး	ʔ i AD
အီးပေါက်	ʔ i AD p a AD ʊ AE ʔ
အီးမေးလ်	ʔ i AD m e AD l
အုတ်	ʔ o AE ʊ AE ʔ
အုတ်ကြွပ်	ʔ o AE ʊ AE ʔ t ɕ ʊ AE ʔ
အုန်း	ʔ o AE ʊ AE ɴ
အုန်းဆီ	ʔ o AE ʊ AE ɴ z i AD
အုန်းထမင်း	ʔ o AE ʊ AE ɴ tʰ ə AD m ɪ AD ɴ
အုန်းနို့	ʔ o AE ʊ AE ɴ n o̰ AH
အုန်းနို့ခေါက်ဆွဲ	ʔ o AE ʊ AE ɴ n o̰ AH kʰ a AD ʊ AE ʔ sʰ w AC ɛ AD
အုန်းမှန်ကူ	ʔ o AE ʊ AE ɴ m̥ a AD ɴ ɡ u AE
အုံး	ʔ o AE ʊ AE ɴ
အူ	ʔ u AE
အူမကြီး	ʔ u AE m a̰ AG d ʑ i AD
အောက်	ʔ a AD ʊ AE ʔ
အောက်ဆီဂျင်	ʔ a AD ʊ AE ʔ sʰ i AD d ʑ ɪ AD ɴ
အောက်တိုဘာ	ʔ a AD ʊ AE ʔ t o AE b a AD
အောက်မြစ်	ʔ a AD ʊ AE ʔ m j AB ɪ AD ʔ
အောက်လွှတ်တော်	ʔ a AD ʊ AE ʔ l̥ ʊ AE ʔ t ɔ AE
အောက်သား	ʔ a AD ʊ AE ʔ ð a AD
အောင်	ʔ a AD ʊ AE ɴ
အောင်ပွဲ	ʔ a AD ʊ AE ɴ b w AC ɛ AD
အောင်လံ	ʔ a AD ʊ AE ɴ l a AD ɴ
အော့	ʔ ɔ̰ AH
အော့အန်	ʔ ɔ̰ AH ʔ a AD ɴ
အော်	ʔ ɔ AE
အော်ကေ့ကြည်	ʔ ɔ AE k ḛ t ɕ i AD
အော်တိုမေးရှင်း	ʔ ɔ AE t o AE m e AD ʃ ɪ AD ɴ
အော်ဒါ	ʔ ɔ AE d a AD
အော်ပရာ	ʔ ɔ AE p ə AD ɹ AI a AD
အေး	ʔ e AD
အဲဒါ	ʔ ɛ AD d a AD
အဲဒါဘာလဲ	ʔ ɛ AD d a AD b a AD l ɛ AD
အဲဒီ	ʔ ɛ AD d i AD
အဲဒီဟာ	ʔ ɛ AD d i AD h AA a AD
အဲလစ်ဇဘက်	ʔ ɛ AD l ɪ AD ʔ z a̰ AG b ɛ AD ʔ
ဣ	ʔ ḭ
ဣန္ဒာ	ʔ ḭ n d a AD
ဣန္ဒြေ	ʔ e AD ɪ AD ɴ d ɹ AI e AD
ဣရိယာပုတ်	ʔ ḭ ɹ AI ḭ j AB a AD b o AE ʊ AE ʔ
ဥ	ʔ ṵ
ဥက္ကဋ္ဌ	ʔ o AE ʊ AE ʔ k ə AD θ a̰ AG
ဥက္ကာ	ʔ o AE ʊ AE ʔ k a AD
ဥက္ကာခဲ	ʔ o AE ʊ AE ʔ k a AD ɡ ɛ AD
ဥက္ကာပျံ	ʔ o AE ʊ AE ʔ k a AD b j AB a AD ɴ
ဥဂ္ဂါ	ʔ ṵ ɡ ɡ a AD
ဥစ္စာ	ʔ o AE ʊ AE ʔ s a AD
ဥဇဘက်ကစ္စတန်	ʔ ṵ z ə AD b ɛ AD ʔ k ɪ AD ʔ s ə AD t a AD ɴ
ဥဏ္ဏလုံ	ʔ o AE ʊ AE ɴ n ə AD l o AE ʊ AE ɴ
ဥဏ္ဏလုံမွေးရှင်	ʔ o AE ʊ AE ɴ n ə AD l o AE ʊ AE ɴ m̥ w AC e AD ʃ ɪ AD ɴ
ဥဏှဂူ	ʔ o AE ʊ AE ɴ n̥ ə AD ɡ u AE
ဥဏှိဿ	ʔ ṵ n̥ e AD ɪ AD ʔ θ a̰ AG
ဥတု	ʔ ṵ d ṵ
ဥတ္တရ	ʔ o AE ʊ AE ʔ t ə AD j AB a̰ AG
ဥတ္တရခဏ္ဍ	ʔ o AE ʊ AE ʔ t ə AD ɹ AI a̰ AG kʰ a AD n d a̰ AG
ဥဒေါင်း	ʔ ṵ d a AD ʊ AE ɴ
ဥပဒေ	ʔ ṵ b a̰ AG d e AD
ဥပဒေပညာ	ʔ ṵ b ə AD d e AD p j AB ɪ AD ɴ ɲ a AD
ဥပဓိရုပ်	ʔ ṵ p a̰ AG d ḭ j AB o AE ʊ AE ʔ
ဥပမာ	ʔ ṵ b ə AD m a AD
ဥပရာဇာ	ʔ ṵ p ə AD ɹ AI a AD z a AD
ဥပါကြယ်	ʔ ṵ p a AD t ɕ ɛ AD
ဥပါဒါန်	ʔ ṵ p a AD d a AD n
ဥပါယ်	ʔ ṵ p ɛ AD
ဥပါလိ	ʔ ṵ p a AD l ḭ
ဥပုသ်	ʔ ṵ b o AE ʊ AE ʔ
ဥပေက္ခါ	ʔ ṵ p ɛ AD ʔ kʰ a AD
ဥမင်	ʔ ṵ m ɪ AD ɴ
ဥမ္မာ	ʔ ṵ m m a AD
ဥယျာဉ်	ʔ ṵ j AB ɪ AD ɴ
ဥရုဂွေး	ʔ ṵ ɹ AI ṵ ʔ ṵ ɡ w AC e AD
ဥရောပ	ʔ ṵ ɹ AI ɔ AE p a̰ AG
ဥသျှစ်	ʔ o AE ʊ AE ʔ ʃ ɪ AD ʔ
ဥုံ	ʔ o AE ʊ AE ɴ
ဥဿဖရား	ʔ o AE ʊ AE ʔ θ ə AD pʰ ə AD j AB a AD
ဦလန်ဘာတာ	ʔ u AE l a AD ɴ b a AD t a AD
ဦး	ʔ u AE
ဦးကြီး	ʔ u AE d ʑ i AD
ဦးခိုက်	ʔ u AE kʰ a AD ɪ AD ʔ
ဦးချ	ʔ u AE t ɕʰ a̰ AG
ဦးချို	ʔ u AE d ʑ o AE
ဦးခွံ	ʔ u AE ɡ ʊ AE ɴ
ဦးထုပ်	ʔ o AE ʊ AE ʔ tʰ o AE ʊ AE ʔ
ဦးနှောက်	ʔ o AE ʊ AE ɴ n̥ a AD ʊ AE ʔ
ဦးပဉ္စင်း	ʔ u AE b ə AD z ɪ AD ɴ
ဦးလေး	ʔ u AE l e AD
ဧက	ʔ e AD k a̰ AG
ဧကရာဇ်	ʔ e AD ɡ ə AD ɹ AI ɪ AD ʔ
ဧကရီ	ʔ e AD k ə AD j AB i AD
ဧကာဒသမ	ʔ e AD k a AD d a̰ AG θ ə AD m a̰ AG
ဧည့်	ʔ ḛ
ဧည့်သည်	ʔ ḛ ð e AD
ဧဏီ	ʔ e AD n i AD
ဧပြီ	ʔ e AD b j AB i AD
ဩကာသ	ʔ ɔ AE ɡ a AD θ a̰ AG
ဩဂုတ်	ʔ ɔ AE ɡ o AE ʊ AE ʔ
ဩစတြီးယား	ʔ ɔ AE s ə AD t ə AD ɹ AI i AD j AB a̰ AG
ဩစတြေးလျ	ʔ ɔ AE s ə AD t ə AD ɹ AI e AD l j AB a̰ AG
ဩဇာ	ʔ ɔ AE z a AD
ဩဇာသီး	ʔ ɔ AE z a AD θ i AD
ဩဌဇ	ʔ ɔ AE tʰ ə AD z a̰ AG
ဩရသ	ʔ ɔ AE j AB ə AD θ a̰ AG
ဩရိဿ	ʔ ɔ AE ɹ AI e AD ɪ AD ʔ θ a̰ AG
ဩသဓ	ʔ ɔ AE θ ə AD d a̰ AG
၌	n̥ a AD ɪ AD ʔ
၍	j AB w AC ḛ
၎	l ə AD ɡ a AD ʊ AE ɴ
၎င်း	l ə AD ɡ a AD ʊ AE ɴ
၏	ʔ ḭ
