'y	ɪ AD
aba	ʔ ɐ AF b a AD ʔ
abalos	ʔ ɐ AF b ɐ AF l o AF s
abandonado	ʔ ɐ AF b ɐ AF n d o AF n ɐ AF d o AF
abaniko	ʔ ɐ AF b ɐ AF n ɪ AD x o AF
abejuela	ʔ ɐ AF b ɛ AD d ʒ ʊ AF ɛ AD l ɐ AF
abelgas	ʔ ɐ AF b ɛ AD l ɡ ɐ AF s
abellera	ʔ ɐ AF b ɛ AD l l ɛ AD ɾ ɐ AF
abing	ʔ ɐ AF b ɪ AD ŋ
abisuhan	ʔ ɐ AF b ɪ AD s ʊ AF h AA ɐ AF n
abo	ʔ ɐ AF b o AF
abrazado	ʔ ɐ AF b ɾ ɐ AF s ɐ AF d o AF
abrenica	ʔ ɐ AF b ɾ ɛ AD n ɪ AD x ɐ AF
abueg	ʔ ɐ AF b w AC ɛ AD ɡ
abulencia	ʔ ɐ AF b ʊ AF l ɛ AD n ʃ ɐ AF
abusado	ʔ ɐ AF b ʊ AF s ɐ AF d o AF
abyad	ʔ ɐ AF b j AB ɐ AF d
abyador	ʔ ɐ AF b j AB ɐ AF d o AF ɾ
acierto	ʔ ɐ AF ʃ ɛ AD ɾ t o AF
acorda	ʔ ɐ AF x o AF ɾ d ɐ AF
acuzar	ʔ ɐ AF x ʊ AF s ɐ AF ɾ
adajar	ʔ ɐ AF d ɐ AF d ʒ ɐ AF ɾ
adik	ʔ a AD d ɪ AD k
adlawan	ʔ ɐ AF d l ɐ AF w AC ɐ AF n
adres	ʔ ɐ AF d ɾ ɛ AD s
adrias	ʔ ɐ AF d ɾ ɪ AD ɐ AF s
agapay	ʔ ɐ AF ɰ AB ɐ AF p a AD ɪ̯ AG
agila	ʔ a AD ɰ AB ɪ AD l ɐ AF
agiw	ʔ a AD ɰ AB ɪ AD ʊ̯ AH
agrabyado	ʔ ɐ AF ɡ ɾ ɐ AF b j AB a AD d o AF
aguas	ʔ ɐ AF ɰ AB ʊ AF ɐ AF s
aguda	ʔ ɐ AF ɰ AB ʊ AF d ɐ AF
aguilera	ʔ ɐ AF ɰ AB ɪ AD l ɛ AD ɾ ɐ AF
aguirre	ʔ ɐ AF ɰ AB ɪ AD ɾ ɛ AD
agustin	ʔ ɐ AF ɰ AB ʊ AF s t ɪ AD n
agwat	ʔ ɐ AF ɡ w AC ɐ AF t
aksayado	ʔ ɐ AF k s ɐ AF j AB a AD d o AF
alambre	ʔ ɐ AF l a AD m b ɾ ɛ AD
alcaide	ʔ ɐ AF l k a AD ɪ̯ AG d ɛ AD
aldover	ʔ ɐ AF l d o AF b ɛ AD ɾ
alegre	ʔ ɐ AF l ɛ AD ɡ ɾ ɛ AD
alila	ʔ ɐ AF l i AD l ɐ AF ʔ
alimasag	ʔ ɐ AF l ɪ AD m a AD s ɐ AF ɡ
alipin	ʔ ɐ AF l ɪ AD p ɪ AD n
alis	ʔ a AD l ɪ AD s
alkansya	a AD l k a AD n ɕ a AD
almaden	ʔ ɐ AF l m ɐ AF d ɛ AD n
almarez	ʔ ɐ AF l m ɐ AF ɾ ɛ AD s
almario	ʔ ɐ AF l m ɐ AF ɾ ɪ AD o AF
almendrala	ʔ ɐ AF l m ɛ AD n d ɾ ɐ AF l ɐ AF
almirol	ʔ ɐ AF l m ɪ AD ɾ o AF l
alonte	ʔ ɐ AF l o AF n t ɛ AD
alonto	ʔ ɐ AF l o AF n t o AF
alperes	ʔ ɐ AF l p ɛ AD ɾ ɛ AD s
altapresyon	ʔ ɐ AF l t ɐ AF p ɾ ɛ AD ʃ o AF n
alviar	ʔ ɐ AF l b j AB ɐ AF ɾ
amante	ʔ ɐ AF m ɐ AF n t ɛ AD
ambag	ʔ ɐ AF m b a AD ɡ
amerikana	ʔ ɐ AF m ɛ AD ɾ ɪ AD x a AD n ɐ AF
amin	ʔ a AD m ɪ AD n
aminado	ʔ ɐ AF m ɪ AD n ɐ AF d o AF
amon	ʔ ɐ AF m o AF n
amoranto	ʔ ɐ AF m o AF ɾ ɐ AF n t o AF
ampaw	ʔ ɐ AF m p a AD ʊ̯ AH
amurao	ʔ ɐ AF m ʊ AF ɾ a AD ʊ̯ AH
analisis	ʔ ɐ AF n ɐ AF l i AD s ɪ AD s
anatomiya	ʔ ɐ AF n ɐ AF t o AF m i AD ɐ AF
anay	ʔ a AD n a AD ɪ̯ AG
anayin	ʔ ɐ AF n ɐ AF j AB ɪ AD n
andal	ʔ ɐ AF n d ɐ AF l
anggo	ʔ ɐ AF ŋ ɡ o AF
anghel	ʔ ɐ AF ŋ h AA ɛ AD l
angkla	ʔ ɐ AF ŋ k l ɐ AF
ango	ʔ ɐ AF ŋ o AF
angot	ʔ ɐ AF ŋ o AF t
anim	ʔ a AD n ɪ AD m
anis	ʔ ɐ AF n i AD s
antipona	ʔ ɐ AF n t i AD p o AF n ɐ AF
antok	ʔ ɐ AF n t o AF k
antukin	ʔ ɐ AF n t ʊ AF x ɪ AD n
anyayahan	ʔ ɐ AF ɲ ɐ AF j AB ɐ AF h AA ɐ AF n
apela	ʔ ɐ AF p ɛ AD l a AD
apilado	ʔ ɐ AF p ɪ AD l ɐ AF d o AF
apostasiya	ʔ ɐ AF p o AF s t ɐ AF s ɪ AD ɐ AF
aranda	ʔ ɐ AF ɾ ɐ AF n d ɐ AF
aray	ʔ ɐ AF ɾ a AD ɪ̯ AG
arañas	ʔ ɐ AF ɾ ɐ AF ɲ ɐ AF s
arce	ʔ ɐ AF ɾ s ɛ AD
arcega	ʔ ɐ AF ɾ s ɛ AD ɰ AB ɐ AF
arceo	ʔ ɐ AF ɾ s ɛ AD o AF
arcilla	ʔ ɐ AF ɾ s ɪ AD l l ɐ AF
arcillas	ʔ ɐ AF ɾ s ɪ AD l l ɐ AF s
arcinas	ʔ ɐ AF ɾ s ɪ AD n ɐ AF s
arenas	ʔ ɐ AF ɾ ɛ AD n ɐ AF s
arevalo	ʔ ɐ AF ɾ ɛ AD b ɐ AF l o AF
argente	ʔ ɐ AF ɾ ɡ ɛ AD n t ɛ AD
arkila	ʔ ɐ AF ɾ k ɪ AD l a AD
arquiza	ʔ ɐ AF ɾ k ɪ AD s ɐ AF
arriola	ʔ ɐ AF ɾ ɪ AD o AF l ɐ AF
arrogante	ʔ ɐ AF ɾ o AF ɰ AB ɐ AF n t ɛ AD
artiaga	ʔ ɐ AF ɾ t ʃ ɐ AF ɰ AB ɐ AF
arzadon	ʔ ɐ AF ɾ s ɐ AF d o AF n
asilo	ʔ ɐ AF s ɪ AD l o AF
asinta	ʔ ɐ AF s ɪ AD n t a AD
asul	ʔ ɐ AF s ʊ AF l
asungot	ʔ ɐ AF s u AF ŋ o AF t
at	ʔ ɐ AF t
ataul	ʔ ɐ AF t ɐ AF ʔ u AF l
atendido	ʔ ɐ AF t ɛ AD n d ɪ AD d o AF
avanceña	ʔ ɐ AF b ɐ AF n s ɛ AD ɲ ɐ AF
avendaño	ʔ ɐ AF b ɛ AD n d ɐ AF ɲ o AF
awat	ʔ a AD w AC ɐ AF t
ay	ʔ a AD ɪ̯ AG
ayson	ʔ a AD ɪ̯ AG s o AF n
azaña	ʔ ɐ AF s ɐ AF ɲ ɐ AF
azucena	ʔ ɐ AF s ʊ AF s ɛ AD n ɐ AF
babae	b ɐ AF b a AD ʔ ɛ AD
babaero	b ɐ AF b ɐ AF ʔ ɛ AD ɾ o AF
babaihin	b ɐ AF b a AD ɪ̯ AG h AA ɪ AD n
babao	b ɐ AF b a AD ʊ̯ AH
babasa	b ɐ AF b ɐ AF s ɐ AF
babasagin	b ɐ AF b ɐ AF s ɐ AF ɰ AB ɪ AD n
babasahin	b ɐ AF b ɐ AF s ɐ AF h AA ɪ AD n
bacani	b ɐ AF x ɐ AF n ɪ AD
baclig	b ɐ AF k l ɪ AD ɡ
bacsa	b ɐ AF k s ɐ AF
bactol	b ɐ AF k t o AF l
baculi	b ɐ AF x ʊ AF l ɪ AD
badayos	b ɐ AF d ɐ AF j AB o AF s
bagaman	b ɐ AF ɰ AB ɐ AF m a AD n
bagamat	b ɐ AF ɰ AB ɐ AF m a AD t
bagang	b ɐ AF ɰ AB a AD ŋ
bagaoisan	b ɐ AF ɰ AB ɐ AF w AC ɪ AD s ɐ AF n
baging	b a AD ɰ AB ɪ AD ŋ
bagon	b ɐ AF ɰ AB o AF n
bagsik	b ɐ AF ɡ s i AD k
bagsit	b ɐ AF ɡ s ɪ AD t
bahaghari	b ɐ AF h AA ɐ AF ɡ h AA a AD ɾ ɪ AD ʔ
bahing	b ɐ AF h AA i AD ŋ
baka	b ɐ AF x ɐ AF
bakahan	b ɐ AF x ɐ AF h AA a AD n
bakas	b ɐ AF x a AD s
baklad	b ɐ AF k l a AD d
bakulaw	b ɐ AF x u AF l a AD ʊ̯ AH
bakuna	b ɐ AF x ʊ AF n ɐ AF
bakunahan	b ɐ AF x ʊ AF n ɐ AF h AA ɐ AF n
bakuran	b ɐ AF x ʊ AF ɾ ɐ AF n
balae	b ɐ AF l ɐ AF ʔ ɛ AD
balaguer	b ɐ AF l ɐ AF ɰ AB ɛ AD ɾ
balahibo	b ɐ AF l ɐ AF h AA i AD b o AF
balakubak	b ɐ AF l ɐ AF x u AF b ɐ AF k
balasa	b ɐ AF l a AD s ɐ AF
balasabas	b ɐ AF l ɐ AF s ɐ AF b ɐ AF s
balato	b ɐ AF l a AD t o AF
balatong	b ɐ AF l a AD t o AF ŋ
balbas	b ɐ AF l b a AD s
baldonado	b ɐ AF l d o AF n ɐ AF d o AF
baligtad	b ɐ AF l ɪ AD ɡ t a AD d
balingit	b ɐ AF l ɪ AD ŋ ɪ AD t
balisacan	b ɐ AF l ɪ AD s ɐ AF x ɐ AF n
balite	b ɐ AF l ɪ AD t ɛ AD
balon	b ɐ AF l o AF n
baluga	b ɐ AF l ʊ AF ɰ AB ɐ AF ʔ
baluktot	b ɐ AF l ʊ AF k t o AF t
balwarte	b ɐ AF l w AC a AD ɾ t ɛ AD
banawa	b ɐ AF n ɐ AF w AC ɐ AF
bandila	b ɐ AF n d i AD l ɐ AF ʔ
bangaw	b a AD ŋ a AD ʊ̯ AH
bangkay	b ɐ AF ŋ k a AD ɪ̯ AG
bangkiling	b ɐ AF ŋ k ɪ AD l i AD ŋ
bango	b ɐ AF ŋ o AF
baniaga	b ɐ AF ɲ ɐ AF ɰ AB ɐ AF
banig	b ɐ AF n i AD ɡ
banlaw	b ɐ AF n l a AD ʊ̯ AH
banta	b ɐ AF n t a AD ʔ
bantay	b ɐ AF n t a AD ɪ̯ AG
bantog	b ɐ AF n t o AF ɡ
banyaga	b ɐ AF ɲ a AD ɰ AB ɐ AF ʔ
baog	b ɐ AF ʔ o AF ɡ
baon	b ɐ AF ʔ o AF n
baquiran	b ɐ AF x ɪ AD ɾ ɐ AF n
bara	b ɐ AF ɾ a AD
barado	b ɐ AF ɾ ɐ AF d o AF
baraha	b ɐ AF ɾ a AD h AA ɐ AF
barbosa	b ɐ AF ɾ b o AF s ɐ AF
barquilla	b ɐ AF ɾ k ɪ AD l l ɐ AF
barrios	b ɐ AF ɾ j AB o AF s
bartolome	b ɐ AF ɾ t o AF l o AF m ɛ AD
barya	b ɐ AF ɾ j AB a AD
basa	b ɐ AF s ɐ AF
basahan	b ɐ AF s ɐ AF h AA ɐ AF n
basco	b ɐ AF s k o AF
base	b ɐ AF s ɛ AD
basehan	b ɐ AF s ɛ AD h AA a AD n
basilan	b ɐ AF s ɪ AD l ɐ AF n
bastos	b ɐ AF s t o AF s
basurahan	b ɐ AF s ʊ AF ɾ ɐ AF h AA a AD n
basurero	b ɐ AF s ʊ AF ɾ ɛ AD ɾ o AF
batallones	b ɐ AF t ɐ AF l l o AF n ɛ AD s
batalyon	b ɐ AF t ɐ AF l j AB o AF n
batangas	b ɐ AF t ɐ AF ŋ ɡ ɐ AF s
bati	b ɐ AF t i AD ʔ
batugan	b ɐ AF t ʊ AF ɰ AB ɐ AF n
batukan	b ɐ AF t ʊ AF x ɐ AF n
batya	b ɐ AF t ʃ a AD ʔ
baunan	b ɐ AF ʔ ʊ AF n a AD n
bauzon	b a AD ʊ̯ AH s o AF n
bayabas	b ɐ AF j AB ɐ AF b ɐ AF s
bayad	b ɐ AF j AB ɐ AF d
bayawak	b ɐ AF j AB ɐ AF w AC ɐ AF k
baybayin	b a AD i̯ AG b aː AE j AB ɪ AD n
bayong	b ɐ AF j AB o AF ŋ
baywang	b ɛ AD w AC ɐ AF ŋ
bañaga	b ɐ AF ɲ ɐ AF ɰ AB ɐ AF
bejasa	b ɛ AD d ʒ ɐ AF s ɐ AF
belhiko	b ɛ AD l h AA ɪ AD x o AF
beltran	b ɛ AD l t ɾ ɐ AF n
benepisyo	b ɛ AD n ɛ AD p i AD ʃ o AF
benipayo	b ɛ AD n ɪ AD p ɐ AF j AB o AF
bergonia	b ɛ AD ɾ ɡ o AF ɲ ɐ AF
bermudez	b ɛ AD ɾ m ʊ AF d ɛ AD s
bibingka	b ɪ AD b ɪ AD ŋ k ɐ AF
bigat	b ɪ AD ɰ AB a AD t
bigti	b ɪ AD ɡ t i AD ʔ
bihag	b ɪ AD h AA a AD ɡ
bihira	b ɪ AD h AA i AD ɾ ɐ AF ʔ
bihis	b ɪ AD h AA i AD s
biik	b ɪ AD i AD k
bilangguan	b ɪ AD l ɐ AF ŋ ɡ ʊ AF ʔ ɐ AF n
bilao	b ɪ AD l a AD o AF
bilas	b ɪ AD l a AD s
bilot	b ɪ AD l o AF t
bilugan	b ɪ AD l ʊ AF ɰ AB ɐ AF n
binabae	b ɪ AD n ɐ AF b ɐ AF ʔ ɛ AD
binatilyo	b ɪ AD n ɐ AF t ɪ AD l j AB o AF
bingwit	b ɪ AD ŋ w AC i AD t
bintang	b ɪ AD n t a AD ŋ
bintog	b ɪ AD n t o AF ɡ
binuya	b ɪ AD n ʊ AF j AB ɐ AF
bisaya	b ɪ AD s a AD j AB ɐ AF ʔ
biscocho	b ɪ AD s k o AF t ʃ o AF
bisikleta	b ɪ AD s ɪ AD k l ɛ AD t ɐ AF
bisita	b ɪ AD s i AD t ɐ AF
bitay	b i AD t a AD ɪ̯ AG
biyas	b j AB a AD s
biyaya	b j AB a AD j AB ɐ AF ʔ
biyuda	b j AB u AF d ɐ AF
bobadilla	b o AF b ɐ AF d ɪ AD l l ɐ AF
bodega	b o AF d ɛ AD ɰ AB ɐ AF
bolante	b o AF l ɐ AF n t ɛ AD
bolaños	b o AF l ɐ AF ɲ o AF s
boluntaryo	b o AF l ʊ AF n t ɐ AF ɾ j AB o AF
bonifacio	b o AF n ɪ AD f ɐ AF ʃ o AF
bonilla	b o AF n ɪ AD l l ɐ AF
boongaling	b o AF o AF ŋ ɡ ɐ AF l ɪ AD ŋ
borillo	b o AF ɾ ɪ AD l l o AF
borlaza	b o AF ɾ l ɐ AF s ɐ AF
botika	b o AF t ɪ AD x ɐ AF
brillantes	b ɾ ɪ AD l l ɐ AF n t ɛ AD s
bruha	b ɾ u AF h AA ɐ AF
bubog	b ʊ AF b o AF ɡ
bubuli	b ʊ AF b ʊ AF l i AD
budhi	b ʊ AF d h AA i AD ʔ
buenafe	b ʊ AF ɛ AD n ɐ AF p ɛ AD
buga	b ʊ AF ɰ AB a AD
bugarin	b ʊ AF ɰ AB ɐ AF ɾ ɪ AD n
bugaw	b u AF ɰ AB a AD ʊ̯ AH
bugayong	b ʊ AF ɰ AB ɐ AF j AB o AF ŋ
bugtong	b ʊ AF ɡ t o AF ŋ
buhaghag	b ʊ AF h AA a AD ɡ h AA a AD ɡ
buhawi	b ʊ AF h AA a AD w AC ɪ AD ʔ
bukambibig	b ʊ AF x ɐ AF m b ɪ AD b i AD ɡ
bukas	b ʊ AF x a AD s
bukbok	b ʊ AF k b o AF k
buking	b ʊ AF x i AD ŋ
bula	b ʊ AF l a AD ʔ
bulaan	b ʊ AF l ɐ AF ʔ ɐ AF n
bulahaw	b ʊ AF l a AD h AA a AD ʊ̯ AH
bulalakaw	b ʊ AF l ɐ AF l a AD x a AD ʊ̯ AH
bulanadi	b ʊ AF l ɐ AF n ɐ AF d ɪ AD
bulanhagui	b ʊ AF l ɐ AF ŋ h AA ɐ AF ɰ AB ɪ AD
bulati	b ʊ AF l ɐ AF t ɪ AD
bulaw	b u AF l a AD ʊ̯ AH
bulbol	b ʊ AF l b o AF l
bulok	b ʊ AF l o AF k
bulutong	b ʊ AF l u AF t o AF ŋ
bulyaw	b ʊ AF l j AB a AD ʊ̯ AH
bumahing	b ʊ AF m ɐ AF h AA ɪ AD ŋ
bumbunan	b u AF m b ʊ AF n ɐ AF n
bumiyahe	b ʊ AF m j AB a AD h AA ɛ AD
bunag	b ʊ AF n ɐ AF ɡ
bunga	b ʊ AF ŋ ɐ AF
bungkos	b ʊ AF ŋ k o AF s
bungo	b ʊ AF ŋ o AF ʔ
buno	b ʊ AF n o AF ʔ
bunso	b ʊ AF ŋ s o AF ʔ
bunyi	b ʊ AF ɲ ɪ AD
buo	b ʊ AF o AF ʔ
buol	b ʊ AF ʔ o AF l
buquid	b ʊ AF x ɪ AD d
burgis	b ʊ AF ɾ ɡ ɪ AD s
buryong	b ʊ AF ɾ j AB o AF ŋ
buson	b ʊ AF s o AF n
butac	b ʊ AF t ɐ AF k
butaka	b ʊ AF t a AD x ɐ AF
buto	b ʊ AF t ʔ o AF
buwag	b w AC a AD ɡ
buwakaw	b w AC a AD x a AD ʊ̯ AH
buwanan	b ʊ AF ɐ AF n ɐ AF n
buwaya	b w AC ɐ AF j AB ɐ AF
buweltahan	b w AC ɛ AD l t ɐ AF h AA a AD n
buwisit	b w AC i AD s ɪ AD t
cabahug	k x ɐ AF b ɐ AF h AA ʊ AF ɡ
cabanayan	k x ɐ AF b ɐ AF n ɐ AF j AB ɐ AF n
cabanlit	k x ɐ AF b ɐ AF n l ɪ AD t
cabasag	k x ɐ AF b ɐ AF s ɐ AF ɡ
cabiling	k x ɐ AF b ɪ AD l ɪ AD ŋ
cabral	k x ɐ AF b ɾ ɐ AF l
cabuhat	k x ɐ AF b ʊ AF h AA ɐ AF t
cabungcal	k x ɐ AF b ʊ AF ŋ k ɐ AF l
cacdac	k x ɐ AF k d ɐ AF k
cadano	k x ɐ AF d ɐ AF n o AF
cadapan	k x ɐ AF d ɐ AF p ɐ AF n
cadayona	k x ɐ AF d ɐ AF j AB o AF n ɐ AF
cagalingan	k x ɐ AF ɰ AB ɐ AF l ɪ AD ŋ ɐ AF n
caguiat	k x ɐ AF ɡ j AB ɐ AF t
caguioa	k x ɐ AF ɰ AB ɪ AD w AC ɐ AF
calalo	k x ɐ AF l ɐ AF l o AF
calaunan	k x ɐ AF l ɐ AF ʔ ʊ AF n ɐ AF n
calaycay	k x ɐ AF l a AD ɪ̯ AG x a AD ɪ̯ AG
calinawan	k x ɐ AF l ɪ AD n ɐ AF w AC ɐ AF n
calingasan	k x ɐ AF l ɪ AD ŋ ɐ AF s ɐ AF n
calinisan	k x ɐ AF l ɪ AD n ɪ AD s ɐ AF n
calma	k x ɐ AF l m ɐ AF
campo	k x ɐ AF m p o AF
cancio	k x ɐ AF n s ɪ AD o AF
canicosa	k x ɐ AF n ɪ AD x o AF s ɐ AF
canilao	k x ɐ AF n ɪ AD l a AD ʊ̯ AH
cantiveros	k x ɐ AF n t ɪ AD b ɛ AD ɾ o AF s
cantos	k x ɐ AF n t o AF s
caparas	k x ɐ AF p ɐ AF ɾ ɐ AF s
capinpin	k x ɐ AF p ɪ AD n p ɪ AD n
cardiño	k x ɐ AF ɾ d ɪ AD ɲ o AF
cariaso	k x ɐ AF ɾ j AB ɐ AF s o AF
carillo	k x ɐ AF ɾ ɪ AD l l o AF
carrillo	k x ɐ AF ɾ ɾ ɪ AD l l o AF
casal	k x ɐ AF s ɐ AF l
casanova	k x ɐ AF s ɐ AF n o AF b ɐ AF
casao	k x ɐ AF s ɐ AF o AF
caseda	k x ɐ AF s ɛ AD d ɐ AF
castañeda	k x ɐ AF s t ɐ AF ɲ ɛ AD d ɐ AF
castrence	k x ɐ AF s t ɾ ɛ AD n s ɛ AD
catapang	k x ɐ AF t ɐ AF p ɐ AF ŋ
catibog	k x ɐ AF t ɪ AD b o AF ɡ
catimbang	k x ɐ AF t ɪ AD m b ɐ AF ŋ
catipon	k x ɐ AF t ɪ AD p o AF n
catral	k x ɐ AF t ɾ ɐ AF l
cauilan	k x ɐ AF w AC ɪ AD l ɐ AF n
cenizal	s ɛ AD n ɪ AD s ɐ AF l
cerillo	s ɛ AD ɾ ɪ AD l l o AF
ching	t ʃ ɪ AD ŋ
cinco	s ɪ AD ŋ k o AF
closa	k x l o AF s ɐ AF
collado	k x o AF l l ɐ AF d o AF
cometa	k x o AF m ɛ AD t ɐ AF
comia	k x o AF m ɪ AD ɐ AF
condez	k x o AF n d ɛ AD s
coquia	k x o AF x ɪ AD ɐ AF
corcuera	k x o AF ɾ k w AC ɛ AD ɾ ɐ AF
cornejo	k x o AF ɾ n ɛ AD d ʒ o AF
coronel	k x o AF ɾ o AF n ɛ AD l
corrales	k x o AF ɾ ɾ ɐ AF l ɛ AD s
correa	k x o AF ɾ ɾ ɛ AD ɐ AF
corro	k x o AF ɾ ɾ o AF
cosico	k x o AF s ɪ AD x o AF
cruzat	k x ɾ ʊ AF s ɐ AF t
cuasay	k w AC ɐ AF s a AD ɪ̯ AG
cubacub	k x ʊ AF b ɐ AF x ʊ AF b
cuizon	k x ʊ AF ɪ AD s o AF n
custodio	k x ʊ AF s t o AF d ʒ o AF
daan	d ɐ AF ʔ a AD n
dacanay	d ɐ AF x ɐ AF n a AD ɪ̯ AG
dado	d ɐ AF d o AF
daga	d ɐ AF ɰ AB a AD ʔ
dagat	d a AD ɰ AB ɐ AF t
dagta	d ɐ AF ɡ t a AD ʔ
dahas	d ɐ AF h AA a AD s
dahilan	d ɐ AF h AA ɪ AD l a AD n
dakip	d ɐ AF x i AD p
dalagita	d ɐ AF l ɐ AF ɰ AB ɪ AD t ɐ AF
dalang	d a AD l ɐ AF ŋ
dalaw	d a AD l a AD ʊ̯ AH
dalubhasa	d ɐ AF l ʊ AF b h AA a AD s ɐ AF ʔ
dalusong	d ɐ AF l ʊ AF s o AF ŋ
dantay	d ɐ AF n t a AD ɪ̯ AG
dapdap	d ɐ AF p d a AD p
datapwa	d ɐ AF t ɐ AF p w AC a AD ʔ
datinguinoo	d ɐ AF t ɪ AD ŋ ɪ AD n o AF o AF
daw	ɾ a AD ʊ̯ AH
daya	d a AD j AB ɐ AF ʔ
dayag	d ɐ AF j AB ɐ AF ɡ
dayami	d ɐ AF j AB ɐ AF m ɪ AD
dayanghirang	d ɐ AF j AB ɐ AF ŋ h AA ɪ AD ɾ ɐ AF ŋ
dayrit	d a AD ɪ̯ AG ɾ ɪ AD t
dazo	d ɐ AF s o AF
deang	d ʒ ɐ AF ŋ
decena	d ɛ AD s ɛ AD n ɐ AF
dee	d ɪ AD
dekada	d ɛ AD x a AD d ɐ AF
dekorasyon	d ɛ AD x o AF ɾ ɐ AF ʃ o AF n
delegasyon	d ɛ AD l ɛ AD ɰ AB ɐ AF ʃ o AF n
demonyo	d ɛ AD m o AF ɲ o AF
dentista	d ɛ AD n t i AD s t ɐ AF
depensahan	d ɛ AD p ɛ AD n s ɐ AF h AA a AD n
desisyon	d ɛ AD s ɪ AD ʃ o AF n
diamante	d ɪ AD ɐ AF m ɐ AF n t ɛ AD
dijamco	d ɪ AD d ʒ ɐ AF m k o AF
dilaw	d ɪ AD l a AD ʊ̯ AH
dimaala	d ɪ AD m ɐ AF ɐ AF l ɐ AF
dimaandal	d ɪ AD m ɐ AF ɐ AF n d ɐ AF l
dimaapi	d ɪ AD m ɐ AF ɐ AF p ɪ AD
dimacali	d ɪ AD m ɐ AF x ɐ AF l ɪ AD
dimagiba	d ɪ AD m ɐ AF ɰ AB ɪ AD b ɐ AF
dimailig	d ɪ AD m a AD ɪ̯ AG l ɪ AD ɡ
dimalaluan	d ɪ AD m ɐ AF l ɐ AF l ʊ AF ɐ AF n
dimalanta	d ɪ AD m ɐ AF l ɐ AF n t ɐ AF
dimapilis	d ɪ AD m ɐ AF p ɪ AD l ɪ AD s
dimaranan	d ɪ AD m ɐ AF ɾ ɐ AF n ɐ AF n
dimatatac	d ɪ AD m ɐ AF t ɐ AF t ɐ AF k
diokno	d ɪ AD o AF k n o AF
dipasupil	d ɪ AD p ɐ AF s ʊ AF p ɪ AD l
diplomasya	d ɪ AD p l o AF m a AD ʃ ɐ AF
disisais	d ɪ AD s ɪ AD s ɐ AF ʔ i AD s
diskumpiyado	d ɪ AD s k u AF m p j AB ɐ AF d o AF
dismayado	d ɪ AD s m ɐ AF j AB ɐ AF d o AF
diyablo	d ʒ ɐ AF b l o AF
diyamante	d ʒ a AD m a AD n t ɛ AD
diño	d ɪ AD ɲ o AF
domantay	d o AF m ɐ AF n t a AD ɪ̯ AG
domingo	d o AF m ɪ AD ŋ ɡ o AF
dueñas	d ʊ AF ɛ AD ɲ ɐ AF s
duhat	d u AF h AA ɐ AF t
dukot	d u AF x o AF t
dukwang	d ʊ AF k w AC a AD ŋ
dulay	d ʊ AF l a AD ɪ̯ AG
duldol	d ʊ AF l d o AF l
dumaguing	d ʊ AF m ɐ AF ɰ AB ɪ AD ŋ
dumating	d ʊ AF m ɐ AF t ɪ AD ŋ
dumlao	d ʊ AF m l ɐ AF o AF
dumpit	d u AF m p ɪ AD t
dumungaw	d ʊ AF m u AF ŋ a AD ʊ̯ AH
dumura	d ʊ AF m ʊ AF ɾ a AD ʔ
dungaw	d u AF ŋ a AD ʊ̯ AH
dura	d ʊ AF ɾ a AD ʔ
durante	d ʊ AF ɾ ɐ AF n t ɛ AD
duwag	d w AC a AD ɡ
dyahe	d ʒ ɐ AF h AA ɛ AD
dyaket	d ʒ a AD x ɛ AD t
dyanitor	d ʒ a AD n ɪ AD t o AF ɾ
echano	ʔ ɛ AD t ʃ ɐ AF n o AF
echevarria	ʔ ɛ AD t ʃ ɛ AD b ɐ AF ɾ j AB ɐ AF
edisyon	ʔ ɛ AD d ɪ AD ʃ o AF n
ekis	ʔ ɛ AD x ɪ AD s
ekisan	ʔ ɛ AD x ɪ AD s ɐ AF n
ekonomiya	ʔ ɛ AD x o AF n o AF m ɪ AD ɐ AF
elamparo	ʔ ɛ AD l ɐ AF m p ɐ AF ɾ o AF
elizaga	ʔ ɛ AD t ʃ ɛ AD b ɐ AF ɾ j AB ɐ AF
encarnado	ʔ ɛ AD ŋ k ɐ AF ɾ n ɐ AF d o AF
encinas	ʔ ɛ AD n s ɪ AD n ɐ AF s
endaya	ʔ ɛ AD n d ɐ AF j AB ɐ AF
epidemya	ʔ ɛ AD p ɪ AD d ɛ AD m j AB ɐ AF
ermitanyo	ʔ ɛ AD ɾ m ɪ AD t ɐ AF ɲ o AF
escalona	ʔ ɛ AD s k ɐ AF l o AF n ɐ AF
escaño	ʔ ɛ AD s k ɐ AF ɲ o AF
esguerra	ʔ ɛ AD s ɡ ɛ AD ɾ ɾ ɐ AF
eskaparate	ʔ ɛ AD s k ɐ AF p ɐ AF ɾ a AD t ɛ AD
espadahan	ʔ ɛ AD s p ɐ AF d ɐ AF h AA a AD n
espasyo	ʔ ɛ AD s p a AD ʃ o AF
espinoza	ʔ ɛ AD s p ɪ AD n o AF s ɐ AF
esquivel	ʔ ɛ AD s k ɪ AD b ɛ AD l
estabillo	ʔ ɛ AD s t ɐ AF b ɪ AD l l o AF
estrella	ʔ ɛ AD s t ɾ ɛ AD l l ɐ AF
eugenio	j AB ʊ AF h AA ɛ AD ɲ o AF
fabregas	p ɐ AF b ɾ ɛ AD ɰ AB ɐ AF s
fabros	p ɐ AF b ɾ o AF s
fajardo	p ɐ AF d ʒ ɐ AF ɾ d o AF
falcon	p ɐ AF l k o AF n
faltado	p ɐ AF l t ɐ AF d o AF
fernandez	p ɛ AD ɾ n ɐ AF n d ɛ AD s
ferriols	p ɛ AD ɾ ɾ ɪ AD o AF l s
figueras	p ɪ AD ɰ AB ɛ AD ɾ ɐ AF s
figueroa	p ɪ AD ɰ AB ɛ AD ɾ o AF ɐ AF
fojas	p o AF d ʒ ɐ AF s
fonacier	p o AF n ɐ AF s ɪ AD ɛ AD ɾ
fontelera	p o AF n t ɛ AD l ɛ AD ɾ ɐ AF
fontillas	p o AF n t ɪ AD l l ɐ AF s
forteza	p o AF ɾ t ɛ AD s ɐ AF
fortich	p o AF ɾ t ɪ AD t ʃ
frias	p ɾ ɪ AD ɐ AF s
fronda	p ɾ o AF n d ɐ AF
fuentebella	p ʊ AF ɛ AD n t ɛ AD b ɛ AD l l ɐ AF
furagganan	p ʊ AF ɾ ɐ AF ɡ ɡ ɐ AF n ɐ AF n
gabi	ɡ ɐ AF b ɪ AD
gabiana	ɡ ɐ AF b ɪ AD ɐ AF n ɐ AF
gacula	ɡ ɐ AF x ʊ AF l ɐ AF
gacusan	ɡ ɐ AF x ʊ AF s ɐ AF n
gacutan	ɡ ɐ AF x ʊ AF t ɐ AF n
galamay	ɡ ɐ AF l ɐ AF m a AD ɪ̯ AG
galapong	ɡ ɐ AF l ɐ AF p o AF ŋ
galis	ɡ ɐ AF l i AD s
gallo	ɡ ɐ AF l l o AF
gan	ɡ ɐ AF n
ganap	ɡ ɐ AF n a AD p
gancayco	ɡ ɐ AF ŋ k a AD ɪ̯ AG x o AF
gansa	ɡ ɐ AF n s a AD
ganti	ɡ ɐ AF n t i AD
ganzon	ɡ ɐ AF n s o AF n
garalde	ɡ ɐ AF ɾ ɐ AF l d ɛ AD
garapata	ɡ ɐ AF ɾ ɐ AF p ɐ AF t ɐ AF
garay	ɡ ɐ AF ɾ a AD ɪ̯ AG
garces	ɡ ɐ AF ɾ s ɛ AD s
garchitorena	ɡ ɐ AF ɾ t ʃ ɪ AD t o AF ɾ ɛ AD n ɐ AF
garciano	ɡ ɐ AF ɾ s ɪ AD ɐ AF n o AF
gascon	ɡ ɐ AF s k o AF n
gaslaw	ɡ ɐ AF s l a AD ʊ̯ AH
gasolinahan	ɡ ɐ AF s o AF l ɪ AD n ɐ AF h AA a AD n
gaspang	ɡ ɐ AF s p a AD ŋ
gaston	ɡ ɐ AF s t o AF n
gatbonton	ɡ ɐ AF t b o AF n t o AF n
gatchalian	ɡ ɐ AF t t ʃ ɐ AF l j AB ɐ AF n
gayuma	ɡ ɐ AF j AB u AF m ɐ AF
gerilya	ɡ ɛ AD ɾ ɪ AD l j AB ɐ AF
gerodias	d ʒ ɛ AD ɾ o AF d ʒ ɐ AF s
geronimo	h AA ɛ AD ɾ o AF n ɪ AD m o AF
gilagid	ɡ ɪ AD l a AD ɰ AB ɪ AD d
ginhawa	ɡ ɪ AD ŋ h AA a AD w AC ɐ AF
ginto	ɡ ɪ AD n t o AF ʔ
giron	h AA ɪ AD ɾ o AF n
gisa	ɡ ɪ AD s a AD
gitna	ɡ ɪ AD t n a AD ʔ
godoy	ɡ o AF d o AF ɪ̯ AG
gradweyt	ɡ ɾ a AD d w AC ɛ AD ɪ̯ AG t
grasa	ɡ ɾ ɐ AF s ɐ AF
grasya	ɡ ɾ a AD ʃ ɐ AF
grumadweyt	ɡ ɾ ʊ AF m a AD d w AC ɛ AD ɪ̯ AG t
guanzon	ɡ ʊ AF ɐ AF n s o AF n
gubat	ɡ ʊ AF b ɐ AF t
guerra	ɡ ɛ AD ɾ ɐ AF
gulpi	ɡ ʊ AF l p i AD
gumapac	ɡ ʊ AF m ɐ AF p ɐ AF k
gumiran	ɡ ʊ AF m ɪ AD ɾ ɐ AF n
guwantes	ɡ w AC ɐ AF n t ɛ AD s
guwardiya	ɡ w AC a AD ɾ d ʒ ɐ AF
habagat	h AA ɐ AF b a AD ɰ AB ɐ AF t
hagod	h AA a AD ɰ AB o AF d
hagok	h AA a AD ɰ AB o AF k
hagulgol	h AA ɐ AF ɰ AB ʊ AF l ɡ o AF l
hagulhol	h AA ɐ AF ɰ AB ʊ AF l h AA o AF l
hagupit	h AA ɐ AF ɰ AB ʊ AF p i AD t
halabos	h AA ɐ AF l ɐ AF b o AF s
halaga	h AA ɐ AF l ɐ AF ɰ AB a AD
halasan	h AA ɐ AF l ɐ AF s ɐ AF n
haligi	h AA ɐ AF l i AD ɰ AB ɪ AD
halik	h AA ɐ AF l i AD k
halimaw	h AA ɐ AF l ɪ AD m a AD ʊ̯ AH
hambalang	h AA ɐ AF m b a AD l ɐ AF ŋ
hamog	h AA ɐ AF m o AF ɡ
hangal	h AA ɐ AF ŋ a AD l
hapdi	h AA ɐ AF p d i AD ʔ
hapit	h AA ɐ AF p ɪ AD t
hapo	h AA ɐ AF p o AF ʔ
hapones	h AA ɐ AF p o AF n ɛ AD s
hapunan	h AA ɐ AF p ʊ AF n ɐ AF n
harana	h AA ɐ AF ɾ ɐ AF n ɐ AF
harang	h AA a AD ɾ ɐ AF ŋ
harap	h AA ɐ AF ɾ a AD p
hasik	h AA ɐ AF s i AD k
hawa	h AA ɐ AF w AC ɐ AF
hawla	h AA a AD ʊ̯ AH l ɐ AF
hayag	h AA ɐ AF j AB ɐ AF ɡ
herradura	ʔ ɛ AD ɾ ɐ AF d ʊ AF ɾ ɐ AF
higop	h AA ɪ AD ɰ AB o AF p
hilab	h AA i AD l ɐ AF b
hilaw	h AA ɪ AD l a AD ʊ̯ AH
hilera	h AA ɪ AD l ɛ AD ɾ ɐ AF
himala	h AA ɪ AD m ɐ AF l a AD ʔ
himasok	h AA ɪ AD m a AD s o AF k
himatayin	h AA ɪ AD m ɐ AF t ɐ AF j AB i AD n
hina	h AA i AD n ɐ AF ʔ
hinagpis	h AA ɪ AD n ɐ AF ɡ p i AD s
hinala	h AA ɪ AD n a AD l ɐ AF ʔ
hinga	h AA ɪ AD ŋ a AD
hinlalaki	h AA ɪ AD n l ɐ AF l ɐ AF x i AD
hinog	h AA ɪ AD n o AF ɡ
hintuturo	h AA ɪ AD n t ʊ AF t ʊ AF ɾ o AF ʔ
hipolito	h AA ɪ AD p o AF l ɪ AD t o AF
hipon	h AA ɪ AD p o AF n
hira	ç i AD r a AD ʔ
hirap	h AA ɪ AD ɾ a AD p
hithit	h AA ɪ AD t h AA i AD t
hitsura	h AA ɪ AD t ʃ u AF ɾ ɐ AF
hiwalay	h AA ɪ AD w AC ɐ AF l a AD ɪ̯ AG
hiya	h AA ɪ AD a AD ʔ
hiyaw	h AA ɪ AD a AD ʊ̯ AH
hizon	h AA ɪ AD s o AF n
homiliya	h AA o AF m ɪ AD l ɪ AD ɐ AF
hortaleza	h AA o AF ɾ t ɐ AF l ɛ AD s ɐ AF
hulog	h AA ʊ AF l o AF ɡ
humagulgol	h AA ʊ AF m ɐ AF ɰ AB ʊ AF l ɡ o AF l
humandusay	h AA ʊ AF m ɐ AF n d u AF s a AD ɪ̯ AG
huni	h AA u AF n ɪ AD
husga	h AA ʊ AF s ɡ a AD
husgado	h AA ʊ AF s ɡ ɐ AF d o AF
husgahan	h AA ʊ AF s ɡ ɐ AF h AA a AD n
huweteng	h AA ʊ AF ɛ AD t ɛ AD ŋ
ibasco	ʔ ɪ AD b ɐ AF s k o AF
igib	ʔ ɪ AD ɰ AB i AD b
ignacio	ʔ ɪ AD ɡ n ɐ AF ʃ o AF
ignoransiya	ʔ ɪ AD ɡ n o AF ɾ a AD n ʃ ɐ AF
ignorante	ʔ ɪ AD ɡ n o AF ɾ a AD n t ɛ AD
ilag	ʔ i AD l ɐ AF ɡ
ilao	ʔ ɪ AD l a AD ʊ̯ AH
iling	ʔ ɪ AD l i AD ŋ
ilog	ʔ ɪ AD l o AF ɡ
ilong	ʔ ɪ AD l o AF ŋ
ilustre	ʔ ɪ AD l ʊ AF s t ɾ ɛ AD
imahen	ʔ ɪ AD m a AD h AA ɛ AD n
imbentaryo	ʔ ɪ AD m b ɛ AD n t ɐ AF ɾ j AB o AF
imperial	ʔ ɪ AD m p ɛ AD ɾ j AB ɐ AF l
impluwensiya	ʔ ɪ AD m p l ʊ AF ɛ AD n s ɪ AD ɐ AF
importansiya	ʔ ɪ AD m p o AF ɾ t a AD n ʃ ɐ AF
importante	ʔ ɪ AD m p o AF ɾ t a AD n t ɛ AD
ina	ʔ ɪ AD n a AD
inahin	ʔ ɪ AD n ɐ AF h AA i AD n
infante	ʔ ɪ AD n p ɐ AF n t ɛ AD
ingay	ʔ ɪ AD ŋ a AD ɪ̯ AG
inggit	ʔ ɪ AD ŋ ɡ i AD t
inggitero	ʔ ɪ AD ŋ ɡ ɪ AD t ɛ AD ɾ o AF
inggo	ʔ ɪ AD ŋ ɡ o AF ʔ
ingrato	ʔ ɪ AD ŋ ɡ ɾ ɐ AF t o AF
inip	ʔ ɪ AD n i AD p
inosente	ʔ ɪ AD n o AF s ɛ AD n t ɛ AD
insulto	ʔ ɪ AD n s ʊ AF l t o AF
interbiyu	ʔ ɪ AD n t ɛ AD ɾ b ɪ AD ʊ̯ AH
interes	ʔ ɪ AD n t ɛ AD ɾ ɛ AD s
intsik	ʔ ɪ AD n t ʃ i AD k
inumin	ʔ ɪ AD n ʊ AF m ɪ AD n
inutil	ʔ ɪ AD n u AF t ɪ AD l
ipagbilin	ʔ ɪ AD p ɐ AF ɡ b ɪ AD l ɪ AD n
ipamigay	ʔ ɪ AD p ɐ AF m ɪ AD ɰ AB a AD ɪ̯ AG
ipis	ʔ i AD p ɪ AD s
irebisa	ʔ ɪ AD ɾ ɛ AD b ɪ AD s a AD
isa	ʔ ɪ AD s a AD
isagani	ʔ ɪ AD s ɐ AF ɰ AB ɐ AF n ɪ AD
isangkot	ʔ ɪ AD s ɐ AF ŋ k o AF t
ishinare	ʔ ɪ AD s h AA ɪ AD n ɛ AD ɾ
isidro	ʔ ɪ AD s ɪ AD d ɾ o AF
isisi	ʔ ɪ AD s ɪ AD s ɪ AD
iskedyul	ʔ ɪ AD s k ɛ AD d ʒ ʊ AF l
iskolar	ʔ ɪ AD s k o AF l ɐ AF ɾ
iskrip	ʔ ɪ AD s k ɾ i AD p
istorya	ʔ ɪ AD s t o AF ɾ j AB ɐ AF
itlog	ʔ ɪ AD t l o AF ɡ
ito	ʔ ɪ AD t o AF
jalandoni	d ʒ ɐ AF l ɐ AF n d o AF n ɪ AD
jamisola	d ʒ ɐ AF m ɪ AD s o AF l ɐ AF
jara	d ʒ ɐ AF ɾ ɐ AF
jaramillo	d ʒ ɐ AF ɾ ɐ AF m ɪ AD l l o AF
jaranilla	d ʒ ɐ AF ɾ ɐ AF n ɪ AD l l ɐ AF
juarez	d ʒ ʊ AF ɐ AF ɾ ɛ AD s
jumarang	d ʒ ʊ AF m ɐ AF ɾ ɐ AF ŋ
juntilla	d ʒ ʊ AF n t ɪ AD l l ɐ AF
jurado	d ʒ ʊ AF ɾ ɐ AF d o AF
jusi	d ʒ ʊ AF s ɪ AD
justiniano	d ʒ ʊ AF s t ɪ AD n ɪ AD ɐ AF n o AF
kababaihan	k x ɐ AF b ɐ AF b ɐ AF ʔ ɪ AD h AA ɐ AF n
kabaligtaran	k x ɐ AF b ɐ AF l ɪ AD ɡ t ɐ AF ɾ a AD n
kabaong	k x ɐ AF b a AD o AF ŋ
kabastusan	k x ɐ AF b ɐ AF s t ʊ AF s a AD n
kabayo	k x ɐ AF b ɐ AF j AB o AF
kaberdehan	k x ɐ AF b ɛ AD ɾ d ɛ AD h AA a AD n
kabig	k x a AD b ɪ AD ɡ
kabiling	k x ɐ AF b ɪ AD l ɪ AD ŋ
kabuwanan	k x ɐ AF b w AC ɐ AF n ɐ AF n
kadena	k x ɐ AF d ɛ AD n ɐ AF
kadugo	k x ɐ AF d ʊ AF ɰ AB o AF ʔ
kadyos	k x ɐ AF d ʒ o AF s
kagalingan	k x ɐ AF ɰ AB ɐ AF l ɪ AD ŋ ɐ AF n
kagaw	k x ɐ AF ɰ AB a AD ʊ̯ AH
kaha	k x ɐ AF h AA ɐ AF
kahabagan	k x ɐ AF h AA ɐ AF b ɐ AF ɰ AB a AD n
kahandaan	k x ɐ AF h AA ɐ AF n d ɐ AF ʔ a AD n
kahero	k x ɐ AF h AA ɛ AD ɾ o AF
kahihiyan	k x a AD h AA ɪ AD h AA ɪ AD a AD n
kahoy	k x a AD h AA o AF ɪ̯ AG
kaibigan	k x a AD ɪ̯ AG b ɪ AD ɰ AB a AD n
kakarampot	k x ɐ AF x ɐ AF ɾ ɐ AF m p o AF t
kakulangan	k x ɐ AF x ʊ AF l ɐ AF ŋ a AD n
kalaguyo	k x ɐ AF l ɐ AF ɰ AB u AF j AB o AF ʔ
kalaliman	k x ɐ AF l ɐ AF l ɪ AD m ɐ AF n
kalan	k x ɐ AF l a AD n
kalantas	k x ɐ AF l ɐ AF n t a AD s
kalaswaan	k x ɐ AF l ɐ AF s w AC ɐ AF ʔ a AD n
kalatas	k x ɐ AF l ɐ AF t a AD s
kalatsutsi	k x ɐ AF l ɐ AF t ʃ u AF t ʃ ɪ AD ʔ
kalawang	k x ɐ AF l a AD w AC ɐ AF ŋ
kalawangin	k x ɐ AF l ɐ AF w AC ɐ AF ŋ ɪ AD n
kalbaryo	k x ɐ AF l b a AD ɾ j AB o AF
kaldero	k x ɐ AF l d ɛ AD ɾ o AF
kalendaryo	k x ɐ AF l ɛ AD n d a AD ɾ j AB o AF
kalibre	k x ɐ AF l ɪ AD b ɾ ɛ AD
kalibugan	k x ɐ AF l ɪ AD b ʊ AF ɰ AB ɐ AF n
kalidad	k x ɐ AF l ɪ AD d a AD d
kaligayahan	k x ɐ AF l ɪ AD ɰ AB ɐ AF j AB ɐ AF h AA ɐ AF n
kaligkig	k x ɐ AF l ɪ AD ɡ k i AD ɡ
kalis	k x a AD l ɪ AD s
kaliskis	k x ɐ AF l ɪ AD s k ɪ AD s
kaliwanagan	k x ɐ AF l ɪ AD w AC ɐ AF n ɐ AF ɰ AB ɐ AF n
kaliwete	k x ɐ AF l ɪ AD w AC ɛ AD t ɛ AD
kalso	k x ɐ AF l s o AF
kalungsuran	k x ɐ AF l ʊ AF ŋ s ʊ AF ɾ a AD n
kaluwalhatian	k x ɐ AF l ʊ AF l ʊ AF ɐ AF l h AA ɐ AF t i AD ʔ ɐ AF n
kalyo	k x ɐ AF l j AB o AF
kamandag	k x ɐ AF m ɐ AF n d a AD ɡ
kamangmangan	k x ɐ AF m ɐ AF ŋ m ɐ AF ŋ a AD n
kamatayan	k x ɐ AF m ɐ AF t ɐ AF j AB ɐ AF n
kambal	k x ɐ AF m b ɐ AF l
kambyo	k x ɐ AF m b j AB o AF
kampana	k x ɐ AF m p a AD n ɐ AF ʔ
kampante	k x ɐ AF m p a AD n t ɛ AD
kampanya	k x ɐ AF m p ɐ AF ɲ a AD
kamukha	k x ɐ AF m ʊ AF k h AA a AD ʔ
kamunduhan	k x ɐ AF m ʊ AF n d ʊ AF h AA a AD n
kandidato	k x ɐ AF n d ɪ AD d a AD t o AF
kandila	k x ɐ AF n d i AD l ɐ AF ʔ
kanduli	k x ɐ AF n d u AF l ɪ AD ʔ
kangkungan	k x ɐ AF ŋ k ʊ AF ŋ ɐ AF n
kanina	k x ɐ AF n i AD n ɐ AF
kanino	k x ɐ AF n ɪ AD n o AF
kaniyugan	k x ɐ AF ɲ ʊ AF ɰ AB ɐ AF n
kanlong	k x ɐ AF n l o AF ŋ
kanlungan	k x ɐ AF n l ʊ AF ŋ ɐ AF n
kanselasyon	k x ɐ AF n s ɛ AD l ɐ AF ʃ o AF n
kanser	k x a AD n s ɛ AD ɾ
kanta	k x ɐ AF n t a AD
kantahin	k x ɐ AF n t ɐ AF h AA i AD n
kaopisina	k x ɐ AF o AF p ɪ AD s ɪ AD n ɐ AF
kapabayaan	k x ɐ AF p ɐ AF b ɐ AF j AB ɐ AF a AD n
kapakanan	k x ɐ AF p ɐ AF x ɐ AF n ʔ a AD n
kapalit	k x ɐ AF p ɐ AF l i AD t
kapanahunan	k x ɐ AF p ɐ AF n ɐ AF h AA ʊ AF n ɐ AF n
kapatawaran	k x ɐ AF p ɐ AF t ɐ AF w AC ɐ AF ɾ a AD n
kapiraso	k x ɐ AF p ɪ AD ɾ ɐ AF s o AF
kapitan	k x ɐ AF p ɪ AD t ɐ AF n
kaplastikan	k x ɐ AF p l ɐ AF s t ɪ AD x a AD n
kapon	k x ɐ AF p o AF n
kapre	k x ɐ AF p ɾ ɛ AD
kaputsino	k x ɐ AF p ʊ AF t ʃ ɪ AD n o AF
karakter	k x ɐ AF ɾ a AD k t ɛ AD ɾ
karambola	k x ɐ AF ɾ ɐ AF m b o AF l ɐ AF
karamihan	k x ɐ AF ɾ ɐ AF m ɪ AD h AA ɐ AF n
karampatan	k x ɐ AF ɾ ɐ AF m p a AD t ɐ AF n
karayom	k x ɐ AF ɾ ɐ AF j AB o AF m
karbon	k x ɐ AF ɾ b o AF n
karerahan	k x a AD ɾ ɛ AD ɾ ɐ AF h AA a AD n
karibal	k x ɐ AF ɾ ɪ AD b a AD l
karitela	k x ɐ AF ɾ ɪ AD t ɛ AD l ɐ AF
kariton	k x ɐ AF ɾ ɪ AD t o AF n
karo	k x a AD ɾ o AF
karpintero	k x ɐ AF ɾ p ɪ AD n t ɛ AD ɾ o AF
karton	k x ɐ AF ɾ t o AF n
karunungan	k x ɐ AF ɾ ʊ AF n ʊ AF ŋ ɐ AF n
karupukan	k x ɐ AF ɾ ʊ AF p ʊ AF x a AD n
karuwagan	k x ɐ AF ɾ ʊ AF ɐ AF ɰ AB a AD n
kasalanan	k x ɐ AF s ɐ AF l a AD n ɐ AF n
kasambahay	k x ɐ AF s ɐ AF m b ɐ AF h AA a AD ɪ̯ AG
kasera	k x ɐ AF s ɛ AD ɾ ɐ AF
kasero	k x ɐ AF s ɛ AD ɾ o AF
kaserola	k x ɐ AF s ɛ AD ɾ o AF l ɐ AF
kasiguraduhan	k x ɐ AF s ɪ AD ɰ AB ʊ AF ɾ ɐ AF d ʊ AF h AA ɐ AF n
kasintahan	k x ɐ AF s ɪ AD n t ɐ AF h AA ɐ AF n
kasinungalingan	k x ɐ AF s ɪ AD n ʊ AF ŋ ɐ AF l i AD ŋ ɐ AF n
kasoy	k x ɐ AF s o AF ɪ̯ AG
kastigo	k x ɐ AF s t ɪ AD ɰ AB o AF
kastiguhin	k x ɐ AF s t ɪ AD ɰ AB ʊ AF h AA ɪ AD n
kasubha	k x ɐ AF s u AF b h AA a AD ʔ
kataga	k x ɐ AF t ɐ AF ɰ AB a AD ʔ
katagalugan	k x ɐ AF t ɐ AF ɰ AB ɐ AF l ʊ AF ɰ AB ɐ AF n
katakawan	k x ɐ AF t ɐ AF x ɐ AF w AC ɐ AF n
katang	k x ɐ AF t a AD ŋ
katangahan	k x ɐ AF t ɐ AF ŋ ɐ AF h AA a AD n
katarata	k x ɐ AF t ɐ AF ɾ ɐ AF t ɐ AF
katawan	k x ɐ AF t ɐ AF w AC a AD n
katedral	k x ɐ AF t ɛ AD d ɾ ɐ AF l
katigbak	k x ɐ AF t ɪ AD ɡ b ɐ AF k
katiwalian	k x ɐ AF t ɪ AD w AC ɐ AF l ɪ AD a AD n
kato	k x ɐ AF t o AF ʔ
katolisismo	k x ɐ AF t o AF l ɪ AD s ɪ AD s m o AF
katungkulan	k x ɐ AF t ʊ AF ŋ k ʊ AF l ɐ AF n
katuwang	k x ɐ AF t w AC a AD ŋ
kawad	k x a AD w AC ɐ AF d
kay	k x a AD ɪ̯ AG
kendi	k x ɛ AD n d ɪ AD
ketongin	k x ɛ AD t o AF ŋ ɪ AD n
kiamzon	k x ɪ AD ɐ AF m s o AF n
kikil	k x i AD x ɪ AD l
kilikili	k x ɪ AD l ɪ AD x ɪ AD l ɪ AD
kilo	k x ɪ AD l o AF ʔ
king	k x ɪ AD ŋ
kintsay	k x ɪ AD n t ʃ a AD ɪ̯ AG
kita	k ɪ AD t a AD
kitikiti	k x ɪ AD t ɪ AD x ɪ AD t i AD
klima	k x l i AD m ɐ AF
klinika	k x l i AD n ɪ AD x ɐ AF
kolera	k x o AF l ɛ AD ɾ ɐ AF
kombinasyon	k x u AF m b ɪ AD n ɐ AF ʃ o AF n
komedya	k x o AF m ɛ AD d ʒ ɐ AF
komento	k x o AF m ɛ AD n t o AF
kometa	k x o AF m ɛ AD t ɐ AF
kompleto	k x u AF m p l ɛ AD t o AF
komplikasyon	k x u AF m p l ɪ AD x ɐ AF ʃ o AF n
komunidad	k x o AF m ʊ AF n ɪ AD d a AD d
kondenahin	k x o AF n d ɛ AD n ɐ AF h AA i AD n
kondisyon	k x o AF n d ɪ AD ʃ o AF n
konstitusyon	k x o AF n s t ɪ AD t ʊ AF ʃ o AF n
konsumisyon	k x o AF n s ʊ AF m ɪ AD ʃ o AF n
kontak	k x o AF n t ɐ AF k
kontakin	k x o AF n t ɐ AF x ɪ AD n
kontrobersiya	k x o AF n t ɾ o AF b ɛ AD ɾ ʃ ɐ AF
koral	k x o AF ɾ a AD l
korona	k x o AF ɾ o AF n ɐ AF
koronahan	k x o AF ɾ o AF n a AD h AA ɐ AF n
kotse	k x o AF t ʃ ɛ AD
krimen	k x ɾ ɪ AD m ɛ AD n
kriminal	k x ɾ ɪ AD m ɪ AD n a AD l
kritiko	k x ɾ i AD t ɪ AD x o AF
kroni	k x ɾ o AF n ɪ AD
kroniyismo	k x ɾ o AF n ɪ AD j AB ɪ AD s m o AF
kuba	k x u AF b ɐ AF ʔ
kubeta	k x ʊ AF b ɛ AD t ɐ AF
kubo	k x ʊ AF b o AF
kudkurin	k x ʊ AF d k ʊ AF ɾ i AD n
kuha	k x ʊ AF h AA ɐ AF
kulambo	k x ʊ AF l ɐ AF m b o AF ʔ
kulangi	k x ʊ AF l ɐ AF ŋ ɪ AD ʔ
kulangot	k x ʊ AF l a AD ŋ o AF t
kulimlim	k x ʊ AF l ɪ AD m l i AD m
kulugo	k x ʊ AF l ʊ AF ɰ AB o AF
kumabig	k x ʊ AF m a AD b ɪ AD ɡ
kumanta	k x ʊ AF m ɐ AF n t a AD
kumbensiyon	k x u AF m b ɛ AD n ʃ o AF n
kumbento	k x u AF m b ɛ AD n t o AF
kumbulsiyon	k x u AF m b ʊ AF l ʃ o AF n
kumpas	k x u AF m p a AD s
kumpederasyon	k x u AF m p ɛ AD d ɛ AD ɾ ɐ AF ʃ o AF n
kumpisal	k x u AF m p ɪ AD s a AD l
kumunoy	k x ʊ AF m ʊ AF n o AF ɪ̯ AG
kumupas	k x ʊ AF m ʊ AF p ɐ AF s
kumuyakoy	k x ʊ AF m ʊ AF j AB a AD x o AF ɪ̯ AG
kunan	k x ʊ AF n ɐ AF n
kupas	k x ʊ AF p a AD s
kurba	k x ʊ AF ɾ b a AD
kurbata	k x ʊ AF ɾ b ɐ AF t ɐ AF
kurot	k x ʊ AF ɾ o AF t
kursonada	k x ʊ AF ɾ s o AF n ɐ AF d ɐ AF
kurtina	k x ʊ AF ɾ t ɪ AD n ɐ AF
kusina	k x ʊ AF s ɪ AD n ɐ AF
kustodiya	k x ʊ AF s t o AF d ɪ AD ɐ AF
kuting	k x ʊ AF t i AD ŋ
kutis	k x u AF t ɪ AD s
kuto	k x ʊ AF t o AF ʔ
kutsara	k x ʊ AF t ʃ ɐ AF ɾ ɐ AF
kutson	k x ʊ AF t ʃ o AF n
kutya	k x ʊ AF t ʃ a AD ʔ
kuwan	k w AC a AD n
laba	l ɐ AF b a AD
labada	l ɐ AF b ɐ AF d ɐ AF
labag	l ɐ AF b a AD ɡ
labastida	l ɐ AF b ɐ AF s t ɪ AD d ɐ AF
labhan	l ɐ AF b h AA a AD n
labnot	l ɐ AF b n o AF t
labong	l ɐ AF b o AF ŋ
lacambra	l ɐ AF x ɐ AF m b ɾ ɐ AF
lacap	l ɐ AF x ɐ AF p
laganap	l ɐ AF ɰ AB ɐ AF n ɐ AF p
lagay	l ɐ AF ɰ AB a AD ɪ̯ AG
lagdameo	l ɐ AF ɡ d ɐ AF m ɛ AD o AF
lagmay	l ɐ AF ɡ m a AD ɪ̯ AG
lagundi	l ɐ AF ɰ AB ʊ AF n d i AD
laitin	l a AD ɪ̯ AG t ɪ AD n
lampara	l a AD m p ɐ AF ɾ ɐ AF
lampin	l ɐ AF m p i AD n
lana	l a AD n ɐ AF
landrito	l ɐ AF n d ɾ ɪ AD t o AF
langkaan	l ɐ AF ŋ k ɐ AF ʔ ɐ AF n
lanting	l ɐ AF n t ɪ AD ŋ
lantsa	l a AD n t ʃ ɐ AF
lanuza	l ɐ AF n ʊ AF s ɐ AF
lapis	l a AD p ɪ AD s
lapnos	l ɐ AF p n o AF s
lapuz	l ɐ AF p ʊ AF s
laquindanum	l ɐ AF x ɪ AD n d ɐ AF n ʊ AF m
larawan	l ɐ AF ɾ a AD w AC ɐ AF n
lascano	l ɐ AF s k ɐ AF n o AF
laspag	l ɐ AF s p a AD ɡ
lastiko	l a AD s t ɪ AD x o AF
laswa	l ɐ AF s w AC a AD ʔ
latayan	l ɐ AF t ɐ AF j AB ɐ AF n
lawa	l a AD w AC ɐ AF ʔ
lawaan	l ɐ AF w AC a AD ʔ ɐ AF n
laway	l a AD w AC a AD ɪ̯ AG
lawlaw	l a AD ʊ̯ AH l a AD ʊ̯ AH
laxamana	l ɐ AF k s ɐ AF m ɐ AF n ɐ AF
layag	l a AD j AB ɐ AF ɡ
layas	l ɐ AF j AB a AD s
laygo	l a AD ɪ̯ AG ɰ AB o AF
laylayan	l a AD ɪ̯ AG l a AD j AB ɐ AF n
laylo	l a AD ɪ̯ AG l o AF
layno	l a AD ɪ̯ AG n o AF
lazarte	l ɐ AF s ɐ AF ɾ t ɛ AD
lazatin	l ɐ AF s ɐ AF t ɪ AD n
lehitimo	l ɛ AD h AA i AD t ɪ AD m o AF
leynes	l ɛ AD ɪ̯ AG n ɛ AD s
libak	l ɪ AD b a AD k
libradilla	l ɪ AD b ɾ ɐ AF d ɪ AD l l ɐ AF
libre	l ɪ AD b ɾ ɛ AD
lichauco	l ɪ AD t ʃ a AD ʊ̯ AH x o AF
licup	l ɪ AD x ʊ AF p
ligpit	l ɪ AD ɡ p i AD t
liha	l ɪ AD h AA ɐ AF
lihim	l i AD h AA ɪ AD m
liko	l ɪ AD x o AF ʔ
limahid	l ɪ AD m a AD h AA ɪ AD d
limbaga	l ɪ AD m b ɐ AF ɰ AB ɐ AF
limjoco	l ɪ AD m d ʒ o AF x o AF
limos	l ɪ AD m o AF s
linatoc	l ɪ AD n ɐ AF t o AF k
lingad	l ɪ AD ŋ ɐ AF d
linggo	l ɪ AD ŋ ɡ o AF
lingon	l ɪ AD ŋ o AF n
linta	l ɪ AD n t a AD ʔ
liquigan	l ɪ AD x ɪ AD ɰ AB ɐ AF n
lising	l ɪ AD s ɪ AD ŋ
lislis	l ɪ AD s l i AD s
literasiya	l ɪ AD t ɛ AD ɾ ɐ AF s ɪ AD ɐ AF
litrato	l ɪ AD t ɾ ɐ AF t o AF
liwag	l ɪ AD w AC ɐ AF ɡ
lizada	l ɪ AD s ɐ AF d ɐ AF
llanera	l l ɐ AF n ɛ AD ɾ ɐ AF
llanto	l l ɐ AF n t o AF
lobo	l o AF b o AF
logarta	l o AF ɰ AB ɐ AF ɾ t ɐ AF
loko	l o AF x o AF
lola	l o AF l ɐ AF
lomibao	l o AF m ɪ AD b a AD ʊ̯ AH
lona	l o AF n ɐ AF
longhitud	l o AF ŋ h AA ɪ AD t ʊ AF d
lorenzana	l o AF ɾ ɛ AD n s ɐ AF n ɐ AF
loterya	l o AF t ɛ AD ɾ j AB ɐ AF
lozada	l o AF s ɐ AF d ɐ AF
lubak	l ʊ AF b a AD k
lubha	l ʊ AF b h AA a AD ʔ
lubiano	l ʊ AF b j AB ɐ AF n o AF
lukban	l ʊ AF k b ɐ AF n
lula	l ʊ AF l a AD ʔ
lumad	l u AF m ɐ AF d
lumagui	l ʊ AF m ɐ AF ɰ AB ɪ AD
lumanglas	l ʊ AF m ɐ AF ŋ l ɐ AF s
lumbang	l u AF m b ɐ AF ŋ
lumbao	l u AF m b a AD ʊ̯ AH
lumibao	l ʊ AF m ɪ AD b a AD ʊ̯ AH
luwag	l w AC a AD ɡ
luzano	l ʊ AF s ɐ AF n o AF
luzon	l ʊ AF s o AF n
luzuriaga	l ʊ AF s ʊ AF ɾ j AB ɐ AF ɰ AB ɐ AF
maagrabyado	m ɐ AF ʔ ɐ AF ʔ ɡ ɾ ɐ AF b j AB a AD d o AF
maangas	m ɐ AF ʔ a AD ŋ ɐ AF s
mababa	m ɐ AF b a AD b ɐ AF ʔ
mabalot	m ɐ AF b ɐ AF l o AF t
mabigat	m ɐ AF b ɪ AD ɰ AB a AD t
mabini	m ɐ AF b ɪ AD n ɪ AD
mabulaklak	m ɐ AF b ʊ AF l ɐ AF k l a AD k
maburyong	m ɐ AF b ʊ AF ɾ j AB o AF ŋ
mabuwisit	m ɐ AF b w AC i AD s ɪ AD t
macababbad	m ɐ AF x ɐ AF b ɐ AF b b ɐ AF d
macadangdang	m ɐ AF x ɐ AF d ɐ AF ŋ d ɐ AF ŋ
macalalad	m ɐ AF x ɐ AF l ɐ AF l ɐ AF d
macalindong	m ɐ AF x ɐ AF l ɪ AD n d o AF ŋ
macapagal	m ɐ AF x ɐ AF p ɐ AF ɰ AB ɐ AF l
macapinlac	m ɐ AF x ɐ AF p ɪ AD n l ɐ AF k
macapugay	m ɐ AF x ɐ AF p ʊ AF ɰ AB a AD ɪ̯ AG
macaranas	m ɐ AF x ɐ AF ɾ ɐ AF n ɐ AF s
macasaet	m ɐ AF x ɐ AF s ɐ AF ɛ AD t
macasieb	m ɐ AF x ɐ AF s ɪ AD ɛ AD b
macaspac	m ɐ AF x ɐ AF s p ɐ AF k
macatulad	m ɐ AF x ɐ AF t ʊ AF l ɐ AF d
maceda	m ɐ AF s ɛ AD d ɐ AF
macuha	m ɐ AF x ʊ AF h AA ɐ AF
madalas	m ɐ AF d ɐ AF l a AD s
madlangbayan	m ɐ AF d l ɐ AF ŋ b ɐ AF j AB ɐ AF n
madriaga	m ɐ AF d ɾ ɪ AD ɐ AF ɰ AB ɐ AF
madulas	m ɐ AF d ʊ AF l a AD s
magaling	m ɐ AF ɰ AB ɐ AF l ɪ AD ŋ
magallanes	m ɐ AF ɰ AB ɐ AF l l ɐ AF n ɛ AD s
magalona	m ɐ AF ɰ AB ɐ AF l o AF n ɐ AF
magandahan	m ɐ AF ɰ AB ɐ AF n d ɐ AF h AA a AD n
magbabaon	n ɐ AF ɡ b ɐ AF ʔ o AF n
magbanua	m ɐ AF ɡ b ɐ AF n ʊ AF ɐ AF
magbaon	m ɐ AF ɡ b ɐ AF ʔ o AF n
magbarena	m ɐ AF ɡ b ɐ AF ɾ ɛ AD n ɐ AF
magbihis	m ɐ AF ɡ b i AD h AA ɪ AD s
magbinata	m ɐ AF ɡ b ɪ AD n ɐ AF t a AD ʔ
magbiro	m ɐ AF ɡ b ɪ AD ɾ o AF ʔ
magbisikleta	m ɐ AF ɡ b ɪ AD s ɪ AD k l ɛ AD t ɐ AF
magboo	m ɐ AF ɡ b o AF o AF
magbubukid	m ɐ AF ɡ b ʊ AF b ʊ AF x i AD d
magbuhat	m ɐ AF ɡ b ʊ AF h AA ɐ AF t
magbulakbol	m ɐ AF ɡ b ʊ AF l ɐ AF k b o AF l
magdalaga	m ɐ AF ɡ d ɐ AF l ɐ AF ɰ AB a AD
magdayao	m ɐ AF ɡ d ɐ AF j AB a AD ʊ̯ AH
magdeliryo	m ɐ AF ɡ d ɛ AD l i AD ɾ j AB o AF
magdemanda	m ɐ AF ɡ d ɛ AD m ɐ AF n d ɐ AF
maghabilin	m ɐ AF ɡ h AA ɐ AF b ɪ AD l ɪ AD n
maghabla	m ɐ AF ɡ h AA ɐ AF b l a AD
maghanapbuhay	m ɐ AF ɡ h AA ɐ AF n ɐ AF p b ʊ AF h AA a AD ɪ̯ AG
maghanda	m ɐ AF ɡ h AA ɐ AF n d a AD ʔ
maghangad	m ɐ AF ɡ h AA ɐ AF ŋ a AD d
maghari	m ɐ AF ɡ h AA a AD ɾ ɪ AD ʔ
maghasik	m ɐ AF ɡ h AA ɐ AF s i AD k
maghati	m ɐ AF ɡ h AA ɐ AF t ɪ AD ʔ
maghiganti	m ɐ AF ɡ h AA ɪ AD ɰ AB ɐ AF n t i AD
maghikab	m ɐ AF ɡ h AA ɪ AD x a AD b
maghikaw	m ɐ AF ɡ h AA ɪ AD x a AD ʊ̯ AH
maghilik	m ɐ AF ɡ h AA ɪ AD l i AD k
maghimagsik	m ɐ AF ɡ h AA ɪ AD m ɐ AF ɡ s i AD k
maghimutok	m ɐ AF ɡ h AA ɪ AD m ʊ AF t o AF k
maghinala	m ɐ AF ɡ h AA ɪ AD n ɐ AF l ɐ AF ʔ
maghingalo	m ɐ AF ɡ h AA ɪ AD ŋ ɐ AF l o AF
maghinto	m ɐ AF ɡ h AA ɪ AD n t o AF ʔ
maghinuha	m ɐ AF ɡ h AA ɪ AD n u AF h AA ɐ AF ʔ
maghirang	m ɐ AF ɡ h AA ɪ AD ɾ ɐ AF ŋ
maghirap	m ɐ AF ɡ h AA ɪ AD ɾ ɐ AF p
maghiyas	m ɐ AF ɡ h AA ɪ AD a AD s
maghumpay	m ɐ AF ɡ h AA u AF m p a AD ɪ̯ AG
magkanlong	m ɐ AF ɡ k ɐ AF n l o AF ŋ
magkataon	m ɐ AF ɡ k ɐ AF t ɐ AF ʔ o AF n
maglalang	m ɐ AF ɡ l ɐ AF l ɐ AF ŋ
maglanggas	m ɐ AF ɡ l ɐ AF ŋ ɡ a AD s
maglangib	m ɐ AF ɡ l ɐ AF ŋ i AD b
maglango	m ɐ AF ɡ l ɐ AF ŋ o AF
maglantod	m ɐ AF ɡ l ɐ AF n t o AF d
maglapa	m ɐ AF ɡ l a AD p ɐ AF ʔ
maglarawan	m ɐ AF ɡ l ɐ AF ɾ ɐ AF w AC ɐ AF n
maglaro	m ɐ AF ɡ l ɐ AF ɾ o AF ʔ
maglaso	m ɐ AF ɡ l ɐ AF s o AF
maglaway	m ɐ AF ɡ l ɐ AF w AC a AD ɪ̯ AG
maglingid	m ɐ AF ɡ l ɪ AD ŋ i AD d
maglingkod	m ɐ AF ɡ l ɪ AD ŋ k o AF d
maglola	m ɐ AF ɡ l o AF l ɐ AF
maglolo	m ɐ AF ɡ l o AF l o AF
magmaliw	m ɐ AF ɡ m ɐ AF l ɪ AD ʊ̯ AH
magmartsa	m ɐ AF ɡ m ɐ AF ɾ t ʃ ɐ AF
magnakaw	m ɐ AF ɡ n a AD x a AD ʊ̯ AH
magno	m ɐ AF ɡ n o AF
magpalaganap	m ɐ AF ɡ p ɐ AF l ɐ AF ɰ AB a AD n ɐ AF p
magpanatili	m ɐ AF ɡ p ɐ AF n ɐ AF t ɪ AD l ɪ AD
magparaya	m ɐ AF ɡ p ɐ AF ɾ ɐ AF j AB ɐ AF ʔ
magpasubasta	m ɐ AF ɡ p ɐ AF s ʊ AF b ɐ AF s t ɐ AF
magpaubaya	m ɐ AF ɡ p ɐ AF ʔ ʊ AF b ɐ AF j AB ɐ AF ʔ
magpraktis	m ɐ AF ɡ p ɾ ɐ AF k t ɪ AD s
magrenta	m ɐ AF ɡ ɾ ɛ AD n t ɐ AF
magsalang	m ɐ AF ɡ s a AD l ɐ AF ŋ
magsaliksik	m ɐ AF ɡ s ɐ AF l ɪ AD k s i AD k
magsimba	m ɐ AF ɡ s ɪ AD m b a AD
magsiwalat	m ɐ AF ɡ s ɪ AD w AC a AD l ɐ AF t
magsugal	m ɐ AF ɡ s ʊ AF ɰ AB a AD l
magsuntukan	m ɐ AF ɡ s ʊ AF n t ʊ AF x ɐ AF n
magtalas	m ɐ AF ɡ t ɐ AF l ɐ AF s
magtalo	m ɐ AF ɡ t ɐ AF l o AF
magustuhan	m ɐ AF ɰ AB ʊ AF s t ʊ AF h AA a AD n
mahinay	m ɐ AF h AA ɪ AD n a AD ɪ̯ AG
mahirap	m ɐ AF h AA i AD ɾ ɐ AF p
maingay	m ɐ AF ʔ i AD ŋ a AD ɪ̯ AG
mais	m ɐ AF ʔ i AD s
makalat	m ɐ AF x a AD l ɐ AF t
makaluma	m ɐ AF x ɐ AF l u AF m ɐ AF ʔ
makapuno	m ɐ AF x ɐ AF p ʊ AF n o AF ʔ
makatotohanan	m ɐ AF x ɐ AF t o AF t o AF h AA ɐ AF n ɐ AF n
makatulog	m ɐ AF x ɐ AF t ʊ AF l o AF ɡ
makiapid	m ɐ AF x i AD ʔ ɐ AF p i AD d
makibahagi	m ɐ AF x ɪ AD b ɐ AF h AA a AD ɰ AB ɪ AD ʔ
makina	m a AD x ɪ AD n ɐ AF
makinis	m ɐ AF x ɪ AD n ɪ AD s
makipagbati	m ɐ AF x ɪ AD p ɐ AF ɡ b ɐ AF t i AD ʔ
makipagsuntukan	m ɐ AF x ɪ AD p ɐ AF ɡ s ʊ AF n t ʊ AF x ɐ AF n
makontento	m ɐ AF x o AF n t ɛ AD n t o AF
makulimlim	m ɐ AF x ʊ AF l ɪ AD m l i AD m
makunan	m ɐ AF x ʊ AF n ɐ AF n
malabuyoc	m ɐ AF l ɐ AF b ʊ AF j AB o AF k
malakanyang	m ɐ AF l ɐ AF x ɐ AF ɲ ɐ AF ŋ
malaluan	m ɐ AF l ɐ AF l ʊ AF ɐ AF n
malambot	m ɐ AF l ɐ AF m b o AF t
malas	m ɐ AF l ɐ AF s
malaswa	m ɐ AF l ɐ AF s w AC a AD ʔ
malibiran	m ɐ AF l ɪ AD b ɪ AD ɾ ɐ AF n
malicsi	m ɐ AF l ɪ AD k s ɪ AD
maligaw	m ɐ AF l ɪ AD ɰ AB a AD ʊ̯ AH
malihan	m ɐ AF l ɪ AD h AA ɐ AF n
maliksi	m ɐ AF l ɪ AD k s ɪ AD
mallare	m ɐ AF l l ɐ AF ɾ ɛ AD
mallorca	m ɐ AF l l o AF ɾ k ɐ AF
malubak	m ɐ AF l ʊ AF b a AD k
mamagitan	m ɐ AF m ɐ AF ɰ AB i AD t ɐ AF n
mamahagi	m ɐ AF m ɐ AF h AA a AD ɰ AB ɪ AD ʔ
mamakyaw	m ɐ AF m ɐ AF k j AB a AD ʊ̯ AH
mamanhikan	m ɐ AF m ɐ AF ŋ h AA ɪ AD x ɐ AF n
mamaril	m ɐ AF m ɐ AF ɾ ɪ AD l
mamasada	m ɐ AF m ɐ AF s ɐ AF d ɐ AF
mamasura	m ɐ AF m ɐ AF s ʊ AF ɾ ɐ AF
mambabae	m ɐ AF m b ɐ AF b ɐ AF ʔ ɛ AD
mambola	m ɐ AF m b o AF l ɐ AF
mamboso	m ɐ AF m b o AF s o AF
mambugaw	m ɐ AF m b u AF ɰ AB a AD ʊ̯ AH
mambuwisit	m ɐ AF m b w AC i AD s ɪ AD t
mamigay	m ɐ AF m ɪ AD ɰ AB a AD ɪ̯ AG
mamihasa	m ɐ AF m ɪ AD h AA a AD s ɐ AF ʔ
mamimili	m ɐ AF m ɪ AD m ɪ AD l ɪ AD
mamintog	m ɐ AF m ɪ AD n t o AF ɡ
mamuhunan	m ɐ AF m ʊ AF h AA ʊ AF n ɐ AF n
mamulaklak	m ɐ AF m ʊ AF l ɐ AF k l a AD k
mamuti	m ɐ AF m ʊ AF t i AD ʔ
mamuyac	m ɐ AF m ʊ AF j AB ɐ AF k
manabat	m ɐ AF n ɐ AF b ɐ AF t
manabunot	m ɐ AF n ɐ AF b ʊ AF n o AF t
managinip	m ɐ AF n ɐ AF ɰ AB i AD n ɪ AD p
manakit	m ɐ AF n ɐ AF x i AD t
manalad	m ɐ AF n ɐ AF l ɐ AF d
manalo	m ɐ AF n a AD l o AF
manaloto	m ɐ AF n ɐ AF l o AF t o AF
manamantala	m ɐ AF n ɐ AF m ɐ AF n t ɐ AF l a AD
mananahi	m ɐ AF n ɐ AF n ɐ AF h AA i AD ʔ
manananggal	m ɐ AF n ɐ AF n ɐ AF ŋ ɡ a AD l
manangan	m ɐ AF n ɐ AF ŋ ɐ AF n
mananghalian	m ɐ AF n ɐ AF ŋ h AA ɐ AF l i AD ʔ ɐ AF n
mananquil	m ɐ AF n ɐ AF ŋ k ɪ AD l
manantan	m ɐ AF n ɐ AF n t ɐ AF n
manaog	m ɐ AF n ɐ AF o AF ɡ
manaois	m ɐ AF n ɐ AF o AF ɪ̯ AG s
manarang	m ɐ AF n ɐ AF ɾ ɐ AF ŋ
manatad	m ɐ AF n ɐ AF t ɐ AF d
mancao	m ɐ AF ŋ k a AD ʊ̯ AH
mandaragat	m ɐ AF n d ɐ AF ɾ ɐ AF ɰ AB a AD t
mandirigma	m ɐ AF n d ɪ AD ɾ ɪ AD ɡ m a AD ʔ
mandocdoc	m ɐ AF n d o AF k d o AF k
mandukot	m ɐ AF n d u AF x o AF t
mandurukot	m ɐ AF n d ʊ AF ɾ u AF x o AF t
mangagat	m ɐ AF ŋ ɐ AF ɰ AB a AD t
mangailangan	m ɐ AF ŋ ɐ AF ʔ ɪ AD l ɐ AF ŋ ɐ AF n
mangalunya	m ɐ AF ŋ ɐ AF l ʊ AF ɲ a AD ʔ
mangamba	m ɐ AF ŋ ɐ AF m b a AD
mangamote	m ɐ AF ŋ ɐ AF m o AF t ɛ AD
manganak	m ɐ AF ŋ ɐ AF n a AD k
mangaoang	m ɐ AF ŋ ɐ AF w AC ɐ AF ŋ
mangaway	m ɐ AF ŋ ɐ AF w AC a AD ɪ̯ AG
manggagantso	m ɐ AF ŋ ɡ ɐ AF ɰ AB ɐ AF n t ʃ o AF
manggantso	m ɐ AF ŋ ɡ ɐ AF n t ʃ o AF
manggas	m ɐ AF ŋ ɡ a AD s
manggulo	m ɐ AF ŋ ɡ ʊ AF l o AF
manghawa	m ɐ AF ŋ h AA ɐ AF w AC ɐ AF
manghimasok	m ɐ AF ŋ h AA ɪ AD m a AD s o AF k
manghuhula	m ɐ AF ŋ h AA ʊ AF h AA u AF l ɐ AF ʔ
manghula	m ɐ AF ŋ h AA u AF l ɐ AF ʔ
manghusga	m ɐ AF ŋ h AA ʊ AF s ɡ a AD
mangikil	m ɐ AF ŋ i AD x ɪ AD l
mangilit	m ɐ AF ŋ ɪ AD l ɪ AD t
mangingisda	m ɐ AF ŋ ɪ AD ŋ ɪ AD s d a AD ʔ
mangisay	m ɐ AF ŋ ɪ AD s a AD ɪ̯ AG
mangisda	m ɐ AF ŋ ɪ AD s d a AD ʔ
mangitlog	m ɐ AF ŋ ɪ AD t l o AF ɡ
mangkok	m ɐ AF ŋ k o AF k
manglicmot	m ɐ AF ŋ l ɪ AD k m o AF t
mangoba	m ɐ AF ŋ o AF b ɐ AF
mangopya	m ɐ AF ŋ o AF p j AB ɐ AF
mangubra	m ɐ AF ŋ ʊ AF b ɾ a AD
manguiat	m ɐ AF ŋ ɪ AD ɐ AF t
mangulabnan	m ɐ AF ŋ ʊ AF l ɐ AF b n ɐ AF n
mangulangot	m ɐ AF ŋ ʊ AF l a AD ŋ o AF t
mangupit	m ɐ AF ŋ u AF p ɪ AD t
manhid	m ɐ AF ŋ h AA i AD d
maniago	m ɐ AF n ɪ AD ɐ AF ɰ AB o AF
maniego	m ɐ AF ɲ ɛ AD ɰ AB o AF
manilaw	m ɐ AF n ɪ AD l a AD ʊ̯ AH
manilip	m ɐ AF n i AD l ɪ AD p
manindigan	m ɐ AF n ɪ AD n d ɪ AD ɰ AB ɐ AF n
maniquiz	m ɐ AF n ɪ AD x ɪ AD s
manlaban	m ɐ AF n l ɐ AF b a AD n
manlait	m ɐ AF n l ɐ AF ʔ ɪ AD t
manlangit	m ɐ AF n l ɐ AF ŋ ɪ AD t
manlapaz	m ɐ AF n l ɐ AF p ɐ AF s
manlapig	m ɐ AF n l ɐ AF p ɪ AD ɡ
manloko	m ɐ AF n l o AF x o AF
manlutac	m ɐ AF n l ʊ AF t ɐ AF k
manrique	m ɐ AF n ɾ ɪ AD x ɛ AD
mansiyon	m ɐ AF n ʃ o AF n
mantika	m ɐ AF n t i AD x ɐ AF ʔ
manuhol	m ɐ AF n u AF h AA o AF l
manuntok	m ɐ AF n ʊ AF n t o AF k
mapagmatyag	m ɐ AF p ɐ AF ɡ m ɐ AF t ʃ a AD ɡ
mapagsamantala	m ɐ AF p ɐ AF ɡ s ɐ AF m ɐ AF n t ɐ AF l a AD
mapahiya	m ɐ AF p ɐ AF h AA ɪ AD a AD ʔ
mapalad	m ɐ AF p ɐ AF l ɐ AF d
mapanghusga	m ɐ AF p a AD ŋ h AA ʊ AF s ɡ a AD
mapangutya	m ɐ AF p a AD ŋ ʊ AF t ʃ a AD ʔ
mapaniil	m ɐ AF p ɐ AF n ɪ AD i AD l
mapusyaw	m ɐ AF p ʊ AF ʃ ɐ AF u AF
maralit	m ɐ AF ɾ ɐ AF l ɪ AD t
marapao	m ɐ AF ɾ ɐ AF p ɐ AF o AF
maravilla	m ɐ AF ɾ ɐ AF b ɪ AD l l ɐ AF
marbella	m ɐ AF ɾ b ɛ AD l l ɐ AF
marcial	m ɐ AF ɾ ʃ ɐ AF l
maristela	m ɐ AF ɾ ɪ AD s t ɛ AD l ɐ AF
mariñas	m ɐ AF ɾ ɪ AD ɲ ɐ AF s
marquez	m ɐ AF ɾ k ɛ AD s
marquinez	m ɐ AF ɾ k ɪ AD n ɛ AD s
marupok	m ɐ AF ɾ ʊ AF p o AF k
masabon	m ɐ AF s ɐ AF b o AF n
masaker	m ɐ AF s ɐ AF x ɛ AD ɾ
masamid	m a AD s ɐ AF m i AD d
masangcay	m ɐ AF s ɐ AF ŋ k a AD ɪ̯ AG
masangkay	m ɐ AF s ɐ AF ŋ k a AD ɪ̯ AG
maselan	m ɐ AF s ɛ AD l ɐ AF n
maski	m ɐ AF s k i AD
masukal	m ɐ AF s u AF x ɐ AF l
masurot	m ɐ AF s ʊ AF ɾ o AF t
mataasnakahoy	m ɐ AF t ɐ AF ʔ a AD s n ɐ AF x ɐ AF h AA o AF ɪ̯ AG
matae	m ɐ AF t ɐ AF ʔ ɛ AD
matalo	m ɐ AF t a AD l o AF
matatakutin	m ɐ AF t ɐ AF t ɐ AF x ʊ AF t i AD n
matauhan	m ɐ AF t ɐ AF ʔ u AF h AA ɐ AF n
matibag	m ɐ AF t ɪ AD b ɐ AF ɡ
matigas	m ɐ AF t ɪ AD ɰ AB a AD s
matisod	m ɐ AF t i AD s o AF d
matrapik	m ɐ AF t ɾ a AD p ɪ AD k
mauleon	m a AD ʊ̯ AH l ɛ AD o AF n
maunahan	m a AD ʊ̯ AH n ɐ AF h AA ɐ AF n
maya	m a AD j AB ɐ AF
mayuga	m ɐ AF j AB ʊ AF ɰ AB ɐ AF
mañago	m ɐ AF ɲ ɐ AF ɰ AB o AF
mañalac	m ɐ AF ɲ ɐ AF l ɐ AF k
medalya	m ɛ AD d a AD l j AB ɐ AF
medrano	m ɛ AD d ɾ ɐ AF n o AF
melegrito	m ɛ AD l ɛ AD ɡ ɾ ɪ AD t o AF
menchavez	m ɛ AD n t ʃ ɐ AF b ɛ AD s
menorca	m ɛ AD n o AF ɾ k ɐ AF
meryenda	m ɛ AD ɾ j AB ɛ AD n d ɐ AF
mesa	m ɛ AD s ɐ AF
michelena	m ɪ AD t ʃ ɛ AD l ɛ AD n ɐ AF
mijares	m ɪ AD d ʒ ɐ AF ɾ ɛ AD s
militante	m ɪ AD l ɪ AD t ɐ AF n t ɛ AD
minviluz	m ɪ AD n b ɪ AD l ʊ AF s
miranda	m ɪ AD ɾ ɐ AF n d ɐ AF
misteryo	m ɪ AD s t ɛ AD ɾ j AB o AF
mitsa	m ɪ AD t ʃ a AD
mondragon	m o AF n d ɾ ɐ AF ɰ AB o AF n
montealegre	m o AF n t ɛ AD ɐ AF l ɛ AD ɡ ɾ ɛ AD
montecalvo	m o AF n t ɛ AD x ɐ AF l b o AF
montejo	ʔ ɐ AF l k a AD ɪ̯ AG d ɛ AD
montillano	m o AF n t ɪ AD l l ɐ AF n o AF
montinola	m o AF n t ɪ AD n o AF l ɐ AF
montoya	m o AF n t o AF j AB ɐ AF
morato	m o AF ɾ ɐ AF t o AF
munggo	m ʊ AF ŋ ɡ o AF
mura	m u AF ɾ ɐ AF
musika	m u AF s ɪ AD x ɐ AF
musoleyo	m ʊ AF s o AF l ɛ AD j AB o AF
mutuc	m ʊ AF t ʊ AF k
nacpil	n ɐ AF k p ɪ AD l
nagbabaon	n ɐ AF ɡ b ɐ AF b ɐ AF ʔ o AF n
nagbaon	n ɐ AF ɡ b ɐ AF ʔ o AF n
nakakaalarma	n ɐ AF x ɐ AF k ɐ AF ɐ AF l ɐ AF ɾ m ɐ AF
nakakabingi	n ɐ AF x ɐ AF k ɐ AF b ɪ AD ŋ i AD
nakakabuwisit	n ɐ AF x ɐ AF k ɐ AF b w AC i AD s ɪ AD t
nakakabwisit	n ɐ AF x ɐ AF k ɐ AF b w AC i AD s ɪ AD t
nakakahawa	n ɐ AF x ɐ AF k ɐ AF h AA a AD w AC ɐ AF
nakakaintriga	n ɐ AF x ɐ AF k ɐ AF ʔ ɪ AD n t ɾ ɪ AD ɰ AB ɐ AF
nakakaloko	n ɐ AF x ɐ AF k ɐ AF l o AF x o AF
nakakatakot	n ɐ AF x ɐ AF k ɐ AF t a AD x o AF t
nakamulaga	n ɐ AF x ɐ AF m ʊ AF l ɐ AF ɰ AB a AD ʔ
nakawin	n ɐ AF x ɐ AF w AC ɪ AD n
nakpil	n ɐ AF k p ɪ AD l
nanlilimahid	n ɐ AF n l ɪ AD l ɪ AD m a AD h AA ɪ AD d
narvaez	n ɐ AF ɾ b ɐ AF ɛ AD s
natae	n ɐ AF t ɐ AF ʔ ɛ AD
navoa	n ɐ AF b o AF ɐ AF
ngalan	ŋ a AD l ɐ AF n
ngimay	ŋ ɪ AD m a AD ɪ̯ AG
nguso	ŋ ʊ AF s o AF ʔ
nguya	ŋ ʊ AF j AB ɐ AF ʔ
nicdao	n ɪ AD k d ɐ AF o AF
nietes	ɲ ɛ AD t ɛ AD s
niknik	n ɪ AD k n i AD k
nilabhan	n ɪ AD l ɐ AF b h AA a AD n
ninang	n ɪ AD n ɐ AF ŋ
niyo	ɲ o AF
nobela	n o AF b ɛ AD l ɐ AF
nobleza	n o AF b l ɛ AD s ɐ AF
nolasco	n o AF l ɐ AF s k o AF
noriega	n o AF ɾ j AB ɛ AD ɰ AB ɐ AF
notarte	n o AF t ɐ AF ɾ t ɛ AD
nuevo	n ʊ AF ɛ AD b o AF
obligacion	ʔ o AF b l ɪ AD ɰ AB ɐ AF ʃ o AF n
ocampo	ʔ o AF x ɐ AF m p o AF
olaguer	ʔ o AF l ɐ AF ɰ AB ɛ AD ɾ
olaivar	ʔ o AF l a AD ɪ̯ AG b ɐ AF ɾ
olalia	ʔ o AF l ɐ AF l ɪ AD ɐ AF
olayvar	ʔ o AF l a AD ɪ̯ AG b ɐ AF ɾ
oliva	ʔ o AF l ɪ AD b ɐ AF
olivares	ʔ o AF l ɪ AD b ɐ AF ɾ ɛ AD s
oliveros	ʔ o AF l ɪ AD b ɛ AD ɾ o AF s
ongkiko	ʔ o AF ŋ k ɪ AD x o AF
opeña	ʔ o AF p ɛ AD ɲ ɐ AF
opisyales	ʔ o AF p ɪ AD ʃ ɐ AF l ɛ AD s
opyum	ʔ o AF p j AB ʊ AF m
oracion	ʔ o AF ɾ ɐ AF ʃ o AF n
orendain	ʔ o AF ɾ ɛ AD n d a AD ɪ̯ AG n
oribello	ʔ o AF ɾ ɪ AD b ɛ AD l l o AF
pabor	p ɐ AF b o AF ɾ
paborito	p ɐ AF b o AF ɾ a AD b l ɛ AD
pacana	p ɐ AF x ɐ AF n ɐ AF
pacaña	p ɐ AF x ɐ AF ɲ ɐ AF
pader	p ɐ AF d ɛ AD ɾ
pagala	p ɐ AF ɰ AB a AD l ɐ AF ʔ
pagbasehan	p ɐ AF ɡ b ɐ AF s ɛ AD h AA ɐ AF n
pagbati	p ɐ AF ɡ b a AD t ɪ AD ʔ
pagbubuntis	p ɐ AF ɡ b ʊ AF b ʊ AF n t i AD s
pagcaliwagan	p ɐ AF ɡ k ɐ AF l ɪ AD w AC ɐ AF ɰ AB ɐ AF n
pagdilao	p ɐ AF ɡ d ɪ AD l a AD ʊ̯ AH
paggiba	p ɐ AF ɡ ɡ ɪ AD b a AD ʔ
pagi	p a AD ɰ AB ɪ AD
pagitan	p ɐ AF ɰ AB i AD t ɐ AF n
pagkakataon	p ɐ AF ɡ k ɐ AF x ɐ AF t ɐ AF ʔ o AF n
pagmamadali	p ɐ AF ɡ m ɐ AF m ɐ AF d ɐ AF l i AD ʔ
pagnanakaw	p ɐ AF ɡ n ɐ AF n a AD x a AD ʊ̯ AH
pagsamantalahan	p ɐ AF ɡ s ɐ AF m ɐ AF n t ɐ AF l ɐ AF h AA a AD n
pagsanjan	p ɐ AF ɡ s ɐ AF ŋ h AA a AD n
pagsuway	p ɐ AF ɡ s w AC a AD ɪ̯ AG
pagtakhan	p ɐ AF ɡ t ɐ AF k h AA ɐ AF n
pagtripan	p ɐ AF ɡ t ɾ ɪ AD p a AD n
pagtutulungan	p ɐ AF ɡ t ʊ AF t ʊ AF l ʊ AF ŋ a AD n
paguia	p ɐ AF ɡ j AB ɐ AF
paguio	p ɐ AF ɡ j AB o AF
pahina	p a AD h AA ɪ AD n ɐ AF
pahintulot	p ɐ AF h AA ɪ AD n t ʊ AF l o AF t
pahiyain	p ɐ AF h AA ɪ AD ɐ AF ʔ i AD n
pajares	p ɐ AF d ʒ ɐ AF ɾ ɛ AD s
pakla	p ɐ AF k l a AD
pakulo	p ɐ AF x ʊ AF l o AF ʔ
palacol	p ɐ AF l ɐ AF x o AF l
palafox	p ɐ AF l ɐ AF p o AF k s
palahaw	p ɐ AF l a AD h AA a AD ʊ̯ AH
palakol	p ɐ AF l ɐ AF x o AF l
palamuti	p ɐ AF l ɐ AF m ʊ AF t i AD ʔ
palaspas	p ɐ AF l ɐ AF s p a AD s
palayan	p ɐ AF l ɐ AF j AB a AD n
palayasin	p ɐ AF l ɐ AF j AB a AD s ɪ AD n
palima	p ɐ AF l ɪ AD m ɐ AF
palisoc	p ɐ AF l ɪ AD s o AF k
palit	p ɐ AF l i AD t
palitada	p ɐ AF l ɪ AD t ɐ AF d ɐ AF
palitadahan	p ɐ AF l ɪ AD t ɐ AF d ɐ AF h AA ɐ AF n
palitan	p ɐ AF l ɪ AD t a AD n
palomares	p ɐ AF l o AF m ɐ AF ɾ ɛ AD s
pamalo	p ɐ AF m ɐ AF l o AF ʔ
pamamanhikan	p ɐ AF m ɐ AF m ɐ AF ŋ h AA ɪ AD x ɐ AF n
pamamaril	p ɐ AF m ɐ AF m ɐ AF ɾ i AD l
pamaypay	p ɐ AF m a AD ɪ̯ AG p a AD ɪ̯ AG
pamimilosopo	p ɐ AF m ɪ AD m ɪ AD l o AF s o AF p o AF
paminta	p ɐ AF m ɪ AD n t a AD
pamintuan	p ɐ AF m ɪ AD n t ʊ AF ɐ AF n
panalangin	p ɐ AF n ɐ AF l ɐ AF ŋ ɪ AD n
panalo	p ɐ AF n a AD l o AF
pananabotahe	p ɐ AF n ɐ AF n ɐ AF b o AF t ɐ AF h AA ɛ AD
pananagutan	p ɐ AF n ɐ AF n ɐ AF ɰ AB ʊ AF t ɐ AF n
pandemya	p ɐ AF n d ɛ AD m j AB ɐ AF
panelo	p ɐ AF n ɛ AD l o AF
pangalan	p ɐ AF ŋ a AD l ɐ AF n
panghimasukan	p ɐ AF ŋ h AA ɪ AD m ɐ AF s ʊ AF x ɐ AF n
pangngalan	p ɐ AF ŋ ŋ a AD l ɐ AF n
panibughuin	p ɐ AF n ɪ AD b ʊ AF ɡ h AA u AF ʔ ɪ AD n
paninigarilyo	p ɐ AF n ɪ AD n ɪ AD ɰ AB ɐ AF ɾ ɪ AD l j AB o AF
panlaqui	p ɐ AF n l ɐ AF x ɪ AD
pansamantala	p ɐ AF n s ɐ AF m ɐ AF n t ɐ AF l a AD
pantig	p ɐ AF n t ɪ AD ɡ
panukala	p ɐ AF n ʊ AF x ɐ AF l ɐ AF ʔ
paraan	p ɐ AF ɾ ɐ AF ʔ a AD n
parada	p ɐ AF ɾ a AD d ɐ AF
paragas	p ɐ AF ɾ ɐ AF ɰ AB ɐ AF s
parayno	p ɐ AF ɾ a AD ɪ̯ AG n o AF
pareño	p ɐ AF ɾ ɛ AD ɲ o AF
pari	p a AD ɾ ɪ AD ʔ
parilla	p ɐ AF ɾ ɪ AD l l ɐ AF
parreño	p ɐ AF ɾ ɛ AD ɲ o AF
parusa	p ɐ AF ɾ u AF s ɐ AF
pasaway	p ɐ AF s ɐ AF w AC a AD ɪ̯ AG
pasiya	p ɐ AF ʃ a AD
pasko	p ɐ AF s k o AF
paskuwa	p ɐ AF s k ʊ AF ɐ AF
pasugalan	p a AD s ʊ AF ɰ AB a AD l ɐ AF n
pasukan	p ɐ AF s ʊ AF x ɐ AF n
pasulo	p ɐ AF s ʊ AF l o AF
patahian	p ɐ AF t ɐ AF h AA i AD ʔ ɐ AF n
patiag	p ɐ AF t ʃ ɐ AF ɡ
patiño	p ɐ AF t ɪ AD ɲ o AF
patnubay	p ɐ AF t n ʊ AF b a AD ɪ̯ AG
patron	p ɐ AF t ɾ o AF n
paupahan	p a AD ʊ̯ AH p ɐ AF h AA ɐ AF n
pawis	p ɐ AF w AC i AD s
payumo	p ɐ AF j AB ʊ AF m o AF
paz	p ɐ AF s
peke	p ɛ AD x ɛ AD ʔ
peklat	p ɛ AD k l ɐ AF t
pestisidyo	p ɛ AD s t ɪ AD s ɪ AD d ʒ o AF
peñaflor	p ɛ AD ɲ ɐ AF p l o AF ɾ
peñaflorida	p ɛ AD ɲ ɐ AF p l o AF ɾ ɪ AD d ɐ AF
peñaranda	p ɛ AD ɲ ɐ AF ɾ ɐ AF n d ɐ AF
piga	p ɪ AD ɰ AB a AD ʔ
pigain	p ɪ AD ɰ AB ɐ AF ʔ i AD n
pigsa	p ɪ AD ɡ s a AD ʔ
pihikan	p ɪ AD h AA i AD x ɐ AF n
pilantik	p ɪ AD l ɐ AF n t i AD k
pilantropo	p ɪ AD l a AD n t ɾ o AF p o AF
pilapil	p ɪ AD l a AD p ɪ AD l
pilat	p i AD l ɐ AF t
pilipinas	p ɪ AD l ɪ AD p ɪ AD n ɐ AF s
pilosopiya	p ɪ AD l o AF s o AF p i AD ɐ AF
pilosopo	p ɪ AD l o AF s o AF p o AF
pilyo	p ɪ AD l j AB o AF
pinaghihinalaan	p ɪ AD n ɐ AF ɡ h AA ɪ AD h AA ɪ AD n ɐ AF l a AD ɐ AF n
pinagsamantalahan	p ɪ AD n ɐ AF ɡ s ɐ AF m ɐ AF n t ɐ AF l ɐ AF h AA a AD n
pindot	p ɪ AD n d o AF t
pinggan	p ɪ AD ŋ ɡ a AD n
pinlac	p ɪ AD n l ɐ AF k
pintakasi	p ɪ AD n t ɐ AF x a AD s ɪ AD
piraso	p ɪ AD ɾ a AD s o AF
pirmahan	p ɪ AD ɾ m ɐ AF h AA a AD n
piskal	p ɪ AD s k a AD l
piskalya	p ɪ AD s k ɐ AF l j AB a AD
pista	p ɪ AD s t a AD
piyo	p j AB o AF ʔ
pizarro	p ɪ AD s ɐ AF ɾ ɾ o AF
piñon	p ɪ AD ɲ o AF n
planas	p l ɐ AF n ɐ AF s
plastik	p l ɐ AF s t ɪ AD k
policarpio	p o AF l ɪ AD x ɐ AF ɾ p j AB o AF
polintan	p o AF l ɪ AD n t ɐ AF n
portuges	p o AF ɾ t ʊ AF ɰ AB ɛ AD s
posas	p o AF s ɐ AF s
post	p o AF ʊ AF s t
prado	p ɾ ɐ AF d o AF
praning	p ɾ ɐ AF n ɪ AD ŋ
prayoridad	p ɾ ɐ AF j AB o AF ɾ ɪ AD d ɐ AF d
proklamasyon	p ɾ o AF k l ɐ AF m ɐ AF ʃ o AF n
prudente	p ɾ ʊ AF d ɛ AD n t ɛ AD
pudpod	p ʊ AF d p o AF d
pugad	p u AF ɰ AB ɐ AF d
pugo	p ʊ AF ɰ AB o AF ʔ
pugot	p ʊ AF ɰ AB o AF t
pugutan	p ʊ AF ɰ AB ʊ AF t ɐ AF n
puhunan	p ʊ AF h AA ʊ AF n ɐ AF n
pukyutan	p ʊ AF k j AB ʊ AF t ɐ AF n
pulahan	p ʊ AF l ɐ AF h AA a AD n
pulgada	p ʊ AF l ɡ ɐ AF d ɐ AF
pulgas	p ʊ AF l ɡ a AD s
pulikat	p ʊ AF l i AD x ɐ AF t
pulmonya	p ʊ AF l m o AF ɲ a AD
pulo	p ʊ AF l o AF ʔ
pulot	p ʊ AF l o AF t
pulubi	p ʊ AF l ʊ AF b ɪ AD
pulutan	p ʊ AF l ʊ AF t ɐ AF n
pumula	p ʊ AF m ʊ AF l a AD
pumutok	p ʊ AF m ʊ AF t o AF k
pundido	p ʊ AF n d i AD d o AF
punongbayan	p ʊ AF n o AF ŋ b ɐ AF j AB ɐ AF n
punsalang	p ʊ AF n s ɐ AF l ɐ AF ŋ
puntahan	p ʊ AF n t ɐ AF h AA a AD n
puntirya	p ʊ AF n t ɪ AD ɾ j AB a AD
punzalan	p ʊ AF n s ɐ AF l ɐ AF n
puson	p ʊ AF s o AF n
pusta	p ʊ AF s t a AD
pustiso	p ʊ AF s t i AD s o AF
pusyaw	p ʊ AF ʃ a AD u AF
putakti	p ʊ AF t ɐ AF k t i AD
puyod	p ʊ AF j AB o AF d
quezon	k x ɛ AD s o AF n
quiambao	k j AB ɐ AF m b a AD ʊ̯ AH
quimpo	k x ɪ AD m p o AF
quintos	k x ɪ AD n t o AF s
quirante	k x ɪ AD ɾ ɐ AF n t ɛ AD
quisumbing	k x ɪ AD s u AF m b ɪ AD ŋ
quitain	k x ɪ AD t a AD ɪ̯ AG n
quiñones	k x ɪ AD ɲ o AF n ɛ AD s
racelis	ɾ ɐ AF s ɛ AD l ɪ AD s
ragas	ɾ ɐ AF ɰ AB ɐ AF s
ragudo	ɾ ɐ AF ɰ AB ʊ AF d o AF
rali	ɾ a AD l ɪ AD
raliyista	ɾ ɐ AF l ɪ AD j AB i AD s t ɐ AF
rambol	ɾ ɐ AF m b o AF l
rambulan	ɾ ɐ AF m b ʊ AF l ɐ AF n
rantso	ɾ ɐ AF n t ʃ o AF
rason	ɾ ɐ AF s o AF n
rayos	ɾ ɐ AF j AB o AF s
razon	ɾ ɐ AF s o AF n
reaño	ɾ ɛ AD ɐ AF ɲ o AF
regala	ɾ ɛ AD ɰ AB ɐ AF l ɐ AF
regidor	ɾ ɛ AD h AA ɪ AD d o AF ɾ
rehas	ɾ ɛ AD h AA ɐ AF s
rekisito	ɾ ɛ AD x ɪ AD s ɪ AD t o AF
rekisitos	ɾ ɛ AD x ɪ AD s ɪ AD t o AF s
remigio	ɾ ɛ AD m ɪ AD h AA j AB o AF
remulla	ɾ ɛ AD m ʊ AF l l ɐ AF
reodica	ɾ ɛ AD o AF d ɪ AD x ɐ AF
resistensya	ɾ ɛ AD s ɪ AD s t ɛ AD n ʃ ɐ AF
resurreccion	ɾ ɛ AD s ʊ AF ɾ ɛ AD k ʃ o AF n
ricafort	ɾ ɪ AD x ɐ AF p o AF ɾ t
ricarte	ɾ ɪ AD x ɐ AF ɾ t ɛ AD
riles	ɾ ɪ AD l ɛ AD s
rivero	ɾ ɪ AD b ɛ AD ɾ o AF
riñon	ɾ ɪ AD ɲ o AF n
rombaoa	ɾ u AF m b ɐ AF w AC ɐ AF
romualdez	ɾ o AF m w AC ɐ AF l d ɛ AD s
romualdo	ɾ o AF m w AC ɐ AF l d o AF
roxas	ɾ o AF d ʒ ɐ AF s
rulloda	ɾ ʊ AF l l o AF d ɐ AF
rumupok	ɾ ʊ AF m ʊ AF p o AF k
sabana	s ɐ AF b ɐ AF n ɐ AF
sabangan	s ɐ AF b ɐ AF ŋ ɐ AF n
sabon	s ɐ AF b o AF n
saboy	s a AD b o AF ɪ̯ AG
sabunin	s ɐ AF b ʊ AF n i AD n
sabunot	s ɐ AF b u AF n o AF t
sabunutan	s ɐ AF b ʊ AF n ʊ AF t ɐ AF n
sacdalan	s ɐ AF k d ɐ AF l ɐ AF n
sadya	s ɐ AF d ʒ a AD ʔ
sagimuymoy	s a AD ɰ AB i AD m u AF j AB m o AF j AB
saguinsin	s ɐ AF ɰ AB ɪ AD n s ɪ AD n
sagun	s ɐ AF ɰ AB ʊ AF n
saha	s ɐ AF h AA ɐ AF ʔ
sahagun	s ɐ AF h AA ɐ AF ɰ AB ʊ AF n
sahog	s ɐ AF h AA o AF ɡ
sais	s ɐ AF ʔ i AD s
sakal	s ɐ AF x a AD l
sakit	s ɐ AF x i AD t
sakitin	s ɐ AF x ɪ AD t ɪ AD n
saksi	s ɐ AF k s i AD
saksihan	s ɐ AF k s ɪ AD h AA a AD n
sakuna	s ɐ AF x ʊ AF n a AD
sala	s a AD l ɐ AF
salagubang	s ɐ AF l ɐ AF ɰ AB ʊ AF b ɐ AF ŋ
salarin	s ɐ AF l ɐ AF ɾ i AD n
salaula	s ɐ AF l ɐ AF ʔ ʊ AF l ɐ AF ʔ
salawal	s ɐ AF l ɐ AF w AC a AD l
saldaña	s ɐ AF l d ɐ AF ɲ ɐ AF
sales	s ɐ AF l ɛ AD s
salitre	s ɐ AF l i AD t ɾ ɛ AD
salonga	s ɐ AF l o AF ŋ ɡ ɐ AF
salud	s ɐ AF l ʊ AF d
salumbides	s ɐ AF l u AF m b ɪ AD d ɛ AD s
salvacion	s ɐ AF l b ɐ AF s ɪ AD o AF n
salvatierra	s ɐ AF l b ɐ AF t ɪ AD ɛ AD ɾ ɾ ɐ AF
samaniego	s ɐ AF m ɐ AF ɲ ɛ AD ɰ AB o AF
samantala	s ɐ AF m ɐ AF n t a AD l ɐ AF ʔ
samid	s ɐ AF m i AD d
samonte	s ɐ AF m o AF n t ɛ AD
sampaloc	s ɐ AF m p ɐ AF l o AF k
sampalok	s ɐ AF m p a AD l o AF k
sangalang	s ɐ AF ŋ ɡ ɐ AF l ɐ AF ŋ
sangco	s ɐ AF ŋ k o AF
sanggol	s ɐ AF ŋ ɡ o AF l
sangkot	s ɐ AF ŋ k o AF t
sapa	s ɐ AF p ɐ AF ʔ
sapak	s ɐ AF p a AD k
sapok	s ɐ AF p o AF k
sapot	s ɐ AF p o AF t
saquing	s ɐ AF x ɪ AD ŋ
sawa	s ɐ AF w AC a AD ʔ
saway	s ɐ AF w AC a AD ɪ̯ AG
sawayin	s ɐ AF w AC ɐ AF j AB i AD n
sayson	s a AD ɪ̯ AG s o AF n
segismundo	s ɛ AD ɰ AB ɪ AD s m ʊ AF n d o AF
segui	s ɛ AD ɰ AB ɪ AD
semantika	s ɛ AD m a AD n t ɪ AD x ɐ AF
semaña	s ɛ AD m ɐ AF ɲ ɐ AF
sentenaryo	s ɛ AD n t ɛ AD n ɐ AF ɾ j AB o AF
sentensiya	s ɛ AD n t ɛ AD n ʃ ɐ AF
sentensiyahan	s ɛ AD n t ɛ AD n ʃ ɐ AF h AA a AD n
sentido	s ɛ AD n t ɪ AD d o AF
seremonya	s ɛ AD ɾ ɛ AD m o AF ɲ ɐ AF
serna	s ɛ AD ɾ n ɐ AF
shabu	ʃ ɐ AF b u AF
siason	ʃ ɐ AF s o AF n
sibayan	s ɪ AD b ɐ AF j AB ɐ AF n
sibug	s ɪ AD b ʊ AF ɡ
sibuyas	s ɪ AD b ʊ AF j AB ɐ AF s
siga	s ɪ AD ɰ AB a AD ʔ
sigarilyas	s ɪ AD ɰ AB ɐ AF ɾ ɪ AD l j AB ɐ AF s
sige	s ɪ AD ɰ AB ɛ AD
siguraduhin	s ɪ AD ɰ AB ʊ AF ɾ ɐ AF d ʊ AF h AA ɪ AD n
siko	s i AD x o AF
silayan	s ɪ AD l ɐ AF j AB ɐ AF n
silindro	s ɪ AD l ɪ AD n d ɾ o AF
simbulan	s ɪ AD m b ʊ AF l ɐ AF n
sinapupunan	s ɪ AD n ɐ AF p ʊ AF p ʊ AF n ɐ AF n
sinat	s i AD n ɐ AF t
sinauna	s ɪ AD n a AD ʊ̯ AH n ɐ AF
sinco	s ɪ AD ŋ k o AF
singil	s ɪ AD ŋ i AD l
sioson	ʃ o AF s o AF n
siping	s i AD p ɪ AD ŋ
sipon	s ɪ AD p ʔ o AF n
sipsip	s ɪ AD p s ɪ AD p
sira	s ɪ AD ɾ a AD ʔ
sirain	s ɪ AD ɾ a AD ʔ ɪ AD n
sisi	s i AD s ɪ AD
sisid	s i AD s ɪ AD d
sisihan	s ɪ AD s ɪ AD h AA a AD n
sitwasyon	s ɪ AD t w AC ɐ AF ʃ o AF n
siya	ʃ a AD
sobrepeña	s o AF b ɾ ɛ AD p ɛ AD ɲ ɐ AF
soledad	s o AF l ɛ AD d ɐ AF d
solis	s o AF l ɪ AD s
sosa	s o AF s ɐ AF
suazo	s w AC ɐ AF s o AF
sucgang	s ʊ AF k ɡ ɐ AF ŋ
sugal	s ʊ AF ɰ AB a AD l
suico	s ʊ AF ɪ AD x o AF
suka	s u AF x ɐ AF ʔ
sukal	s u AF x ɐ AF l
sulsol	s ʊ AF l s o AF l
sumadsad	s ʊ AF m ɐ AF d s ɐ AF d
sumemplang	s ʊ AF m ɛ AD m p l ɐ AF ŋ
suntok	s ʊ AF n t o AF k
suntukan	s ʊ AF n t ʊ AF x ɐ AF n
suntukin	s ʊ AF n t ʊ AF x i AD n
supling	s ʊ AF p l i AD ŋ
surot	s ʊ AF ɾ o AF t
sustento	s ʊ AF s t ɛ AD n t o AF
taduran	t ɐ AF d ʊ AF ɾ ɐ AF n
tagapagmana	t ɐ AF ɰ AB ɐ AF p ɐ AF ɡ m ɐ AF n ɐ AF
tagas	t ɐ AF ɰ AB ɐ AF s
tagiktik	t ɐ AF ɰ AB ɪ AD k t i AD k
tagtuyot	t ɐ AF ɡ t ʊ AF j AB o AF t
taguba	t ɐ AF ɰ AB ʊ AF b ɐ AF
tagubilin	t ɐ AF ɰ AB ʊ AF b ɪ AD l ɪ AD n
taguinod	t ɐ AF ɰ AB ɪ AD n o AF d
tagupa	t ɐ AF ɰ AB ʊ AF p ɐ AF
takahashi	t ɐ AF x ɐ AF h AA ɐ AF ʃ ɪ AD
talag	t ɐ AF l ɐ AF ɡ
talampas	t ɐ AF l ɐ AF m p ɐ AF s
talavera	t ɐ AF l ɐ AF b ɛ AD ɾ ɐ AF
talento	t ɐ AF l ɛ AD n t o AF
talo	t ɐ AF l o AF
talong	t ɐ AF l o AF ŋ
talukbong	t ɐ AF l ʊ AF k b o AF ŋ
talunan	t ɐ AF l ʊ AF n a AD n
tamban	t ɐ AF m b a AD n
tamis	t ɐ AF m i AD s
tampal	t ɐ AF m p a AD l
tanauan	t ɐ AF n ʔ ɐ AF w AC ɐ AF n
tancinco	t ɐ AF n s ɪ AD ŋ k o AF
tangco	t ɐ AF ŋ k o AF
tanghalian	t ɐ AF ŋ h AA ɐ AF l ɪ AD ʔ ɐ AF n
tanikala	t ɐ AF n ɪ AD x ɐ AF l a AD ʔ
tanso	t ɐ AF n s o AF ʔ
tantiya	t ɐ AF n t ʃ ɐ AF
taon	t ɐ AF ʔ o AF n
tapales	t ɐ AF p ɐ AF l ɛ AD s
tapilok	t ɐ AF p ɪ AD l o AF k
tarik	t ɐ AF ɾ i AD k
taruc	t ɐ AF ɾ ʊ AF k
tasa	t ɐ AF s a AD
tatlonghari	t ɐ AF t l o AF ŋ h AA ɐ AF ɾ ɪ AD
tato	t ɐ AF t o AF ʔ
tañada	t ɐ AF ɲ ɐ AF d ɐ AF
tenyente	t ɛ AD ɲ ɛ AD n t ɛ AD
teoriya	t ɛ AD o AF ɾ i AD ɐ AF
teritoryo	t ɛ AD ɾ ɪ AD t o AF ɾ j AB o AF
tiamson	t ʃ ɐ AF m s o AF n
tiangco	t ʃ ɐ AF ŋ k o AF
tibay	t i AD b a AD ɪ̯ AG
tiburcio	t ɪ AD b ʊ AF ɾ ʃ o AF
ticzon	t ɪ AD k s o AF n
tigang	t ɪ AD ɰ AB a AD ŋ
tigas	t ɪ AD ɰ AB a AD s
tiis	t ɪ AD ʔ i AD s
tikbalang	t ɪ AD k b a AD l ɐ AF ŋ
tiklop	t ɪ AD k l o AF p
tiktik	t ɪ AD k t i AD k
timbang	t ɪ AD m b a AD ŋ
tindero	t ɪ AD n d ɛ AD ɾ o AF
tindig	t ɪ AD n d i AD ɡ
tinga	t ɪ AD ŋ a AD
tingala	t ɪ AD ŋ ɐ AF l a AD ʔ
tingalaan	t ɪ AD ŋ ɐ AF l ɐ AF a AD n
tingin	t ɪ AD ŋ i AD n
tinidor	t ɪ AD n ɪ AD d o AF ɾ
tinik	t ɪ AD n i AD k
tinta	t ɪ AD n t a AD
tio	t ʃ o AF
tiongco	t ɪ AD o AF ŋ k o AF
tiozon	t ʃ o AF s o AF n
tipaklong	t ɪ AD p a AD k l o AF ŋ
tira	t ɪ AD ɾ a AD
tiraniya	t ɪ AD ɾ ɐ AF n i AD ɐ AF
tirik	t ɪ AD ɾ i AD k
tiris	t ɪ AD ɾ i AD s
tirona	t ɪ AD ɾ o AF n ɐ AF
tiwali	t ɪ AD w AC ɐ AF l i AD ʔ
tiya	t ɪ AD ɐ AF
tiyaga	t ɪ AD ɐ AF ɰ AB a AD ʔ
tiyahin	t ʃ ɐ AF h AA ɪ AD n
tiyan	t ʃ a AD n
tiyanak	t ʃ a AD n ɐ AF k
tiyangge	t ʃ a AD ŋ ɡ ɛ AD ʔ
tiyo	t ɪ AD o AF
tiyuhin	t ʃ ʊ AF h AA ɪ AD n
tonelada	t o AF n ɛ AD l ɐ AF d ɐ AF
topacio	t o AF p ɐ AF ʃ o AF
torrecampo	t o AF ɾ ɾ ɛ AD x ɐ AF m p o AF
totanes	t o AF t ɐ AF n ɛ AD s
trangkaso	t ɾ ɐ AF ŋ k a AD s o AF
trapik	t ɾ a AD p ɪ AD k
traqueña	t ɾ ɐ AF x ɛ AD ɲ ɐ AF
tratado	t ɾ ɐ AF t a AD d o AF
traydor	t ɾ a AD ɪ̯ AG d o AF ɾ
tren	t ɾ ɛ AD n
tria	t ɾ ɪ AD ɐ AF
trillanes	t ɾ ɪ AD l l ɐ AF n ɛ AD s
trip	t ɾ ɪ AD p
tsikinini	t ʃ ɪ AD x ɪ AD n i AD n ɪ AD ʔ
tsikot	t ʃ ɪ AD x o AF t
tuason	t w AC ɐ AF s o AF n
tuba	t ʊ AF b a AD
tubero	t ʊ AF b ɛ AD ɾ o AF
tubo	t ʊ AF b o AF
tubuhan	t ʊ AF b ʊ AF h AA a AD n
tugade	t ʊ AF ɰ AB ɐ AF d ɛ AD
tugtog	t ʊ AF ɡ t o AF ɡ
tukod	t u AF x o AF d
tukso	t ʊ AF k s o AF
tulad	t u AF l ɐ AF d
tulak	t u AF l ɐ AF k
tulay	t ʊ AF l a AD ɪ̯ AG
tulingan	t ʊ AF l ɪ AD ŋ ɐ AF n
tullao	t ʊ AF l j AB a AD ʊ̯ AH
tuloy	t ʊ AF l o AF ɪ̯ AG
tumacder	t ʊ AF m ɐ AF k d ɛ AD ɾ
tumae	t ʊ AF m ɐ AF ʔ ɛ AD
tumbaga	t u AF m b ɐ AF ɰ AB ɐ AF
tumbalik	t u AF m b ɐ AF l ɪ AD k
tumingala	t ʊ AF m ɪ AD ŋ ɐ AF l a AD ʔ
tumira	t ʊ AF m ɪ AD ɾ ɐ AF
tumukso	t ʊ AF m ʊ AF k s o AF
tunay	t u AF n a AD ɪ̯ AG
tungaw	t ʊ AF ŋ a AD ʊ̯ AH
tungkab	t ʊ AF ŋ k a AD b
tungkod	t ʊ AF ŋ k o AF d
tungkol	t ʊ AF ŋ k o AF l
tungkos	t ʊ AF ŋ k o AF s
tunton	t ʊ AF n t o AF n
tupad	t ʊ AF p a AD d
tupi	t ʊ AF p i AD ʔ
turnilyo	t ʊ AF ɾ n i AD l j AB o AF
turok	t ʊ AF ɾ o AF k
tutol	t ʊ AF t o AF l
tuwa	t w AC a AD ʔ
tuwad	t w AC a AD d
tuwalya	t w AC ɐ AF l j AB ɐ AF
tuwang	t w AC a AD ŋ
ubas	ʔ ʊ AF b ɐ AF s
ubasan	ʔ ʊ AF b ɐ AF s a AD n
udyukan	ʔ ʊ AF d ʒ ʊ AF x a AD n
ugat	ʔ ʊ AF ɰ AB a AD t
ulep	ʔ ʊ AF l ɛ AD p
ulila	ʔ ʊ AF l i AD l ɐ AF
uling	ʔ u AF l ɪ AD ŋ
umasinta	ʔ ʊ AF m ɐ AF s ɪ AD n t a AD
umawat	ʔ ʊ AF m a AD w AC ɐ AF t
umpisa	ʔ u AF m p ɪ AD s a AD
umutot	ʔ ʊ AF m ʊ AF t o AF t
untalan	ʔ ʊ AF n t ɐ AF l ɐ AF n
upa	ʔ ʊ AF p ɐ AF
uriarte	ʔ ʊ AF ɾ j AB ɐ AF ɾ t ɛ AD
ursua	ʔ ʊ AF ɾ s ʊ AF ɐ AF
usap	ʔ u AF s ɐ AF p
usisero	ʔ ʊ AF s ɪ AD s ɛ AD ɾ o AF
utot	ʔ ʊ AF t o AF t
uwak	ʔ ʊ AF a AD k
uwi	ʔ ʊ AF i AD ʔ
valera	b ɐ AF l ɛ AD ɾ ɐ AF
valle	b ɐ AF l l ɛ AD
valmores	b ɐ AF l m o AF ɾ ɛ AD s
varias	b ɐ AF ɾ ɪ AD ɐ AF s
varona	b ɐ AF ɾ o AF n ɐ AF
vecino	b ɛ AD s ɪ AD n o AF
velarde	b ɛ AD l ɐ AF ɾ d ɛ AD
velasquez	b ɛ AD l ɐ AF s k ɛ AD s
veloria	b ɛ AD l o AF ɾ j AB ɐ AF
veneracion	b ɛ AD n ɛ AD ɾ ɐ AF ʃ o AF n
venturina	b ɛ AD n t ʊ AF ɾ ɪ AD n ɐ AF
versoza	b ɛ AD ɾ s o AF s ɐ AF
villablanca	b ɪ AD l l ɐ AF b l ɐ AF ŋ k ɐ AF
villacarlos	b ɪ AD l l ɐ AF x ɐ AF ɾ l o AF s
villafranca	b ɪ AD l l ɐ AF p ɾ ɐ AF ŋ k ɐ AF
villafuerte	b ɪ AD l l ɐ AF p w AC ɛ AD ɾ t ɛ AD
villagracia	b ɪ AD l l ɐ AF ɡ ɾ ɐ AF ʃ ɐ AF
villamater	b ɪ AD l l ɐ AF m ɐ AF t ɛ AD ɾ
villamin	b ɪ AD l l ɐ AF m ɪ AD n
villamor	b ɪ AD l l ɐ AF m o AF ɾ
villapando	b ɪ AD l l ɐ AF p ɐ AF n d o AF
villareal	b ɪ AD l l ɐ AF ɾ ɛ AD ɐ AF l
villarino	b ɪ AD l l ɐ AF ɾ ɪ AD n o AF
villaruz	b ɪ AD l l ɐ AF ɾ ʊ AF s
villaseñor	b ɪ AD l l ɐ AF s ɛ AD ɲ o AF ɾ
villasis	b ɪ AD l l ɐ AF s ɪ AD s
villaverde	b ɪ AD l l ɐ AF b ɛ AD ɾ d ɛ AD
villavicencio	b ɪ AD l l ɐ AF b ɪ AD s ɛ AD n ʃ o AF
villegas	b ɪ AD l l ɛ AD ɰ AB ɐ AF s
vinoya	b ɪ AD n o AF j AB ɐ AF
virata	b ɪ AD ɾ ɐ AF t ɐ AF
virrey	b ɪ AD ɾ ɾ ɛ AD ɪ̯ AG
visaya	b ɪ AD s ɐ AF j AB ɐ AF ʔ
volante	b o AF l ɐ AF n t ɛ AD
wang	w AC ɐ AF ŋ
wangis	w AC a AD ŋ ɪ AD s
yalung	j AB ɐ AF l ʊ AF ŋ
yarda	j AB ɐ AF ɾ d ɐ AF
yasay	j AB ɐ AF s a AD ɪ̯ AG
yatco	j AB ɐ AF t k o AF
ybañez	ʔ ɪ AD b ɐ AF ɲ ɛ AD s
yuvienco	j AB ʊ AF b ɪ AD ɛ AD ŋ k o AF
yñiguez	j AB ɲ ɪ AD ɰ AB ɛ AD s
zafra	s ɐ AF p ɾ ɐ AF
zaide	s a AD ɪ̯ AG d ɛ AD
zapanta	s ɐ AF p ɐ AF n t ɐ AF
zavalla	s ɐ AF b ɐ AF l l ɐ AF
zoleta	s o AF l ɛ AD t ɐ AF
zuñiga	s ʊ AF ɲ ɪ AD ɰ AB ɐ AF
