't	t
'y	i AD
aa	ʔ a AD a AD ʔ
aam	ʔ a AD a AD m
aba	ʔ a AD b a AD ʔ
abadiano	a AD b a AD d d ʒ a AD n o AF
abaka	a AD b a AD k a AD
abako	a AD b a AD k o AF
abakus	a AD b a AD k u AF s
abala	ɐ AF b ɐ AF l a AD
abalos	ʔ a AD b a AD l o AF s
abandonado	ʔ a AD b a AD n d o AF n a AD d o AF
abangan	ʔ a AD b a AD ŋ a AD n
abaniko	ʔ a AD b a AD n i AD k o AF
abay	ʔ a AD b a AD j AB
abayan	ʔ a AD b a AD j AB a AD n
abejuela	ʔ a AD b ɛ AD d ʒ u AF ɛ AD l a AD
abelgas	ʔ a AD b ɛ AD l ɡ a AD s
abellera	ʔ a AD b ɛ AD l l ɛ AD ɾ a AD
abenida	a AD b ɛ AD n iː AE d a AD
aberya	ɑ AD b ɛ AD r j AB ɑ AD
abing	ʔ a AD b i AD ŋ
abiso	a AD b i AD s ɔ AF
abisuhan	ʔ a AD b i AD s u AF h AA a AD n
abitsuwelas	a AD b i AD t s u AF ɛ AD l a AD s
abnoy	a AD b n ɔ AF j AB
abo	ʔ a AD b o AF
abogasya	ɑ AD b ɔ AF ɡ ɑ AD ɕ ɑ AD
aborsyonista	ɑ AD b ɔ AF r ɕ ɔ AF n i AD s t ɑ AD
abot	ʔ a AD b ɔ AF t
abrasyete	ɑ AD b r ɑ AD ɕ ɛ AD t ɛ AD
abrazado	ʔ a AD b ɾ a AD s a AD d o AF
abrenica	ʔ a AD b ɾ ɛ AD n i AD k a AD
abril	a AD b ɾ i AD l
abueg	ʔ a AD b w AC ɛ AD ɡ
abulencia	ʔ a AD b u AF l ɛ AD n s j AB a AD
abusado	ʔ a AD b u AF s a AD d o AF
abusuhin	ʔ a AD b u AF s u AF h AA i AD n
abutin	ʔ a AD b u AF t i AD n
abyad	ʔ a AD b j AB a AD d
abyador	ʔ a AD b j AB a AD d o AF ɾ
abyasyon	ɑ AD b j AB ɑ AD ɕ ɔ AF n
acierto	ʔ a AD s j AB ɛ AD ɾ t o AF
acorda	ʔ a AD k o AF ɾ d a AD
acuzar	ʔ a AD k u AF s a AD ɾ
adajar	ʔ a AD d a AD d ʒ a AD ɾ
adelpa	a AD d e AD l p a AD
adidas	a AD d i AD d a AD s
adik	ʔ a AD d i AD k
adiksyon	ɑ AD d i AD k̚ ɕ ɔ AF n
adisyunal	ɑ AD d i AD ɕ u AF n ɑ AD l
adlawan	ʔ a AD d l a AD w AC a AD n
administrasyon	ɑ AD d m i AD n i AD s t r ɑ AD ɕ ɔ AF n
adopsyon	ɑ AD d ɔ AF p̚ ɕ ɔ AF n
adres	ʔ a AD d ɾ ɛ AD s
adrias	ʔ a AD d ɾ i AD a AD s
adyenda	ɑ AD dʲ ɛ AD n d ɑ AD
afam	a AD f a AD m
agamahan	ʔ a AD ɡ a AD m a AD h AA a AD n
agapay	ʔ a AD ɡ a AD p a AD i AD
agaran	ʔ a AD ɡ a AD ɾ a AD n
agbarog	ʔ a AD ɡ b a AD ɾ o AF ɡ
agbarugan	ʔ a AD ɡ b a AD ɾ u AF ɡ a AD n
aghamwika	a AD ɡ h AA a AD m w AC i AD k a AD ʔ
aghimo	ʔ a AD ɡ h AA i AD m o AF ʔ
aghimuan	ʔ a AD ɡ h AA i AD m u AF ʔ a AD n
aghimuin	ʔ a AD ɡ h AA i AD m u AF ʔ i AD n
agila	ʔ a AD ɡ i AD l a AD
agimat	ʔ a AD ɡ i AD m a AD t
agimatan	ʔ a AD ɡ i AD m a AD t a AD n
agiw	ʔ a AD ɡ i AD u AF
agosto	a AD ɡ o AF s t o AF
agrabyado	ʔ a AD ɡ ɾ a AD b j AB a AD d o AF
agsikap	ʔ a AD ɡ s i AD k a AD p
agsikapan	ʔ a AD ɡ s i AD k a AD p a AD n
aguas	ʔ a AD ɡ u AF a AD s
aguda	ʔ a AD ɡ u AF d a AD
aguilera	ʔ a AD ɡ i AD l ɛ AD ɾ a AD
aguirre	ʔ a AD ɡ i AD ɾ ɛ AD
agustin	ʔ a AD ɡ u AF s t i AD n
agwa	a AD ɡ w AC ɐ AF
agwat	ʔ a AD ɡ w AC a AD t
ahensya	ɑ AD ɦ AA ɛ AD n ɕ ɑ AD
aklat	ɐ AF k l a AD t
aklatan	ɐ AF k l aː AE t ɐ AF n
aksayado	ʔ a AD k s a AD j AB a AD d o AF
alam	ɐ AF l a AD m
alambre	ʔ a AD l a AD m b ɾ ɛ AD
alamin	ʔ a AD l a AD m i AD n
alcaide	ʔ a AD l k a AD i AD d ɛ AD
aldover	ʔ a AD l d o AF b ɛ AD ɾ
alegre	ʔ a AD l ɛ AD ɡ ɾ ɛ AD
alfaro	a AD l f a AD ɾ o AF
alila	ʔ a AD l i AD l a AD ʔ
alimasag	ʔ a AD l i AD m a AD s a AD ɡ
alimuom	a AD l i AD m u AF o AF m
alipin	ʔ a AD l i AD p i AD n
alis	ʔ a AD l i AD s
almaden	ʔ a AD l m a AD d ɛ AD n
almarez	ʔ a AD l m a AD ɾ ɛ AD s
almario	ʔ a AD l m a AD ɾ i AD o AF
almendrala	ʔ a AD l m ɛ AD n d ɾ a AD l a AD
almirol	ʔ a AD l m i AD ɾ o AF l
almohadilya	a AD l m o AF h AA a AD d i AD l j AB a AD ʔ
alonte	ʔ a AD l o AF n t ɛ AD
alonto	ʔ a AD l o AF n t o AF
alperes	ʔ a AD l p ɛ AD ɾ ɛ AD s
altapresyon	ʔ a AD l t a AD p ɾ ɛ AD s j AB o AF n
alulod	ɐ AF l u AF l ɔ AF d
alusitha	ʔ a AD l u AF s i AD t h AA a AD ʔ
alviar	ʔ a AD l b j AB a AD ɾ
alzaga	a AD l s a AD ɡ a AD
amante	ʔ a AD m a AD n t ɛ AD
ambag	ʔ a AD m b a AD ɡ
amerikana	ʔ a AD m ɛ AD ɾ i AD k a AD n a AD
amin	ʔ a AD m i AD n
aminado	ʔ a AD m i AD n a AD d o AF
aming	a AD m i AD ŋ
aminin	a AD m i AD n i AD n
amo	ʔ a AD m o AF
amon	ʔ a AD m o AF n
amoranto	ʔ a AD m o AF ɾ a AD n t o AF
ampaw	ʔ a AD m p a AD u AF
amurao	ʔ a AD m u AF ɾ a AD u AF
analisis	ʔ a AD n a AD l i AD s i AD s
anatomiya	ʔ a AD n a AD t o AF m i AD a AD
anay	ʔ a AD n a AD i AD
anayin	ʔ a AD n a AD j AB i AD n
anda	a AD n d a AD
andal	ʔ a AD n d a AD l
andaya	a AD n d a AD y AF a AD
ang	a AD ŋ
anga	ʔ a AD ŋ a AD
angaw	a AD ŋ a AD w AC
anggo	ʔ a AD ŋ ɡ o AF
anghel	ʔ a AD ŋ h AA ɛ AD l
angis	ʔ a AD ŋ i AD s
angkla	ʔ a AD ŋ k l a AD
ango	ʔ a AD ŋ o AF
angot	ʔ a AD ŋ o AF t
anim	ʔ a AD n i AD m
animnapu	a AD n i AD m n a AD p u AF ʔ
anis	ʔ a AD n i AD s
ano	a AD n o AF
anos	ʔ a AD n o AF s
anta	ʔ a AD n t a AD
antas	ʔ a AD n t a AD s
antipona	ʔ a AD n t i AD p o AF n a AD
antok	ʔ a AD n t o AF k
antukin	ʔ a AD n t u AF k i AD n
anunsyo	ɑ AD n u AF n ɕ ɔ AF
anyayahan	ʔ a AD n j AB a AD j AB a AD h AA a AD n
apahap	ʔ a AD p a AD h AA a AD p
apalit	ʔ a AD p a AD l i AD t
apat	a AD p a AD t
apatnapu	a AD p a AD t n a AD p u AF ʔ
apatnaraan	a AD p a AD t n a AD r a AD a AD n
apela	ʔ a AD p ɛ AD l a AD
apilado	ʔ a AD p i AD l a AD d o AF
apostasiya	ʔ a AD p o AF s t a AD s i AD a AD
aral	a AD ɾ ɐ AF l
aranda	ʔ a AD ɾ a AD n d a AD
araw	ɐ AF ɾ a AD w AC
aray	ʔ a AD ɾ a AD i AD
arañas	ʔ a AD ɾ a AD ɲ a AD s
arce	ʔ a AD ɾ s ɛ AD
arcega	ʔ a AD ɾ s ɛ AD ɡ a AD
arceo	ʔ a AD ɾ s ɛ AD o AF
arcilla	ʔ a AD ɾ s i AD l l a AD
arcillas	ʔ a AD ɾ s i AD l l a AD s
arcinas	ʔ a AD ɾ s i AD n a AD s
arenas	ʔ a AD ɾ ɛ AD n a AD s
arevalo	ʔ a AD ɾ ɛ AD b a AD l o AF
argente	ʔ a AD ɾ ɡ ɛ AD n t ɛ AD
arguelles	a AD ɾ ɡ w AC e AD l j AB e AD s
arkila	ʔ a AD ɾ k i AD l a AD
arlene	a AD r l i AD n
arnibal	a AD r n i AD b a AD l
arquiza	ʔ a AD ɾ k i AD s a AD
arriola	ʔ a AD ɾ i AD o AF l a AD
arrogante	ʔ a AD ɾ o AF ɡ a AD n t ɛ AD
artiaga	ʔ a AD ɾ t j AB a AD ɡ a AD
artista	a AD r t i AD s t a AD
arzadon	ʔ a AD ɾ s a AD d o AF n
ashley	a AD ʃ l i AD
asilo	ʔ a AD s i AD l o AF
asinta	ʔ a AD s i AD n t a AD
aso	a AD s o AF
asukal	a AD s uː AG k a AD l
asul	ʔ a AD s u AF l
asungot	ʔ a AD s u AF ŋ o AF t
at	ʔ a AD t
ataul	ʔ a AD t a AD ʔ u AF l
atendido	ʔ a AD t ɛ AD n d i AD d o AF
atip	a AD t i AD p
auyong	a AD w AC j AB ɔ AF ŋ
avanceña	ʔ a AD b a AD n s ɛ AD ɲ a AD
avendaño	ʔ a AD b ɛ AD n d a AD ɲ o AF
awat	ʔ a AD w AC a AD t
away	a AD w AC a AD j AB
awayin	a AD w AC a AD j AB i AD n
awyoung	a AD w AC j AB ɐ AF ŋ
ay	ʔ a AD i AD
ayam	a AD y AF a AD m
ayson	ʔ a AD i AD s o AF n
azaña	ʔ a AD s a AD ɲ a AD
azucena	ʔ a AD s u AF s ɛ AD n a AD
ba	b a AD
ba't	b a AD t
babae	b a AD b a AD ʔ ɛ AD
babaero	b a AD b a AD ʔ ɛ AD ɾ o AF
babaihin	b a AD b a AD i AD h AA i AD n
babao	b a AD b a AD u AF
babasa	b a AD b a AD s a AD
babasagin	b a AD b a AD s a AD ɡ i AD n
babasahin	b a AD b a AD s a AD h AA i AD n
bacani	b a AD k a AD n i AD
baclig	b a AD k l i AD ɡ
bacsa	b a AD k s a AD
bactol	b a AD k t o AF l
baculi	b a AD k u AF l i AD
badayos	b a AD d a AD j AB o AF s
baga	b a AD ɡ a AD ʔ
bagaman	b a AD ɡ a AD m a AD n
bagamat	b a AD ɡ a AD m a AD t
bagang	b a AD ɡ ʔ a AD ŋ
bagaoisan	b a AD ɡ a AD w AC i AD s a AD n
baging	b a AD ɡ i AD ŋ
bagon	b a AD ɡ o AF n
bagsak	b a AD ɡ s a AD k
bagsik	b a AD ɡ s i AD k
bagsit	b a AD ɡ s i AD t
bagunsakupin	b a AD ɡ u AF n s a AD k u AF p i AD n
bahaghari	b a AD h AA a AD ɡ h AA a AD ɾ i AD ʔ
bahaw	b a AD h AA a AD w AC
bahay	b a AD h AA a AD j AB
bahing	b a AD h AA i AD ŋ
bahon	b a AD h AA o AF n
baka	b ɐ AF k a AD ʔ
bakahan	b a AD k a AD h AA a AD n
bakas	b a AD k a AD s
bakasyon	b a AD k a AD ʃ o AF n
bakit	b a AD k ɛ AD t
baklad	b a AD k l a AD d
bakulaw	b a AD k u AF l a AD u AF
bakuna	b a AD k u AF n a AD
bakunahan	b a AD k u AF n a AD h AA a AD n
bakuran	b a AD k u AF ɾ a AD n
balae	b a AD l a AD ʔ ɛ AD
balaguer	b a AD l a AD ɡ ɛ AD ɾ
balahak	b a AD l a AD h AA a AD k
balahakan	b a AD l a AD h AA a AD k a AD n
balahibo	b a AD l a AD h AA i AD b o AF
balakubak	b a AD l a AD k u AF b a AD k
balani	b ɐ AF l a AD n i AD ʔ
balasa	b a AD l a AD s a AD
balasabas	b a AD l a AD s a AD b a AD s
balat	b a AD l a AD t
balato	b a AD l a AD t o AF
balatong	b a AD l a AD t o AF ŋ
balbas	b a AD l b a AD s
balde	b a AD l d e AD
baldonado	b a AD l d o AF n a AD d o AF
baldosa	b ɐ AF l d o AF s ɐ AF
bali	b a AD l i AD ʔ
baligtad	b a AD l i AD ɡ t a AD d
balik	b a AD l i AD k
balimbing	b ɐ AF l i AD m b i AD ŋ
balingit	b a AD l i AD ŋ i AD t
balisa	b a AD l i AD s a AD ʔ
balisacan	b a AD l i AD s a AD k a AD n
balisungsong	b a AD l i AD s u AF ŋ s ɔ AF ŋ
balita	b ɐ AF l i AD t a AD ʔ
balite	b a AD l i AD t ɛ AD
balnian	b a AD l n i AD a AD n
balo	b a AD l o AF ʔ
balon	b a AD l o AF n
baluga	b a AD l u AF ɡ a AD ʔ
balukay	b a AD l u AF k a AD j AB
baluktot	b a AD l u AF k t o AF t
balwarte	b a AD l w AC a AD ɾ t ɛ AD
banawa	b a AD n a AD w AC a AD
bandila	b a AD n d i AD l a AD ʔ
bangaw	b a AD ŋ a AD u AF
bangkay	b a AD ŋ k a AD i AD
bangkiling	b a AD ŋ k i AD l i AD ŋ
bango	b a AD ŋ o AF
baniaga	b a AD n j AB a AD ɡ a AD
banig	b a AD n i AD ɡ
banlaw	b a AD n l a AD u AF
banta	b a AD n t a AD ʔ
bantay	b a AD n t a AD i AD
bantayog	b a AD n t a AD j AB o AF ɡ
bantog	b a AD n t o AF ɡ
banyaga	b a AD n j AB a AD ɡ a AD ʔ
banyuhay	b ɐ AF n y AF u AF h AA ɐ AF j AB
bao	b a AD o AF
baog	b a AD ʔ o AF ɡ
baon	b a AD ʔ o AF n
baquiran	b a AD k i AD ɾ a AD n
bara	b a AD ɾ a AD
barado	b a AD ɾ a AD d o AF
baraha	b a AD ɾ a AD h AA a AD
barangay	b a AD r a AD ŋ ɡ a AD j AB
barbosa	b a AD ɾ b o AF s a AD
barquilla	b a AD ɾ k i AD l l a AD
barrios	b a AD ɾ j AB o AF s
bartolome	b a AD ɾ t o AF l o AF m ɛ AD
barya	b a AD ɾ j AB a AD
basa	b a AD s a AD
basag	b a AD s a AD ɡ
basahan	b a AD s a AD h AA a AD n
basakay	b a AD s a AD k a AD j AB
basallote	b ɐ AF s ɐ AF l j AB o AF t ɛ AD
basco	b a AD s k o AF
base	b a AD s ɛ AD
basehan	b a AD s ɛ AD h AA a AD n
basilan	b a AD s i AD l a AD n
basta	b a AD s t a AD
bastos	b a AD s t o AF s
basurahan	b a AD s u AF ɾ a AD h AA a AD n
basurero	b a AD s u AF ɾ ɛ AD ɾ o AF
basyo	b a AD ʃ o AF
basyuhin	b a AD ʃ u AF h AA i AD n
bata	b ɐ AF t a AD
batallones	b a AD t a AD l l o AF n ɛ AD s
batalyon	b a AD t a AD l j AB o AF n
batangas	b a AD t a AD n ɡ a AD s
batas	b a AD t a AD s
bathalaan	b a AD t h AA a AD l a AD ʔ a AD n
bati	b a AD t i AD ʔ
bato	b a AD t o AF ʔ
batok	b a AD t o AF k
batugan	b a AD t u AF ɡ a AD n
batukan	b a AD t u AF k a AD n
batya	b a AD t j AB a AD ʔ
batyaw	b a AD tʲ a AD w AC
baunan	b a AD ʔ u AF n a AD n
bauzon	b a AD u AF s o AF n
bawang	b aː AE w AC a AD ŋ
bayabas	b a AD j AB a AD b a AD s
bayad	b a AD j AB a AD d
bayanihan	b a AD j AB ɐ AF n ɪ AD h AA a AD n
bayarin	b a AD y AF a AD r i AD n
bayawak	b a AD j AB a AD w AC a AD k
bayna	b a AD j AB n a AD
bayong	b a AD j AB o AF ŋ
bayugo	b a AD j AB u AF ɡ o AF
baywang	b ɛ AD w AC a AD ŋ
bañaga	b a AD ɲ a AD ɡ a AD
bebot	b ɛː AE b ɔ AF t
bejasa	b ɛ AD d ʒ a AD s a AD
belhiko	b ɛ AD l h AA i AD k o AF
belmonte	b ɛ AD l m o AF n t ɛ AD
beltran	b ɛ AD l t ɾ a AD n
benepisyo	b ɛ AD n ɛ AD p i AD s j AB o AF
benipayo	b ɛ AD n i AD p a AD j AB o AF
benta	b e AD n t a AD
berde	b ɛ AD ɾ d ɛ AD
bergonia	b ɛ AD ɾ ɡ o AF n j AB a AD
beripikahin	b ɛ AD r i AD p i AD k a AD h AA i AD n
bermudez	b ɛ AD ɾ m u AF d ɛ AD s
beshie	b e AD s h AA i AD
bibe	b i AD b e AD
bibili	b i AD b i AD l i AD
bibingka	b i AD b i AD ŋ k a AD
bigat	b i AD ɡ ʔ a AD t
bigo	b i AD ɡ o AF ʔ
bigote	b i AD ɡ ɔ AF t ɛ AD
bigti	b i AD ɡ t i AD ʔ
biguin	b i AD ɡ u AF i AD n
bihag	b i AD h AA a AD ɡ
bihira	b i AD h AA i AD ɾ a AD ʔ
bihis	b i AD h AA i AD s
biik	b i AD i AD k
bilang	b iː AE l a AD ŋ
bilangguan	b i AD l a AD ŋ ɡ u AF ʔ a AD n
bilao	b i AD l a AD o AF
bilas	b i AD l a AD s
bilhan	b i AD l h AA a AD n
bilhin	b i AD l h AA i AD n
bili	b i AD l i AD
bilog	b i AD l ɔ AF ɡ
bilot	b i AD l o AF t
biloy	b i AD l o AF j AB
bilubilo	b i AD l u AF b i AD l o AF
bilugan	b i AD l u AF ɡ a AD n
binabae	b i AD n a AD b a AD ʔ ɛ AD
binatilyo	b i AD n a AD t i AD l j AB o AF
binaysok	b i AD n a AD j AB s o AF k
bingwit	b i AD ŋ w AC i AD t
bintag	b i AD n t a AD ɡ
bintana	b i AD n t a AD n a AD
bintang	b i AD n t a AD ŋ
bintog	b i AD n t o AF ɡ
binutil	b i AD n u AF t i AD l
binuya	b i AD n u AF j AB a AD
biro	b iː AE ɾ o AF ʔ
bisaya	b i AD s a AD j AB a AD ʔ
biscocho	b i AD s k o AF t ʃ o AF
bisikleta	b i AD s i AD k l ɛ AD t a AD
bisita	b i AD s i AD t a AD
bisitahin	b i AD s i AD t a AD h AA i AD n
bitamina	b ɪ AD t ɐ AF m i AD n ɐ AF
bitay	b i AD t a AD i AD
biyas	b i AD a AD s
biyaya	b i AD a AD j AB a AD ʔ
biyernes	b j AB ɛ AD ɾ n ɛ AD s
biyolohiya	b i AD j AB o AF l o AF h AA i AD j AB ɐ AF
biyuda	b i AD u AF d a AD
bobadilla	b o AF b a AD d i AD l l a AD
bobo	b o AF b o AF
bobotante	b ɔ AF b ɔ AF t a AD n t ɛ AD
bodega	b o AF d ɛ AD ɡ a AD
boksing	b o AF k s i AD ŋ
bolante	b o AF l a AD n t ɛ AD
bolaños	b o AF l a AD ɲ o AF s
bolpen	b o AF l p ɛ AD n
boluntaryo	b o AF l u AF n t a AD ɾ j AB o AF
bonifacio	b o AF n i AD f a AD ʃ o AF
bonilla	b o AF n i AD l l a AD
boongaling	b o AF o AF ŋ ɡ a AD l i AD ŋ
borbon	b o AF ɾ b o AF n
borillo	b o AF ɾ i AD l l o AF
borlaza	b o AF ɾ l a AD s a AD
boso	b o AF s o AF
botante	b o AF t a AD n t ɛ AD
bote	b o AF t ɛ AD
botelya	b o AF t ɛ AD l j AB a AD
botika	b o AF t i AD k a AD
botohan	b o AF t o AF h AA a AD n
braso	b ɾ a AD s o AF
brillantes	b ɾ i AD l l a AD n t ɛ AD s
bruha	b ɾ u AF h AA a AD
bubo	b u AF b o AF ʔ
bubog	b u AF b o AF ɡ
bubuli	b u AF b u AF l i AD
budhi	b u AF d h AA i AD ʔ
buenafe	b u AF ɛ AD n a AD p ɛ AD
buga	b u AF ɡ a AD
bugarin	b u AF ɡ a AD ɾ i AD n
bugat	b u AF ɡ a AD t
bugaw	b u AF ɡ a AD u AF
bugayong	b u AF ɡ a AD j AB o AF ŋ
bughaw	b u AF ɡ h AA a AD w AC
bugnit	b u AF ɡ n i AD t
bugtong	b u AF ɡ t o AF ŋ
buhag	b u AF h AA a AD ɡ
buhaghag	b u AF h AA a AD ɡ h AA a AD ɡ
buhagsigan	b u AF h AA a AD ɡ s i AD ɡ a AD n
buhagsigwasan	b u AF h AA a AD ɡ s i AD ɡ w AC a AD s a AD n
buhagtigilan	b u AF h AA a AD ɡ t i AD ɡ i AD l a AD n
buhawi	b u AF h AA a AD w AC i AD ʔ
buhok	b u AF h AA o AF k
bukambibig	b u AF k a AD m b i AD b i AD ɡ
bukas	b u AF k a AD s
bukbok	b u AF k b o AF k
buking	b u AF k i AD ŋ
bukot	b u AF k o AF t
bula	b u AF l a AD ʔ
bulaan	b u AF l a AD ʔ a AD n
bulahaw	b u AF l a AD h AA a AD u AF
bulalakaw	b u AF l a AD l a AD k a AD u AF
bulalay	b u AF l a AD l a AD j AB
bulanadi	b u AF l a AD n a AD d i AD
bulandal	b u AF l a AD n d a AD l
bulanhagui	b u AF l a AD n h AA a AD ɡ i AD
bulati	b u AF l a AD t i AD
bulatlat	b u AF l a AD t l a AD t
bulaw	b u AF l a AD u AF
bulbol	b u AF l b o AF l
bulig	b u AF l i AD ɡ
bulok	b u AF l o AF k
bulutong	b u AF l u AF t o AF ŋ
bulyaw	b u AF l j AB a AD u AF
bumaba	b u AF m a AD b a AD ʔ
bumagsak	b u AF m a AD ɡ s a AD k
bumagyo	l u AF m i AD w AC a AD n a AD ɡ
bumaha	b u AF m a AD h AA a AD ʔ
bumahin	b u AF m a AD h AA i AD n
bumahing	b u AF m a AD h AA i AD ŋ
bumalik	b u AF m a AD l i AD k
bumalintong	b u AF m a AD l i AD n t ɔ AF ŋ
bumbunan	b u AF m b u AF n a AD n
bumibili	b u AF m i AD b i AD l i AD
bumili	b u AF m i AD l i AD
bumilis	b u AF m i AD l i AD s
bumisita	b u AF m i AD s i AD t a AD
bumiyahe	b u AF m j AB a AD h AA ɛ AD
bumuo	b u AF m u AF ʔ o AF ʔ
bumuwelta	b u AF m u AF w AC ɛ AD l t a AD
bunag	b u AF n a AD ɡ
bunga	b u AF ŋ a AD
bungkos	b u AF ŋ k o AF s
bungo	b u AF ŋ o AF ʔ
bungot	b u AF ŋ ɔ AF t
buno	b u AF n o AF ʔ
bunso	b u AF ŋ s o AF ʔ
bunto	b u AF n t o AF ʔ
bunyi	b u AF n j AB i AD
buo	b u AF o AF ʔ
buol	b u AF ʔ o AF l
buquid	b u AF k i AD d
bura	b u AF ɾ aː AE
burahin	b u AF r a AD h AA i AD n
burgis	b u AF ɾ ɡ i AD s
buryong	b u AF ɾ j AB o AF ŋ
bus	b u AF s
buson	b u AF s o AF n
butac	b u AF t a AD k
butaka	b u AF t a AD k a AD
butang	b u AF t a AD ŋ
butas	b u AF t a AD s
buto	b u AF t ʔ o AF
butod	b u AF t o AF d
butudkaphay	b u AF t o AF d k a AD p h AA a AD j AB
butudkilos	b u AF t o AF d k i AD l o AF s
buturan	b u AF t u AF ɾ a AD n
buuin	b u AF ʔ u AF ʔ i AD n
buwag	b u AF a AD ɡ
buwakaw	b w AC a AD k a AD u AF
buwanan	b u AF a AD n a AD n
buwaya	b u AF a AD j AB a AD
buwelta	b w AC ɛ AD l t a AD
buweltahan	b w AC ɛ AD l t a AD h AA a AD n
buwisit	b u AF i AD s i AD t
buyo	b u AF j AB o AF
cabahug	k a AD b a AD h AA u AF ɡ
cabanayan	k a AD b a AD n a AD j AB a AD n
cabanlit	k a AD b a AD n l i AD t
cabasag	k a AD b a AD s a AD ɡ
cabiling	k a AD b i AD l i AD ŋ
cabral	k a AD b ɾ a AD l
cabuhat	k a AD b u AF h AA a AD t
cabungcal	k a AD b u AF ŋ k a AD l
cacdac	k a AD k d a AD k
cadano	k a AD d a AD n o AF
cadapan	k a AD d a AD p a AD n
cadayona	k a AD d a AD j AB o AF n a AD
cagalingan	k a AD ɡ a AD l i AD ŋ a AD n
caguiat	k a AD ɡ j AB a AD t
caguioa	k a AD ɡ i AD w AC a AD
calalo	k a AD l a AD l o AF
calaunan	k a AD l a AD ʔ u AF n a AD n
calaycay	k a AD l a AD i AD k a AD i AD
calinawan	k a AD l i AD n a AD w AC a AD n
calingasan	k a AD l i AD ŋ a AD s a AD n
calinisan	k a AD l i AD n i AD s a AD n
calma	k a AD l m a AD
campo	k a AD m p o AF
cancio	k a AD n s i AD o AF
canicosa	k a AD n i AD k o AF s a AD
canilao	k a AD n i AD l a AD u AF
cantiveros	k a AD n t i AD b ɛ AD ɾ o AF s
cantos	k a AD n t o AF s
caparas	k a AD p a AD ɾ a AD s
capinpin	k a AD p i AD n p i AD n
cardiño	k a AD ɾ d i AD ɲ o AF
cariaso	k a AD ɾ j AB a AD s o AF
carillo	k a AD ɾ i AD l l o AF
carlos	k ɐ AF ɾ l ɔ AF s
carrillo	k a AD ɾ ɾ i AD l l o AF
casal	k a AD s a AD l
casanova	k a AD s a AD n o AF b a AD
casao	k a AD s a AD o AF
caseda	k a AD s ɛ AD d a AD
castañeda	k a AD s t a AD ɲ ɛ AD d a AD
castrence	k a AD s t ɾ ɛ AD n s ɛ AD
catapang	k a AD t a AD p a AD ŋ
catibog	k a AD t i AD b o AF ɡ
catimbang	k a AD t i AD m b a AD ŋ
catipon	k a AD t i AD p o AF n
catral	k a AD t ɾ a AD l
cauilan	k a AD w AC i AD l a AD n
caw	k a AD w AC
cedeño	s ɛ AD d ɛ AD ɲ o AF
cenizal	s ɛ AD n i AD s a AD l
cereno	s ɛ AD ɾ ɛ AD n o AF
cerillo	s ɛ AD ɾ i AD l l o AF
chan	t ʃ a AD n
cheng	c h AA ɛ AD ŋ
chi	t ʃ i AD
ching	t ʃ i AD ŋ
chong	t ʃ o AF ŋ
chu	t ʃ ʊ AF
chua	t ʃ w AC a AD
chung	t ʃ ʊ AF ŋ
cinco	s i AD n k o AF
closa	k l o AF s a AD
co	k ɔ AF
collado	k o AF l l a AD d o AF
cometa	k o AF m ɛ AD t a AD
comia	k o AF m i AD a AD
condez	k o AF n d ɛ AD s
coo	k uː AG
coquia	k o AF k i AD a AD
corcuera	k o AF ɾ k w AC ɛ AD ɾ a AD
cornejo	k o AF ɾ n ɛ AD d ʒ o AF
coronel	k o AF ɾ o AF n ɛ AD l
corrales	k o AF ɾ ɾ a AD l ɛ AD s
correa	k o AF ɾ ɾ ɛ AD a AD
corro	k o AF ɾ ɾ o AF
cosico	k o AF s i AD k o AF
cruzat	k ɾ u AF s a AD t
cua	k w AC a AD
cuasay	k w AC a AD s a AD i AD
cubacub	k u AF b a AD k u AF b
cueto	k w AC ɛ AD t o AF
cuizon	k u AF i AD s o AF n
custodio	k u AF s t o AF d j AB o AF
daan	d a AD ʔ a AD n
dabarkads	d a AD b a AD r k a AD d s
dacanay	d a AD k a AD n a AD i AD
dado	d a AD d o AF
daga	d a AD ɡ a AD ʔ
dagadagaan	d a AD ɡ a AD d a AD ɡ a AD ʔ a AD n
dagat	d a AD ɡ a AD t
dagipik	d a AD ɡ i AD p i AD k
dagisikan	d a AD ɡ i AD s i AD k a AD n
dagitban	d a AD ɡ i AD t b a AD n
dagitigilan	d a AD ɡ i AD t i AD ɡ i AD l a AD n
dagitsigan	d a AD ɡ i AD t s i AD ɡ a AD n
dagta	d a AD ɡ t a AD ʔ
dahas	d a AD h AA a AD s
dahilan	d a AD h AA i AD l a AD n
dahilig	d a AD h AA i AD l i AD ɡ
dahon	d a AD h AA o AF n
dakip	d a AD k i AD p
daktao	d a AD k t a AD ʔ ɔ AF
daktinig	d a AD k t i AD n i AD ɡ
dalagita	d a AD l a AD ɡ i AD t a AD
dalang	d a AD l a AD ŋ
dalaw	d a AD l a AD u AF
dalawa	d a AD l a AD w AC a AD
dalawampu	d a AD l a AD w AC a AD m p u AF ʔ
dalawit	d a AD l a AD w AC i AD t
dalmasya	d ɑ AD l m ɑ AD ɕ ɑ AD
dalubhasa	d a AD l u AF b h AA a AD s a AD ʔ
dalubituinan	d a AD l u AF b b i AD t u AF i AD n a AD n
dalubtalaan	d a AD l u AF b t a AD l a AD ʔ a AD n
dalubtauhan	d a AD l u AF b t a AD ʔ u AF h AA a AD n
dalubwikaan	d a AD l u AF b w AC i AD k a AD ʔ a AD n
dalusong	d a AD l u AF s o AF ŋ
dama	d ɐ AF m a AD
damit	d a AD m i AD t
damo	d a AD m o AF
damot	d a AD m o AF t
damuhan	d ɐ AF m u AF h AA a AD n
damuho	d a AD m u AF h AA o AF ʔ
dantay	d a AD n t a AD i AD
danum	d a AD n u AF m
danumsigwasan	d a AD n u AF m s i AD ɡ w AC a AD s a AD n
danumtigilan	d a AD n u AF m t i AD ɡ i AD l a AD n
dao	d a AD ʔ o AF
dapat	d a AD p a AD t
dapdap	d a AD p d a AD p
datapwa	d a AD t a AD p w AC a AD ʔ
dati	d a AD t i AD
dating	d ɐ AF t i AD ŋ
datinguinoo	d a AD t i AD ŋ i AD n o AF o AF
davao	d a AD b a AD u AF
daw	ɾ a AD u AF
daya	d a AD j AB a AD ʔ
dayag	d a AD j AB a AD ɡ
dayami	d a AD j AB a AD m i AD
dayang	d a AD j AB a AD ŋ
dayanghirang	d a AD j AB a AD ŋ h AA i AD ɾ a AD ŋ
dayrit	d a AD i AD ɾ i AD t
dazo	d a AD s o AF
deang	d j AB a AD ŋ
deboto	d ɛ AD b o AF t o AF
decena	d ɛ AD s ɛ AD n a AD
dee	d i AD
dehado	d ɛ AD h AA a AD d o AF
dekada	d ɛ AD k a AD d a AD
dekorasyon	d ɛ AD k o AF ɾ a AD s j AB o AF n
dekreto	d ɛ AD k ɾ ɛ AD t o AF
delegasyon	d ɛ AD l ɛ AD ɡ a AD s j AB o AF n
demonyo	d ɛ AD m o AF n j AB o AF
dentista	d ɛ AD n t i AD s t a AD
depensahan	d ɛ AD p ɛ AD n s a AD h AA a AD n
desisyon	d ɛ AD s i AD s j AB o AF n
destino	d ɛ AD s t i AD n o AF
di	d ɛ AD
diamante	d i AD a AD m a AD n t ɛ AD
diigkasin	d i AD ʔ i AD ɡ k a AD s i AD n
diin	d i AD ʔ i AD n
dijamco	d i AD d ʒ a AD m k o AF
diklap	d i AD k l a AD p
dila	d i AD l a AD ʔ
dilaan	d i AD l a AD a AD n
dilaw	d i AD l a AD u AF
dilikas	d i AD l i AD k a AD s
dilim	d i AD l i AD m
dimaala	d i AD m a AD a AD l a AD
dimaandal	d i AD m a AD a AD n d a AD l
dimaapi	d i AD m a AD a AD p i AD
dimacali	d i AD m a AD k a AD l i AD
dimagiba	d i AD m a AD ɡ i AD b a AD
dimailig	d i AD m a AD i AD l i AD ɡ
dimalaluan	d i AD m a AD l a AD l u AF a AD n
dimalanta	d i AD m a AD l a AD n t a AD
dimapilis	d i AD m a AD p i AD l i AD s
dimaranan	d i AD m a AD ɾ a AD n a AD n
dimatatac	d i AD m a AD t a AD t a AD k
din	d i AD n
dinagipik	d i AD n a AD ɡ i AD p i AD k
dinamita	d i AD n a AD m i AD t a AD
dinding	d i AD n d i AD ŋ
dine	d i AD n ɛ AD
dingding	d i AD n d i AD ŋ
diokno	d i AD o AF k n o AF
dipasupil	d i AD p a AD s u AF p i AD l
diplomasya	d i AD p l o AF m a AD s j AB a AD
disisais	d i AD s i AD s a AD ʔ i AD s
diskumpiyado	d i AD s k u AF m p i AD a AD d o AF
dismayado	d i AD s m a AD j AB a AD d o AF
dito	d i AD t o AF
diyablo	d i AD a AD b l o AF
diyamante	d i AD a AD m a AD n t ɛ AD
diño	d i AD ɲ o AF
doctolero	d o AF k t o AF l ɛ AD ɾ o AF
dolores	d o AF l o AF ɾ ɛ AD s
domantay	d o AF m a AD n t a AD i AD
domingo	d o AF m i AD n ɡ o AF
doon	d o AF ʔ o AF n
dos	d o AF s
dueñas	d u AF ɛ AD ɲ a AD s
duhansipat	d u AF h AA a AD n s i AD p a AD t
duhat	d u AF h AA a AD t
dukot	d u AF k o AF t
dukwang	d u AF k w AC a AD ŋ
dulay	d u AF l a AD i AD
duldol	d u AF l d o AF l
dulos	d u AF l o AF s
dumaan	d u AF m a AD a AD n
dumaguing	d u AF m a AD ɡ i AD ŋ
dumapa	d u AF m a AD p a AD
dumating	d u AF m a AD t i AD ŋ
dumi	d u AF m ɪː AE
dumighay	d u AF m i AD ɡ h AA a AD y AF
dumilim	d u AF m i AD l i AD m
dumlao	d u AF m l a AD o AF
dumpit	d u AF m p i AD t
dumulas	d u AF m u AF l a AD s
dumungaw	d u AF m u AF ŋ a AD u AF
dumura	d u AF m u AF ɾ a AD ʔ
dungaw	d u AF ŋ a AD u AF
dunggot	d u AF ŋ ɡ o AF t
dupil	d u AF p i AD l
dura	d u AF ɾ a AD ʔ
durante	d u AF ɾ a AD n t ɛ AD
durungawan	d u AF ɾ u AF ŋ a AD w AC a AD n
dutaan	d u AF t a AD ʔ a AD n
duwag	d u AF a AD ɡ
duyan	d u AF j AB a AD n
dy	d iː AE
dyahe	d ʒ a AD h AA ɛ AD
dyaket	d ʒ a AD k ɛ AD t
dyanitor	d j AB a AD n i AD t o AF ɾ
dyaryo	ɟ ʝ ɑ AD rʲ ɔ AF
echano	ʔ ɛ AD t ʃ a AD n o AF
echevarria	ʔ ɛ AD t ʃ ɛ AD b a AD ɾ j AB a AD
edad	ɛ AD d a AD d
edisyon	ʔ ɛ AD d i AD s j AB o AF n
ekis	ʔ ɛ AD k i AD s
ekisan	ʔ ɛ AD k i AD s a AD n
ekonomiya	ʔ ɛ AD k o AF n o AF m i AD a AD
elamparo	ʔ ɛ AD l a AD m p a AD ɾ o AF
elegansya	ɛ AD l ɛ AD ɡ a AD n ʃ a AD
elizaga	ʔ ɛ AD t ʃ ɛ AD b a AD ɾ j AB a AD
encarnado	ʔ ɛ AD n k a AD ɾ n a AD d o AF
encinas	ʔ ɛ AD n s i AD n a AD s
endaya	ʔ ɛ AD n d a AD j AB a AD
endozo	ʔ ɛ AD n d o AF s o AF
enero	ɛ AD n ɛ AD ɾ o AF
engkanto	ʔ ɛ AD ŋ k a AD n t o AF
entusyasmo	ɛ AD n t u AF s j AB a AD s m o AF
epal	ɛ AD p a AD l
epekto	ʔ ɛ AD p ɛ AD k t o AF
epidemya	ʔ ɛ AD p i AD d ɛ AD m j AB a AD
episyente	ɛ AD p i AD ʃ ɛ AD n t ɛ AD
erehe	ʔ ɛ AD ɾ ɛ AD h AA ɛ AD
ermitanyo	ʔ ɛ AD ɾ m i AD t a AD n j AB o AF
escalona	ʔ ɛ AD s k a AD l o AF n a AD
escaño	ʔ ɛ AD s k a AD ɲ o AF
esguerra	ʔ ɛ AD s ɡ ɛ AD ɾ ɾ a AD
eskaparate	ʔ ɛ AD s k a AD p a AD ɾ a AD t ɛ AD
espadahan	ʔ ɛ AD s p a AD d a AD h AA a AD n
espasyo	ʔ ɛ AD s p a AD s j AB o AF
espinoza	ʔ ɛ AD s p i AD n o AF s a AD
esquivel	ʔ ɛ AD s k i AD b ɛ AD l
estabillo	ʔ ɛ AD s t a AD b i AD l l o AF
estrella	ʔ ɛ AD s t ɾ ɛ AD l l a AD
eugenio	j AB u AF h AA ɛ AD n j AB o AF
exconde	ʔ ɛ AD k s k o AF n d ɛ AD
fabregas	p a AD b ɾ ɛ AD ɡ a AD s
fabros	p a AD b ɾ o AF s
fajardo	p a AD d ʒ a AD ɾ d o AF
falcon	p a AD l k o AF n
faltado	p a AD l t a AD d o AF
fernandez	p ɛ AD ɾ n a AD n d ɛ AD s
ferriols	p ɛ AD ɾ ɾ i AD o AF l s
festejo	p ɛ AD s t ɛ AD d ʒ o AF
figueras	p i AD ɡ ɛ AD ɾ a AD s
figueroa	p i AD ɡ ɛ AD ɾ o AF a AD
filipino	p i AD l i AD p i AD n o AF
flojo	p l o AF d ʒ o AF
fojas	p o AF d ʒ a AD s
fonacier	p o AF n a AD s i AD ɛ AD ɾ
fontelera	p o AF n t ɛ AD l ɛ AD ɾ a AD
fontillas	p o AF n t i AD l l a AD s
forteza	p o AF ɾ t ɛ AD s a AD
fortich	p o AF ɾ t i AD t ʃ
frias	p ɾ i AD a AD s
fronda	p ɾ o AF n d a AD
fuentebella	p u AF ɛ AD n t ɛ AD b ɛ AD l l a AD
fung	p u AF ŋ
furagganan	p u AF ɾ a AD ɡ ɡ a AD n a AD n
gabi	ɡ a AD b i AD
gabiana	ɡ a AD b i AD a AD n a AD
gacula	ɡ a AD k u AF l a AD
gacusan	ɡ a AD k u AF s a AD n
gacutan	ɡ a AD k u AF t a AD n
gadgad	ɡ a AD d ɡ a AD d
galamay	ɡ a AD l a AD m a AD i AD
galapong	ɡ a AD l a AD p o AF ŋ
galauran	ɡ a AD l a AD ʔ u AF ɾ a AD n
galawan	ɡ a AD l a AD w AC a AD n
galing	ɡ a AD l i AD ŋ
galis	ɡ a AD l i AD s
galit	ɡ a AD l i AD t
gallo	ɡ a AD l l o AF
galos	ɡ a AD l o AF s
gan	ɡ a AD n
ganap	ɡ a AD n a AD p
gancayco	ɡ a AD n k a AD i AD k o AF
ganda	ɡ a AD n d a AD
gangsal	ɡ a AD ŋ s a AD l
ganid	ɡ a AD n i AD d
gansa	ɡ a AD n s a AD
gansal	ɡ a AD n s a AD l
ganti	ɡ a AD n t i AD
ganzon	ɡ a AD n s o AF n
gao	ɡ a AD w AC
garalde	ɡ a AD ɾ a AD l d ɛ AD
garapata	ɡ a AD ɾ a AD p a AD t a AD
garay	ɡ a AD ɾ a AD i AD
garces	ɡ a AD ɾ s ɛ AD s
garchitorena	ɡ a AD ɾ t ʃ i AD t o AF ɾ ɛ AD n a AD
garciano	ɡ a AD ɾ s i AD a AD n o AF
gargaran	ɡ a AD ɾ ɡ a AD ɾ a AD n
gascon	ɡ a AD s k o AF n
gaslaw	ɡ a AD s l a AD u AF
gasolinahan	ɡ a AD s o AF l i AD n a AD h AA a AD n
gaspang	ɡ a AD s p a AD ŋ
gaston	ɡ a AD s t o AF n
gatbonton	ɡ a AD t b o AF n t o AF n
gatchalian	ɡ a AD t t ʃ a AD l j AB a AD n
gatong	ɡ aː AE t ɔ AF ŋ
gavilan	ɡ a AD b i AD l a AD n
gaviola	ɡ a AD b j AB o AF l a AD
gayuma	ɡ a AD j AB u AF m a AD
gerilya	ɡ ɛ AD ɾ i AD l j AB a AD
gerodias	d ʒ ɛ AD ɾ o AF d j AB a AD s
geron	ɡ ɛ AD ɾ o AF n
geronimo	h AA ɛ AD ɾ o AF n i AD m o AF
gigil	ɡ i AD ɡ i AD l
gilagid	ɡ i AD l a AD ɡ i AD d
ginhawa	ɡ i AD n h AA a AD w AC a AD
ginto	ɡ i AD n t o AF ʔ
gipalpal	ɡ i AD p a AD l p a AD l
giron	h AA i AD ɾ o AF n
gisa	ɡ i AD s a AD
gising	ɡ i AD s i AD ŋ
gitara	ɡ i AD t a AD ɾ a AD
gitlawas	ɡ i AD t l a AD w AC a AD s
gitna	ɡ i AD t n a AD ʔ
giwa	ɡ i AD w AC a AD ʔ
go	ɡ ɔ AF
godoy	ɡ o AF d o AF i AD
goh	ɡ o AF
grabe	ɡ ɾ a AD b ɛ AD
gradweyt	ɡ ɾ a AD d w AC ɛ AD i AD t
grasa	ɡ ɾ a AD s a AD
grasya	ɡ ɾ a AD s j AB a AD
grumadweyt	ɡ ɾ u AF m a AD d w AC ɛ AD i AD t
guanzon	ɡ u AF a AD n s o AF n
gubat	ɡ u AF b a AD t
guerra	ɡ ɛ AD ɾ a AD
guinto	ɡ i AD n t o AF
gulang	ɡ u AF l a AD ŋ
gulay	ɡ u AF l a AD j AB
gulpi	ɡ u AF l p i AD
gumagad	ɡ u AF m a AD ɡ a AD d
gumala	ɡ u AF m a AD l a AD ʔ
gumaling	ɡ u AF m a AD l i AD ŋ
gumapac	ɡ u AF m a AD p a AD k
gumawa	ɡ u AF m a AD w AC a AD ʔ
gumilid	ɡ u AF m i AD l i AD d
gumiran	ɡ u AF m i AD ɾ a AD n
gumising	ɡ u AF m i AD s i AD ŋ
gumuho	ɡ u AF m u AF h AA ɔ AF ʔ
gumulong	ɡ u AF m u AF l ɔ AF ŋ
guwantes	ɡ u AF a AD n t ɛ AD s
guwardiya	ɡ u AF a AD ɾ d j AB a AD
habagat	h AA a AD b a AD ɡ a AD t
hagikgik	h AA a AD ɡ ɪ AD k ɡ ɪ AD k
hagod	h AA a AD ɡ o AF d
hagok	h AA a AD ɡ o AF k
hagulgol	h AA a AD ɡ u AF l ɡ o AF l
hagulhol	h AA a AD ɡ u AF l h AA o AF l
hagupit	h AA a AD ɡ u AF p i AD t
halabos	h AA a AD l a AD b o AF s
halaga	h AA a AD l a AD ɡ a AD
halalan	h AA a AD l a AD l a AD n
halari	h AA a AD l a AD ɾ i AD ʔ
halasan	h AA a AD l a AD s a AD n
haligi	h AA a AD l i AD ɡ i AD
halik	h AA a AD l i AD k
halimaw	h AA a AD l i AD m a AD u AF
hambalang	h AA a AD m b a AD l a AD ŋ
hamog	h AA a AD m o AF ɡ
hamon	h AA a AD m o AF n
hangal	h AA a AD ŋ a AD l
hangin	h AA a AD ŋ i AD n
hanginsigan	h AA a AD ŋ i AD n s i AD ɡ a AD n
hangintigilan	h AA a AD ŋ i AD n t i AD ɡ i AD l a AD n
hapdi	h AA a AD p d i AD ʔ
hapit	h AA a AD p i AD t
hapo	h AA a AD p o AF ʔ
hapones	h AA a AD p o AF n ɛ AD s
hapunan	h AA a AD p u AF n a AD n
harana	h AA a AD ɾ a AD n a AD
harang	h AA a AD ɾ a AD ŋ
harap	h AA a AD ɾ a AD p
hardin	h AA ɐ AF r d i AD n
hardinera	h AA ɐ AF r d ɪ AD n e AD r a AD
hardinero	h AA ɐ AF r d ɪ AD n e AD r o AF
hasik	h AA a AD s i AD k
hati	h AA a AD t i AD ʔ
hatinig	h AA a AD t i AD n i AD ɡ
hatol	h AA a AD t o AF l
hau	h AA a AD w AC
haw	h AA a AD w AC
hawa	h AA a AD w AC a AD
hawak	h AA a AD w AC a AD k
hawakan	h AA a AD w AC a AD k a AD n
hawla	h AA a AD u AF l a AD
hayag	h AA a AD j AB a AD ɡ
haynayan	h AA a AD j AB n a AD j AB a AD n
hayop	h AA a AD j AB o AF p
hene	h AA e AD n e AD
henetika	h AA e AD n e AD t i AD k ɐ AF
heng	h AA e AD ŋ
herradura	ʔ ɛ AD ɾ a AD d u AF ɾ a AD
hesusmaryosep	h AA ɛ AD s u AF s m a AD ɾ i AD ɔː AG s e AD p
hibi	h AA i AD b i AD
higanti	h AA i AD ɡ a AD n t i AD ʔ
higlikas	h AA i AD ɡ l i AD k a AD s
higliknayan	h AA i AD ɡ l i AD k n a AD j AB a AD n
higop	h AA i AD ɡ o AF p
higsipnayan	h AA i AD ɡ s i AD p n a AD j AB a AD n
higtao	h AA i AD ɡ t a AD ʔ ɔ AF
hikaw	h AA i AD k a AD w AC
hilab	h AA i AD l a AD b
hilaga	h AA i AD l a AD ɡ a AD ʔ
hilaw	h AA i AD l a AD u AF
hilera	h AA i AD l ɛ AD ɾ a AD
himagas	h AA i AD m a AD ɡ a AD s
himala	h AA i AD m a AD l a AD ʔ
himanting	h AA i AD m a AD n t i AD ŋ
himasok	h AA i AD m a AD s o AF k
himatayin	h AA i AD m a AD t a AD j AB i AD n
himbabahay	h AA i AD m b a AD b a AD h AA a AD j AB
hina	h AA i AD n a AD ʔ
hinagpis	h AA i AD n a AD ɡ p i AD s
hinala	h AA i AD n a AD l a AD ʔ
hindi	h AA ɛ AD n d ɛ AD
hinga	h AA i AD ŋ a AD
hinlalaki	h AA i AD n l a AD l a AD k i AD
hinog	h AA i AD n o AF ɡ
hintuturo	h AA i AD n t u AF t u AF ɾ o AF ʔ
hipolito	h AA i AD p o AF l i AD t o AF
hipon	h AA i AD p o AF n
hira	h AA i AD ɾ a AD ʔ
hirap	h AA i AD ɾ a AD p
hita	h AA i AD t a AD ʔ
hithit	h AA i AD t h AA i AD t
hito	h AA i AD t o AF ʔ
hitso	h AA i AD t s o AF
hitsura	h AA i AD t ʃ u AF ɾ a AD
hiwalay	h AA i AD w AC a AD l a AD i AD
hiya	h AA i AD j AB a AD ʔ
hiyaw	h AA i AD a AD u AF
hizon	h AA i AD s o AF n
ho	h AA ɔ AF
homiliya	h AA o AF m i AD l i AD a AD
hong	h AA o AF ŋ
hopya	h AA o AF p j AB a AD ʔ
hortaleza	h AA o AF ɾ t a AD l ɛ AD s a AD
hoy	h AA o AF j AB
huli	h AA u AF l i AD ʔ
hulog	h AA u AF l o AF ɡ
humadlang	h AA u AF m a AD d l a AD ŋ
humagulgol	h AA u AF m a AD ɡ u AF l ɡ o AF l
humalik	h AA u AF m a AD l i AD k
humanda	h AA u AF m a AD n d a AD ʔ
humandusay	h AA u AF m a AD n d u AF s a AD i AD
humiga	h AA u AF m i AD ɡ a AD ʔ
humingi	h AA u AF m i AD ŋ i AD ʔ
huminto	h AA u AF m i AD n t o AF ʔ
humiram	h AA u AF m i AD ɾ a AD m
humirap	h AA u AF m i AD r a AD p
hung	h AA u AF ŋ
huni	h AA u AF n i AD
huramentado	h AA u AF ɾ a AD m e AD n t a AD d o AF
huron	h AA u AF r o AF n
husga	h AA u AF s ɡ a AD
husgado	h AA u AF s ɡ a AD d o AF
husgahan	h AA u AF s ɡ a AD h AA a AD n
huwebes	h AA u AF w AC ɛ AD b e AD s
huweteng	h AA u AF ɛ AD t ɛ AD ŋ
huy	h AA u AF j AB
huyad	h AA u AF j AB a AD d
huyong	h AA u AF j AB o AF ŋ
hwan	h AA w AC ɐ AF n
ibagsak	i AD b a AD ɡ s a AD k
ibahaw	i AD b a AD h AA a AD w AC
ibalik	i AD b a AD l i AD k
ibasco	ʔ i AD b a AD s k o AF
ibay	ʔ i AD b a AD j AB
ibili	i AD b i AD l i AD
ibutod	i AD b u AF t o AF d
idalum	ʔ i AD d a AD l u AF m
igib	ʔ i AD ɡ i AD b
igkasin	ʔ i AD ɡ k a AD s i AD n
ignacio	ʔ i AD ɡ n a AD s j AB o AF
ignoransiya	ʔ i AD ɡ n o AF ɾ a AD n s j AB a AD
ignorante	ʔ i AD ɡ n o AF ɾ a AD n t ɛ AD
ihi	ʔ i AD h AA i AD ʔ
ikabilanggo	ʔ i AD k a AD b i AD l a AD ŋ ɡ o AF ʔ
ikagalit	ʔ i AD k a AD ɡ a AD l i AD t
ikaw	i AD k a AD w AC
ikmo	i AD k m o AF
ikuha	i AD k u AF h AA a AD
ilag	ʔ i AD l a AD ɡ
ilao	ʔ i AD l a AD u AF
iling	ʔ i AD l i AD ŋ
ilog	ʔ i AD l o AF ɡ
ilong	ʔ i AD l o AF ŋ
ilustre	ʔ i AD l u AF s t ɾ ɛ AD
imahen	ʔ i AD m a AD h AA ɛ AD n
imbentaryo	ʔ i AD m b ɛ AD n t a AD ɾ j AB o AF
imperial	ʔ i AD m p ɛ AD ɾ j AB a AD l
impluwensiya	ʔ i AD m p l u AF ɛ AD n s j AB a AD
importansiya	ʔ i AD m p o AF ɾ t a AD n s j AB a AD
importante	ʔ i AD m p o AF ɾ t a AD n t ɛ AD
ina	ʔ i AD n a AD
inahin	ʔ i AD n a AD h AA i AD n
infante	ʔ i AD n p a AD n t ɛ AD
ingay	ʔ i AD ŋ a AD i AD
inggit	ʔ i AD ŋ ɡ i AD t
inggitero	ʔ i AD ŋ ɡ i AD t ɛ AD ɾ o AF
inggles	i AD ŋ ɡ l ɛ AD s
inggo	ʔ i AD ŋ ɡ o AF ʔ
inglesero	i AD ŋ ɡ l ɛ AD s ɛː AE ɾ ɔ AF
ingrato	ʔ i AD ŋ ɡ ɾ a AD t o AF
inip	ʔ i AD n i AD p
init	ʔ i AD n i AD t
initan	ʔ i AD n i AD t a AD n
initbutod	ʔ i AD n i AD t b u AF t ɔ AF d
initdagitban	ʔ i AD n i AD t d a AD ɡ i AD t b a AD n
initkapnayan	ʔ i AD n i AD t k a AD p n a AD j AB a AD n
initsigan	ʔ i AD n i AD t s i AD ɡ a AD n
inosente	ʔ i AD n o AF s ɛ AD n t ɛ AD
insulto	ʔ i AD n s u AF l t o AF
interbiyu	ʔ i AD n t ɛ AD ɾ b i AD u AF
interes	ʔ i AD n t ɛ AD ɾ ɛ AD s
intindi	ʔ i AD n t i AD n d i AD
intsik	ʔ i AD n t ʃ i AD k
inumin	ʔ i AD n u AF m i AD n
inutil	ʔ i AD n u AF t i AD l
inyo	i AD n j AB o AF
ip	ɪ AD p
ipagbilin	ʔ i AD p a AD ɡ b i AD l i AD n
ipakausap	i AD p a AD k a AD u AF s a AD p
ipakuha	i AD p a AD k u AF h AA a AD
ipamigay	ʔ i AD p a AD m i AD ɡ a AD i AD
ipatapon	i AD p a AD t a AD p o AF n
ipis	ʔ i AD p i AD s
ipo	ʔ i AD p o AF
iprint	i AD p r i AD n t
irebisa	ʔ i AD ɾ ɛ AD b i AD s a AD
isa	ʔ i AD s a AD
isagani	ʔ i AD s a AD ɡ a AD n i AD
isangkot	ʔ i AD s a AD ŋ k o AF t
isauli	i AD s a AD u AF l i AD
iscan	i AD s k a AD n
iset	i AD s ɛ AD t
ishinare	ʔ i AD s h AA i AD n ɛ AD ɾ
isidro	ʔ i AD s i AD d ɾ o AF
isigan	i AD s i AD ɡ a AD n
isipin	ʔ i AD s i AD p i AD n
isisi	ʔ i AD s i AD s i AD
iskedyul	ʔ i AD s k ɛ AD d j AB u AF l
iskolar	ʔ i AD s k o AF l a AD ɾ
iskrip	ʔ i AD s k ɾ i AD p
isoli	i AD s o AF l i AD
istorya	ʔ i AD s t o AF ɾ j AB a AD
isuot	ʔ i AD s u AF ʔ ɔ AF t
itago	i AD t a AD ɡ o AF
itim	ɪ AD t i AD m
itlog	ʔ i AD t l o AF ɡ
itmo	i AD t m o AF
ito	ʔ i AD t o AF
ixerox	i AD s ɛ AD r o AF k s
iyan	j AB a AD n
iyo	i AD j AB o AF
iyon	j AB o AF n
jalandoni	d ʒ a AD l a AD n d o AF n i AD
jamisola	d ʒ a AD m i AD s o AF l a AD
jara	d ʒ a AD ɾ a AD
jaramillo	d ʒ a AD ɾ a AD m i AD l l o AF
jaranilla	d ʒ a AD ɾ a AD n i AD l l a AD
jologs	d ʒ o AF l o AF ɡ z
jontis	d ʒ ɔ AF n t i AD s
juan	h AA w AC ɐ AF n
juarez	d ʒ u AF a AD ɾ ɛ AD s
julalay	d ʒ u AF l a AD l a AD j AB
jumarang	d ʒ u AF m a AD ɾ a AD ŋ
juntilla	d ʒ u AF n t i AD l l a AD
jurado	d ʒ u AF ɾ a AD d o AF
jusi	d ʒ u AF s i AD
justiniano	d ʒ u AF s t i AD n i AD a AD n o AF
kaagulo	k a AD a AD ɡ u AF l ɔ AF ʔ
kaalit	k a AD ʔ a AD l i AD t
kaanak	k a AD ʔ a AD n a AD k
kaanib	k a AD ʔ a AD n i AD b
kababaihan	k a AD b a AD b a AD ʔ i AD h AA a AD n
kabaligtaran	k a AD b a AD l i AD ɡ t a AD ɾ a AD n
kabalintunaan	k a AD b a AD l i AD n t u AF n a AD ʔ a AD n
kabaong	k a AD b a AD o AF ŋ
kabarkada	k a AD b a AD r k a AD d a AD
kabasangal	k a AD b a AD s a AD ŋ a AD l
kabastusan	k a AD b a AD s t u AF s a AD n
kabayo	k a AD b a AD j AB o AF
kaberdehan	k a AD b ɛ AD ɾ d ɛ AD h AA a AD n
kabig	k a AD b i AD ɡ
kabiling	k a AD b i AD l i AD ŋ
kabuwanan	k a AD b u AF a AD n a AD n
kadena	k a AD d ɛ AD n a AD
kadugo	k a AD d u AF ɡ o AF ʔ
kadyos	k a AD d j AB o AF s
kadyot	k ɑ AD d ʑ ɔ AF t̚
kagalingan	k a AD ɡ a AD l i AD ŋ a AD n
kagaw	k a AD ɡ a AD u AF
kaha	k a AD h AA a AD
kahabagan	k a AD h AA a AD b a AD ɡ a AD n
kahandaan	k a AD h AA a AD n d a AD ʔ a AD n
kaharian	k a AD h AA a AD ɾ i AD a AD n
kahel	k ɐ AF h AA ɛ AD l
kahero	k a AD h AA ɛ AD ɾ o AF
kahihiyan	k a AD h AA i AD h AA i AD a AD n
kahoy	k a AD h AA o AF i AD
kaibigan	k a AD ʔ i AD b i AD ɡ a AD n
kailan	k ɛ AD l a AD n
kain	k a AD ʔ i AD n
kakainin	k a AD k a AD ʔ i AD n i AD n
kakaphay	k a AD k a AD p h AA a AD j AB
kakarampot	k a AD k a AD ɾ a AD m p o AF t
kakayahan	k a AD k ɐ AF y AF ɐ AF h AA a AD n
kakulangan	k a AD k u AF l a AD ŋ a AD n
kakulawas	k a AD k u AF l a AD w AC a AD s
kalaguyo	k a AD l a AD ɡ u AF j AB o AF ʔ
kalakpan	k a AD l a AD k p a AD n
kalaliman	k a AD l a AD l i AD m a AD n
kalan	k a AD l a AD n
kalansay	k a AD l a AD n s a AD j AB
kalantas	k a AD l a AD n t a AD s
kalaswaan	k a AD l a AD s w AC a AD ʔ a AD n
kalat	k a AD l a AD t
kalatas	k a AD l a AD t a AD s
kalatsutsi	k a AD l a AD t ʃ u AF t ʃ i AD ʔ
kalawang	k a AD l a AD w AC a AD ŋ
kalawangin	k a AD l a AD w AC a AD ŋ i AD n
kalayaan	k a AD l ɐ AF i AD ɪ AD a AD ʔ ɐ AF n
kalbaryo	k a AD l b a AD ɾ j AB o AF
kaldero	k a AD l d ɛ AD ɾ o AF
kalendaryo	k a AD l ɛ AD n d a AD ɾ j AB o AF
kalesa	k ɐ AF l ɛː AE s a AD
kalibre	k a AD l i AD b ɾ ɛ AD
kalibugan	k a AD l i AD b u AF ɡ a AD n
kalidad	k a AD l i AD d a AD d
kaligayahan	k a AD l i AD ɡ a AD j AB a AD h AA a AD n
kaligkig	k a AD l i AD ɡ k i AD ɡ
kalihim	k a AD l i AD h AA i AD m
kalima	k a AD l i AD m a AD
kalis	k a AD l i AD s
kaliskis	k a AD l i AD s k i AD s
kaliwanagan	k a AD l i AD w AC a AD n a AD ɡ a AD n
kaliwete	k a AD l i AD w AC ɛ AD t ɛ AD
kalso	k a AD l s o AF
kaluban	k ɐ AF l u AF b ɐ AF n
kalungsuran	k a AD l u AF ŋ s u AF ɾ a AD n
kaluwalhatian	k a AD l u AF l u AF a AD l h AA a AD t i AD ʔ a AD n
kalyo	k a AD l j AB o AF
kamanahan	k a AD m a AD n a AD h AA a AD n
kamandag	k a AD m a AD n d a AD ɡ
kamangmangan	k a AD m a AD ŋ m a AD ŋ a AD n
kamatayan	k a AD m a AD t a AD j AB a AD n
kambal	k a AD m b a AD l
kambyo	k a AD m b j AB o AF
kami	k a AD m ɪ AD
kamihasnan	k a AD m i AD h AA a AD s n a AD n
kampana	k a AD m p a AD n a AD ʔ
kampante	k a AD m p a AD n t ɛ AD
kampanya	k a AD m p a AD n j AB a AD
kampyon	k a AD m p j AB o AF n
kamukha	k a AD m u AF k h AA a AD ʔ
kamunduhan	k a AD m u AF n d u AF h AA a AD n
kandidato	k a AD n d i AD d a AD t o AF
kandila	k a AD n d i AD l a AD ʔ
kanduli	k a AD n d u AF l i AD ʔ
kang	k a AD ŋ
kangkungan	k a AD ŋ k u AF ŋ a AD n
kanina	k a AD n i AD n a AD
kanino	k a AD n i AD n o AF
kaniyugan	k a AD n j AB u AF ɡ a AD n
kanlong	k a AD n l o AF ŋ
kanlungan	k a AD n l u AF ŋ a AD n
kanselasyon	k a AD n s ɛ AD l a AD s j AB o AF n
kanser	k a AD n s ɛ AD ɾ
kanta	k a AD n t a AD
kantahin	k a AD n t a AD h AA i AD n
kantutin	k a AD n t u AF t i AD n
kanyon	k a AD ɲ o AF n
kaopisina	k a AD o AF p i AD s i AD n a AD
kapabayaan	k a AD p a AD b a AD j AB a AD a AD n
kapakanan	k a AD p a AD k a AD n ʔ a AD n
kapalit	k a AD p a AD l i AD t
kapanahunan	k a AD p a AD n a AD h AA u AF n a AD n
kapatawaran	k a AD p a AD t a AD w AC a AD ɾ a AD n
kaphay	k a AD p h AA a AD j AB
kapid	k a AD p i AD d
kapiraso	k a AD p i AD ɾ a AD s o AF
kapitan	k a AD p i AD t a AD n
kaplastikan	k a AD p l a AD s t i AD k a AD n
kapon	k a AD p o AF n
kapotgayong	k a AD p o AF t ɡ a AD j AB o AF ŋ
kapre	k a AD p ɾ ɛ AD
kapuluan	k a AD p u AF l u AF a AD n
kaputsino	k a AD p u AF t ʃ i AD n o AF
karakter	k a AD ɾ a AD k t ɛ AD ɾ
karambola	k a AD ɾ a AD m b o AF l a AD
karamihan	k a AD ɾ a AD m i AD h AA a AD n
karampatan	k a AD ɾ a AD m p a AD t a AD n
karapatan	k a AD ɾ a AD p a AD t a AD n
karayom	k a AD ɾ a AD j AB o AF m
karbon	k a AD ɾ b o AF n
karelyebo	k a AD r ɛ AD ʎ ɛ AD b o AF
karerahan	k a AD ɾ ɛ AD ɾ a AD h AA a AD n
karibal	k a AD ɾ i AD b a AD l
karitela	k a AD ɾ i AD t ɛ AD l a AD
kariton	k a AD ɾ i AD t o AF n
karo	k a AD ɾ o AF
karpintero	k a AD ɾ p i AD n t ɛ AD ɾ o AF
karton	k a AD ɾ t o AF n
karunungan	k a AD ɾ u AF n u AF ŋ a AD n
karupukan	k a AD ɾ u AF p u AF k a AD n
karuwagan	k a AD ɾ u AF a AD ɡ a AD n
kasalanan	k a AD s a AD l a AD n a AD n
kasambahay	k a AD s a AD m b a AD h AA a AD i AD
kasera	k a AD s ɛ AD ɾ a AD
kasero	k a AD s ɛ AD ɾ o AF
kaserola	k a AD s ɛ AD ɾ o AF l a AD
kasiguraduhan	k a AD s i AD ɡ u AF ɾ a AD d u AF h AA a AD n
kasintahan	k a AD s i AD n t a AD h AA a AD n
kasinungalingan	k a AD s i AD n u AF ŋ a AD l i AD ŋ a AD n
kaso	k a AD s ɔ AF
kasoy	k a AD s o AF i AD
kastigo	k a AD s t i AD ɡ o AF
kastiguhin	k a AD s t i AD ɡ u AF h AA i AD n
kasubha	k a AD s u AF b h AA a AD ʔ
kata	k a AD t a AD ʔ
kataga	k a AD t a AD ɡ a AD ʔ
katagalugan	k a AD t a AD ɡ a AD l u AF ɡ a AD n
katakawan	k a AD t a AD k a AD w AC a AD n
katang	k a AD t a AD ŋ
katangahan	k a AD t a AD ŋ a AD h AA a AD n
katarata	k a AD t a AD ɾ a AD t a AD
katawan	k a AD t a AD w AC a AD n
katedral	k a AD t ɛ AD d ɾ a AD l
kati	k ɐ AF t i AD ʔ
katigbak	k a AD t i AD ɡ b a AD k
katiwalian	k a AD t i AD w AC a AD l i AD a AD n
kato	k a AD t o AF ʔ
katolisismo	k a AD t o AF l i AD s i AD s m o AF
katropa	k a AD t r o AF p a AD
katungkulan	k a AD t u AF ŋ k u AF l a AD n
katuruan	k a AD t u AF r u AF ʔ a AD n
katuwang	k a AD t u AF a AD ŋ
kaunti	k ɔ AF n t ɛ AD ʔ
kausap	k a AD u AF s a AD p
kausapin	k a AD u AF s a AD p i AD n
kawad	k a AD w AC a AD d
kay	k a AD i AD
kaya	k aː AE ɪ AD a AD
kayumanggi	k a AD j AB u AF m a AD ŋ ɡ i AD
kelot	k ɛ AD l ɔ AF t
kendi	k ɛ AD n d i AD
keri	k ɛ AD ɾ i AD
ketongin	k ɛ AD t o AF ŋ i AD n
khoo	k uː AG
kiamzon	k i AD a AD m s o AF n
kidsulid	k i AD d s u AF l i AD d
kikil	k i AD k i AD l
kiko	k i AD k o AF ʔ
kilay	k i AD l a AD j AB
kilikili	k i AD l i AD k i AD l i AD
kilo	k i AD l o AF ʔ
kilos	k i AD l o AF s
kilusan	k i AD l u AF s a AD n
kimika	k i AD m ɪ AD k ɐ AF
kindat	k i AD n ʔ d a AD t
king	k i AD ŋ
kintsay	k i AD n t ʃ a AD i AD
kita	k i AD t a AD
kitikiti	k i AD t i AD k i AD t i AD
kiyo	k i AD j AB o AF ʔ
klima	k l i AD m a AD
klinika	k l i AD n i AD k a AD
kloropila	k l o AF r o AF p i AD l ɐ AF
ko	k ɔ AF
kolera	k o AF l ɛ AD ɾ a AD
komander	k o AF m a AD n d ɛ AD ɾ
kombinasyon	k o AF m b i AD n a AD s j AB o AF n
komedya	k o AF m ɛ AD d j AB a AD
komento	k o AF m ɛ AD n t o AF
kometa	k o AF m ɛ AD t a AD
kompleto	k o AF m p l ɛ AD t o AF
komplikasyon	k o AF m p l i AD k a AD s j AB o AF n
komunidad	k o AF m u AF n i AD d a AD d
komunikasyon	k o AF m u AF n i AD k a AD s j AB o AF n
komunista	k o AF m u AF n i AD s t ɐ AF
kondenahin	k o AF n d ɛ AD n a AD h AA i AD n
kondisyon	k o AF n d i AD s j AB o AF n
kong	k ɔ AF ŋ
konstitusyon	k o AF n s t i AD t u AF s j AB o AF n
konsumisyon	k o AF n s u AF m i AD s j AB o AF n
kontak	k o AF n t a AD k
kontakin	k o AF n t a AD k i AD n
kontrobersiya	k o AF n t ɾ o AF b ɛ AD ɾ s j AB a AD
koral	k o AF ɾ a AD l
korona	k o AF ɾ o AF n a AD
koronahan	k o AF ɾ o AF n a AD h AA a AD n
koronel	k o AF ɾ o AF n ɛ AD l
kotse	k o AF t ʃ ɛ AD
krimen	k ɾ i AD m ɛ AD n
kriminal	k ɾ i AD m i AD n a AD l
kritiko	k ɾ i AD t i AD k o AF
kromatina	k r o AF m ɐ AF t i AD n ɐ AF
kromosoma	k r o AF m o AF s o AF m ɐ AF
kroni	k ɾ o AF n i AD
kroniyismo	k ɾ o AF n i AD j AB i AD s m o AF
kua	k w AC a AD
kuba	k u AF b a AD ʔ
kubeta	k u AF b ɛ AD t a AD
kubo	k u AF b o AF
kudkurin	k u AF d k u AF ɾ i AD n
kuha	k u AF h AA a AD
kulambo	k u AF l a AD m b o AF ʔ
kulangi	k u AF l a AD ŋ i AD ʔ
kulangot	k u AF l a AD ŋ o AF t
kulasim	k u AF l a AD s i AD m
kulay	k u AF l a AD j AB
kulayin	k u AF l a AD j AB i AD n
kulaylawas	k u AF l a AD j AB l a AD w AC a AD s
kulayputol	k u AF l a AD j AB p u AF t o AF l
kulig	k u AF l i AD ɡ
kulimlim	k u AF l i AD m l i AD m
kuliti	k u AF l i AD t i AD ʔ
kulos	k u AF l o AF s
kulugo	k u AF l u AF ɡ o AF
kumabig	k u AF m a AD b i AD ɡ
kumain	k u AF m a AD ʔ i AD n
kumanta	k u AF m a AD n t a AD
kumbensiyon	k u AF m b ɛ AD n s i AD o AF n
kumbento	k u AF m b ɛ AD n t o AF
kumbinsihin	k u AF m b i AD n s i AD h AA i AD n
kumbulsiyon	k u AF m b u AF l s i AD o AF n
kumintab	k u AF m i AD n t a AD b
kumot	k u AF m o AF t
kumpas	k u AF m p a AD s
kumpederasyon	k u AF m p ɛ AD d ɛ AD ɾ a AD s j AB o AF n
kumpisal	k u AF m p i AD s a AD l
kumpyansa	k u AF m p j AB a AD n s a AD
kumuha	k u AF m u AF h AA a AD
kumulimlim	k u AF m u AF l i AD m l i AD m
kumunoy	k u AF m u AF n o AF i AD
kumupas	k u AF m u AF p a AD s
kumusta	k u AF m u AF s t a AD
kumuyakoy	k u AF m u AF j AB a AD k o AF i AD
kunan	k u AF n a AD n
kunin	k u AF n i AD n
kupal	k uː AG p a AD l
kupas	k u AF p a AD s
kurag	k u AF ɾ a AD ɡ
kurarap	k u AF ɾ a AD ɾ a AD p
kurba	k u AF ɾ b a AD
kurbata	k u AF ɾ b a AD t a AD
kurot	k u AF ɾ o AF t
kurse	k u AF ɾ s e AD
kursonada	k u AF ɾ s o AF n a AD d a AD
kurtina	k u AF ɾ t i AD n a AD
kuryusidad	k u AF r j AB u AF s i AD d a AD d
kusi	k u AF s i AD
kusina	k u AF s i AD n a AD
kuskos	k u AF s k o AF s
kustodiya	k u AF s t o AF d i AD a AD
kuting	k u AF t i AD ŋ
kutis	k u AF t i AD s
kuto	k u AF t o AF ʔ
kutsara	k u AF t ʃ a AD ɾ a AD
kutsarita	k u AF t ʃ a AD r i AD t a AD
kutson	k u AF t ʃ o AF n
kutya	k u AF t j AB a AD ʔ
kuwan	k u AF a AD n
kwok	k w AC ɔ AF k
kyut	k j AB u AF t
laba	l a AD b a AD
labada	l a AD b a AD d a AD
labag	l a AD b a AD ɡ
labas	l a AD b a AD s
labaskaphay	l a AD b a AD s k a AD p h AA a AD j AB
labastida	l a AD b a AD s t i AD d a AD
labawsugnayan	l a AD b a AD u AF s u AF ɡ n a AD j AB a AD n
labhan	l a AD b h AA a AD n
labi	l a AD b i AD ʔ
labimpito	l a AD b i AD m p i AD t o AF
labindalawa	l a AD b i AD n d a AD l a AD w AC a AD
labingwalo	l a AD b i AD ŋ w AC a AD l o AF
labinlima	l a AD b i AD n l i AD m a AD
labinsiyam	l a AD b i AD n s i AD j AB a AD m
labintatlo	l a AD b i AD n t a AD t l o AF
labnot	l a AD b n o AF t
labong	l a AD b o AF ŋ
lacambra	l a AD k a AD m b ɾ a AD
lacap	l a AD k a AD p
laganap	l a AD ɡ a AD n a AD p
lagay	l a AD ɡ a AD i AD
lagaylay	l a AD ɡ a AD j AB l a AD j AB
lagda	l a AD ɡ d a AD ʔ
lagdameo	l a AD ɡ d a AD m ɛ AD o AF
lagkit	l a AD ɡ k i AD t
lagmak	l a AD ɡ m a AD k
lagmay	l a AD ɡ m a AD i AD
lagnat	l a AD ɡ n a AD t
lagumlalangin	l a AD ɡ u AF m l a AD l a AD ŋ i AD n
lagundi	l a AD ɡ u AF n d i AD
lahat	l a AD h AA a AD t
laitin	l a AD i AD t i AD n
lakan	l a AD k a AD n
lakdawkaphay	l a AD k d a AD w AC k a AD p h AA a AD j AB
lakdawyugto	l a AD k d a AD w AC j AB u AF ɡ t o AF ʔ
laktaw	l a AD k t a AD w AC
lalagyan	l a AD l a AD ɡ j AB a AD n
lalamunan	l a AD l a AD m u AF n a AD n
lalanghutan	l a AD l a AD ŋ h AA u AF t a AD n
lamad	l a AD m a AD d
lamang	l a AD m a AD ŋ
lamig	l a AD m ʔ i AD ɡ
lampara	l a AD m p a AD ɾ a AD
lampin	l a AD m p i AD n
lana	l a AD n a AD
landa	l a AD n d a AD
landrito	l a AD n d ɾ i AD t o AF
lang	l a AD ŋ
langkaan	l a AD ŋ k a AD ʔ a AD n
lansangan	l a AD n s a AD ŋ a AD n
lanting	l a AD n t i AD ŋ
lantsa	l a AD n t ʃ a AD
lanunab	l a AD n u AF n a AD b
lanuza	l a AD n u AF s a AD
lao	l a AD ʊ AF
lapis	l a AD p i AD s
lapnos	l a AD p n o AF s
lapuz	l a AD p u AF s
laquindanum	l a AD k i AD n d a AD n u AF m
larawan	l a AD ɾ a AD w AC a AD n
lascano	l a AD s k a AD n o AF
lasing	l a AD s i AD ŋ
laspag	l a AD s p a AD ɡ
lastiko	l a AD s t i AD k o AF
laswa	l a AD s w AC a AD ʔ
latayan	l a AD t a AD j AB a AD n
lawa	l a AD w AC a AD ʔ
lawaan	l a AD w AC a AD ʔ a AD n
laway	l a AD w AC a AD i AD
lawlaw	l a AD u AF l a AD u AF
laxamana	l a AD k s a AD m a AD n a AD
layag	l a AD j AB a AD ɡ
layas	l a AD j AB a AD s
layaw	l ɐ AF j AB a AD w AC
laygo	l a AD i AD ɡ o AF
laylayan	l a AD i AD l a AD j AB a AD n
laylo	l a AD i AD l o AF
layno	l a AD i AD n o AF
lazarte	l a AD s a AD ɾ t ɛ AD
lazatin	l a AD s a AD t i AD n
lebadura	l e AD b a AD d u AF r ɐ AF
lehitimo	l ɛ AD h AA i AD t i AD m o AF
lengguwahe	l ɛ AD ŋ ɡ w AC a AD h AA ɛ AD
leong	l j AB o AF ŋ
leung	l j AB u AF ŋ
lew	l ʊ AF
leynes	l ɛ AD i AD n ɛ AD s
libak	l i AD b a AD k
libradilla	l i AD b ɾ a AD d i AD l l a AD
libre	l i AD b ɾ ɛ AD
libro	l i AD b r o AF
libuntaon	l i AD b u AF n t a AD ʔ ɔ AF n
lichauco	l i AD t ʃ a AD u AF k o AF
licup	l i AD k u AF p
ligpit	l i AD ɡ p i AD t
liha	l i AD h AA a AD
liham	l i AD h AA a AD m
lihim	l i AD h AA i AD m
lihukan	l i AD h AA u AF k a AD n
likas	l i AD k a AD s
likha	l i AD k h AA a AD ʔ
liknayan	l i AD k n a AD j AB a AD n
liko	l i AD k o AF ʔ
lila	l ɪː AE l ɐ AF
lilom	l i AD l o AF m
lim	l i AD m
lima	l i AD m a AD
limahi	l i AD m a AD h AA i AD ʔ
limahid	l i AD m a AD h AA i AD d
limampu	l i AD m a AD m p u AF ʔ
limandaan	l i AD m a AD n d a AD a AD n
limanlaksa	l i AD m a AD n l a AD k s a AD ʔ
limay	l i AD m a AD j AB
limbaga	l i AD m b a AD ɡ a AD
limit	l i AD m i AD t
limjoco	l i AD m d ʒ o AF k o AF
limos	l i AD m o AF s
linatoc	l i AD n a AD t o AF k
lindol	l i AD n d ɔ AF l
lingad	l i AD ŋ a AD d
linggo	l i AD ŋ ɡ ɔ AF
lingon	l i AD ŋ o AF n
linisan	l i AD n i AD s a AD n
linisin	l i AD n i AD s i AD n
linta	l i AD n t a AD ʔ
liong	l j AB o AF ŋ
lipon	l i AD p o AF n
lipunan	l i AD p u AF n a AD n
liquigan	l i AD k i AD ɡ a AD n
lising	l i AD s i AD ŋ
lislis	l i AD s l i AD s
liso	l i AD s o AF
literasiya	l i AD t ɛ AD ɾ a AD s i AD a AD
litrato	l i AD t ɾ a AD t o AF
liwag	l i AD w AC a AD ɡ
lizada	l i AD s a AD d a AD
llanera	l l a AD n ɛ AD ɾ a AD
llanto	l l a AD n t o AF
lo	l o AF
lodi	l o AF d i AD
logarta	l o AF ɡ a AD ɾ t a AD
lojo	l o AF d ʒ o AF
loka	l o AF k a AD
loko	l o AF k o AF
lola	l o AF l a AD
lomibao	l o AF m i AD b a AD u AF
lomocso	l o AF m o AF k s o AF
lona	l o AF n a AD
longganisa	l o AF ŋ ɡ a AD n i AD s a AD
longhitud	l o AF ŋ h AA i AD t u AF d
loo	l u AF
loob	l ɔ AF ʔ ɔ AF b
loobkaphay	l o AF ʔ o AF b k a AD p h AA a AD j AB
look	l o AF ʔ o AF k
lorenzana	l o AF ɾ ɛ AD n s a AD n a AD
loterya	l o AF t ɛ AD ɾ j AB a AD
lozada	l o AF s a AD d a AD
lu	l u AF
lubak	l u AF b a AD k
lubha	l u AF b h AA a AD ʔ
lubiano	l u AF b j AB a AD n o AF
lugami	l u AF ɡ a AD m i AD ʔ
luho	l u AF h AA o AF ʔ
lukban	l u AF k b a AD n
lula	l u AF l a AD ʔ
luma	l u AF m a AD ʔ
lumabas	l u AF m a AD b a AD s
lumabo	l u AF m a AD b o AF ʔ
lumad	l u AF m a AD d
lumagui	l u AF m a AD ɡ i AD
lumakdang	l u AF m a AD k d a AD ŋ
lumamig	l u AF m a AD m i AD ɡ
lumanglas	l u AF m a AD ŋ l a AD s
lumangoy	l u AF m a AD ŋ o AF j AB
lumapit	l u AF m a AD p i AD t
lumayo	l u AF m a AD j AB o AF ʔ
lumbang	l u AF m b a AD ŋ
lumbao	l u AF m b a AD u AF
lumbo	l u AF m b ɔ AF ʔ
lumboy	l u AF m b ɔ AF j AB
lumibao	l u AF m i AD b a AD u AF
lumikha	l u AF m i AD k h AA a AD ʔ
luminaw	l u AF m i AD n a AD w AC
lumindol	l u AF m i AD n d o AF l
lumipad	l u AF m i AD p a AD d
lumiwanag	l u AF m i AD w AC a AD n a AD ɡ
lumot	l u AF m o AF t
lumutang	l u AF m u AF t a AD ŋ
lumuwag	l u AF m u AF w AC a AD ɡ
lunes	l u AF n ɛ AD s
lungkag	l u AF ŋ k a AD ɡ
luntian	l u AF nː t i AD ɐ AF n
lupa	l u AF p a AD ʔ
lupain	l u AF p a AD ʔ i AD n
lusaw	l u AF s a AD w AC
luto	l u AF t o AF ʔ
luwag	l u AF a AD ɡ
luwalhati	l u AF w AC a AD l h AA a AD t i AD ʔ
luwat	l u AF w AC a AD t
luy	l ʊ AF j AB
luyos	l u AF j AB o AF s
luzano	l u AF s a AD n o AF
luzon	l u AF s o AF n
luzuriaga	l u AF s u AF ɾ j AB a AD ɡ a AD
maagrabyado	m a AD ʔ a AD ʔ ɡ ɾ a AD b j AB a AD d o AF
maambunan	m a AD ʕ a AD m b u AF n a AD n
maanak	m a AD ʔ a AD n a AD k
maangas	m a AD ʔ a AD ŋ a AD s
maanta	m a AD ʔ a AD n t a AD
mababa	m a AD b a AD b a AD ʔ
mabagal	m a AD b a AD ɡ a AD l
mabalot	m a AD b a AD l o AF t
mabato	m a AD b a AD t o AF
mabigat	m a AD b i AD ɡ a AD t
mabigo	m a AD b i AD ɡ o AF ʔ
mabilis	m a AD b i AD l i AD s
mabini	m a AD b i AD n i AD
mabuhay	m a AD b u AF h AA a AD y AF
mabulaklak	m a AD b u AF l a AD k l a AD k
maburyong	m a AD b u AF ɾ j AB o AF ŋ
mabuti	m a AD b u AF t i AD
mabuwisit	m a AD b u AF i AD s i AD t
macababbad	m a AD k a AD b a AD b b a AD d
macadangdang	m a AD k a AD d a AD ŋ d a AD ŋ
macalalad	m a AD k a AD l a AD l a AD d
macalindong	m a AD k a AD l i AD n d o AF ŋ
macapagal	m a AD k a AD p a AD ɡ a AD l
macapinlac	m a AD k a AD p i AD n l a AD k
macapugay	m a AD k a AD p u AF ɡ a AD i AD
macaranas	m a AD k a AD ɾ a AD n a AD s
macasaet	m a AD k a AD s a AD ɛ AD t
macasieb	m a AD k a AD s i AD ɛ AD b
macaspac	m a AD k a AD s p a AD k
macatulad	m a AD k a AD t u AF l a AD d
maceda	m a AD s ɛ AD d a AD
macuha	m a AD k u AF h AA a AD
madalas	m a AD d a AD l a AD s
madali	m a AD d a AD l i AD ʔ
madilim	m a AD d i AD l i AD m
madlangbayan	m a AD d l a AD ŋ b a AD j AB a AD n
madriaga	m a AD d ɾ i AD a AD ɡ a AD
madulas	m a AD d u AF l a AD s
magalang	m a AD ɡ a AD l a AD ŋ
magaling	m a AD ɡ a AD l i AD ŋ
magallanes	m a AD ɡ a AD l l a AD n ɛ AD s
magalona	m a AD ɡ a AD l o AF n a AD
maganda	m a AD ɡ a AD n d a AD
magandahan	m a AD ɡ a AD n d a AD h AA a AD n
magaso	m a AD ɡ a AD s o AF
magbabaon	n a AD ɡ b a AD ʔ o AF n
magbalik	m a AD ɡ b a AD l i AD k
magbanua	m a AD ɡ b a AD n u AF a AD
magbaon	m a AD ɡ b a AD ʔ o AF n
magbarena	m a AD ɡ b a AD ɾ ɛ AD n a AD
magbasanlot	m a AD ɡ b a AD s a AD n l ɔ AF t
magbayad	m a AD ɡ b a AD j AB a AD d
magbenta	m a AD ɡ b e AD n t a AD
magbihis	m a AD ɡ b i AD h AA i AD s
magbili	m a AD ɡ b i AD l i AD
magbinata	m a AD ɡ b i AD n a AD t a AD ʔ
magbiro	m a AD ɡ b i AD ɾ o AF ʔ
magbisikleta	m a AD ɡ b i AD s i AD k l ɛ AD t a AD
magbiyahe	m a AD ɡ b i AD j AB a AD h AA e AD
magboo	m a AD ɡ b o AF o AF
magbubukid	m a AD ɡ b u AF b u AF k i AD d
magbuhat	m a AD ɡ b u AF h AA a AD t
magbulakbol	m a AD ɡ b u AF l a AD k b o AF l
magdalaga	m a AD ɡ d a AD l a AD ɡ a AD
magdasal	m a AD ɡ d a AD s a AD l
magdayao	m a AD ɡ d a AD j AB a AD u AF
magdeliryo	m a AD ɡ d ɛ AD l i AD ɾ j AB o AF
magdemanda	m a AD ɡ d ɛ AD m a AD n d a AD
maggayat	m a AD ɡ ɡ a AD j AB a AD t
maghabilin	m a AD ɡ h AA a AD b i AD l i AD n
maghabla	m a AD ɡ h AA a AD b l a AD
maghanap	m a AD ɡ h AA a AD n a AD p
maghanapbuhay	m a AD ɡ h AA a AD n a AD p b u AF h AA a AD i AD
maghanda	m a AD ɡ h AA a AD n d a AD ʔ
maghangad	m a AD ɡ h AA a AD ŋ a AD d
maghari	m a AD ɡ h AA a AD ɾ i AD ʔ
maghasik	m a AD ɡ h AA a AD s i AD k
maghati	m a AD ɡ h AA a AD t i AD ʔ
maghiganti	m a AD ɡ h AA i AD ɡ a AD n t i AD
maghikab	m a AD ɡ h AA i AD k a AD b
maghikaw	m a AD ɡ h AA i AD k a AD u AF
maghilamos	m a AD ɡ h AA i AD l a AD m o AF s
maghilik	m a AD ɡ h AA i AD l i AD k
maghimagsik	m a AD ɡ h AA i AD m a AD ɡ s i AD k
maghimutok	m a AD ɡ h AA i AD m u AF t o AF k
maghinala	m a AD ɡ h AA i AD n a AD l a AD ʔ
maghingalo	m a AD ɡ h AA i AD ŋ a AD l o AF
maghintay	m a AD ɡ h AA i AD n t a AD j AB
maghinto	m a AD ɡ h AA i AD n t o AF ʔ
maghinuha	m a AD ɡ h AA i AD n u AF h AA a AD ʔ
maghirang	m a AD ɡ h AA i AD ɾ a AD ŋ
maghirap	m a AD ɡ h AA i AD ɾ a AD p
maghiyas	m a AD ɡ h AA i AD a AD s
maghugas	m a AD ɡ h AA u AF ɡ a AD s
maghumpay	m a AD ɡ h AA u AF m p a AD i AD
maghuramentado	m a AD ɡ h AA u AF ɾ a AD m ɛ AD n t a AD d o AF
magigi	m a AD ɡ i AD ɡ i AD ʔ
magiting	m a AD ɡ i AD t i AD ŋ
magjeep	m a AD ɡ d ʒ i AD p
magkanlong	m a AD ɡ k a AD n l o AF ŋ
magkaroon	m a AD ɡ k a AD r o AF ʔ o AF n
magkasakit	m a AD ɡ k a AD s a AD k i AD t
magkataon	m a AD ɡ k a AD t a AD ʔ o AF n
magkausap	m a AD ɡ k a AD u AF s a AD p
maglaba	m a AD ɡ l a AD b a AD
maglabas	m a AD ɡ l a AD b a AD s
maglakbay	m a AD ɡ l a AD k b a AD j AB
maglalang	m a AD ɡ l a AD l a AD ŋ
maglanggas	m a AD ɡ l a AD ŋ ɡ a AD s
maglangib	m a AD ɡ l a AD ŋ i AD b
maglango	m a AD ɡ l a AD ŋ o AF
maglantod	m a AD ɡ l a AD n t o AF d
maglapa	m a AD ɡ l a AD p a AD ʔ
maglarawan	m a AD ɡ l a AD ɾ a AD w AC a AD n
maglaro	m a AD ɡ l a AD ɾ o AF ʔ
maglaso	m a AD ɡ l a AD s o AF
maglaway	m a AD ɡ l a AD w AC a AD i AD
maglingid	m a AD ɡ l i AD ŋ i AD d
maglingkod	m a AD ɡ l i AD ŋ k o AF d
maglola	m a AD ɡ l o AF l a AD
maglolo	m a AD ɡ l o AF l o AF
magmadali	m a AD ɡ m a AD d a AD l i AD ʔ
magmahal	m a AD ɡ m a AD h AA a AD l
magmaliw	m a AD ɡ m a AD l i AD u AF
magmartsa	m a AD ɡ m a AD ɾ t ʃ a AD
magmasahe	m a AD ɡ m a AD s a AD h AA e AD
magmayabang	m a AD ɡ m a AD j AB a AD b a AD ŋ
magnakaw	m a AD ɡ n a AD k a AD u AF
magno	m a AD ɡ n o AF
magpalaganap	m a AD ɡ p a AD l a AD ɡ a AD n a AD p
magpanatili	m a AD ɡ p a AD n a AD t i AD l i AD
magparaya	m a AD ɡ p a AD ɾ a AD j AB a AD ʔ
magpasubasta	m a AD ɡ p a AD s u AF b a AD s t a AD
magpaubaya	m a AD ɡ p a AD ʔ u AF b a AD j AB a AD ʔ
magpraktis	m a AD ɡ p ɾ a AD k t i AD s
magpunas	m a AD ɡ p u AF n a AD s
magrenta	m a AD ɡ ɾ ɛ AD n t a AD
magresign	m a AD ɡ ɾ e AD s a AD ɪ AD n
magsahig	m a AD ɡ s a AD h AA i AD ɡ
magsalang	m a AD ɡ s a AD l a AD ŋ
magsaliksik	m a AD ɡ s a AD l i AD k s i AD k
magsapatos	m a AD ɡ s a AD p a AD t o AF s
magsimba	m a AD ɡ s i AD m b a AD
magsinungaling	m a AD ɡ s i AD n u AF ŋ a AD l i AD ŋ
magsiwalat	m a AD ɡ s i AD w AC a AD l a AD t
magstay	m a AD ɡ s t ɛ AD ɪ AD
magsubscribe	m a AD ɡ s u AF b s k ɾ a AD ɪ AD b
magsugal	m a AD ɡ s u AF ɡ a AD l
magsuntukan	m a AD ɡ s u AF n t u AF k a AD n
magtaas	m a AD ɡ t a AD a AD s
magtaban	m a AD ɡ t a AD b a AD n
magtalas	m a AD ɡ t a AD l a AD s
magtalo	m a AD ɡ t a AD l o AF
magtapon	m a AD ɡ t a AD p o AF n
magtinda	m a AD ɡ t i AD n d a AD
magtipid	m a AD ɡ t i AD p i AD d
magtrabaho	m a AD ɡ t ɾ a AD b a AD h AA o AF
magtrycicle	m a AD ɡ t ɾ a AD ɪ AD s i AD k ɛ AD l
magturo	m a AD ɡ t u AF ɾ o AF ʔ
magugol	m a AD ɡ u AF ɡ o AF l
magulo	m a AD ɡ u AF l o AF
magusot	m a AD ɡ u AF s o AF t
magustuhan	m a AD ɡ u AF s t u AF h AA a AD n
magwagi	m a AD ɡ w AC a AD ɡ i AD
magwahil	m a AD ɡ w AC a AD h AA i AD l
magwisik	m a AD ɡ w AC i AD s i AD k
magyabang	m a AD ɡ j AB a AD b a AD ŋ
magyangyang	m a AD ɡ j AB a AD ŋ j AB a AD ŋ
magyasyas	m a AD ɡ j AB a AD s j AB a AD s
magyaya	m a AD ɡ j AB a AD j AB a AD
magyibok	m a AD ɡ j AB i AD b o AF k
mahal	m a AD h AA a AD l
mahalaga	m a AD h AA a AD l a AD ɡ a AD
mahiman	m a AD h AA i AD m a AD n
mahinay	m a AD h AA i AD n a AD i AD
mahirap	m a AD h AA i AD ɾ a AD p
mahuli	m aː AE h AA u AF l i AD
maikli	m a AD ʔ i AD k l i AD ʔ
maingay	m a AD ʔ i AD ŋ a AD i AD
mainis	m a AD ʔ i AD n i AD s
makaitlo	m a AD k a AD i AD t l o AF
makakita	m a AD k a AD k i AD t a AD
makakuha	m a AD k a AD k u AF h AA a AD
makalat	m a AD k a AD l a AD t
makalima	m a AD k a AD l i AD m a AD
makaluma	m a AD k a AD l u AF m a AD ʔ
makapuno	m a AD k a AD p u AF n o AF ʔ
makati	m ɐ AF k ɐ AF t i AD ʔ
makatotohanan	m a AD k a AD t o AF t o AF h AA a AD n a AD n
makatulog	m a AD k a AD t u AF l o AF ɡ
makiapid	m a AD k i AD ʔ a AD p i AD d
makibahagi	m a AD k i AD b a AD h AA a AD ɡ i AD ʔ
makina	m a AD k i AD n a AD
makinis	m a AD k i AD n i AD s
makipagbati	m a AD k i AD p a AD ɡ b a AD t i AD ʔ
makipagkaibigan	m a AD k i AD p a AD ɡ k a AD i AD b i AD ɡ a AD n
makipagsuntukan	m a AD k i AD p a AD ɡ s u AF n t u AF k a AD n
makipagtalik	m a AD k i AD p a AD ɡ t a AD l i AD k
makontento	m a AD k o AF n t ɛ AD n t o AF
makuha	m a AD k u AF h AA a AD
makulimlim	m a AD k u AF l i AD m l i AD m
makunan	m a AD k u AF n a AD n
malabuyoc	m a AD l a AD b u AF j AB o AF k
malagata	m a AD l a AD ɡ a AD t a AD ʔ
malagatas	m a AD l a AD ɡ a AD t a AD s
malagkit	m a AD l a AD ɡ k i AD t
malakanyang	m a AD l a AD k a AD n j AB a AD ŋ
malalim	m a AD l a AD l i AD m
malaluan	m a AD l a AD l u AF a AD n
malaman	m a AD l a AD m a AD n
malambot	m a AD l a AD m b o AF t
malanasi	m a AD l a AD n a AD s i AD ʔ
malanya	m a AD l a AD n j AB a AD ʔ
malaon	m a AD l a AD ʔ o AF n
malapad	m a AD l a AD p a AD d
malapit	m a AD l a AD p i AD t
malapot	m a AD l a AD p o AF t
malas	m a AD l a AD s
malaswa	m a AD l a AD s w AC a AD ʔ
malaya	m ɐ AF l aː AE ɪ AD a AD
malibag	m a AD l i AD b a AD ɡ
malibiran	m a AD l i AD b i AD ɾ a AD n
malicsi	m a AD l i AD k s i AD
maligaw	m a AD l i AD ɡ a AD u AF
malihan	m a AD l i AD h AA a AD n
malikhain	m a AD l i AD k h AA a AD ʔ i AD n
maliksi	m a AD l i AD k s i AD
malilom	m a AD l i AD l o AF m
malimit	m a AD l i AD m i AD t
mallare	m a AD l l a AD ɾ ɛ AD
mallorca	m a AD l l o AF ɾ k a AD
malubak	m a AD l u AF b a AD k
malusog	m a AD l u AF s o AF ɡ
maluwat	m a AD l u AF w AC a AD t
mama	m a AD m a AD ʔ
mamagitan	m a AD m a AD ɡ i AD t a AD n
mamahagi	m a AD m a AD h AA a AD ɡ i AD ʔ
mamakyaw	m a AD m a AD k j AB a AD u AF
mamanhikan	m a AD m a AD n h AA i AD k a AD n
mamaril	m a AD m a AD ɾ i AD l
mamasada	m a AD m a AD s a AD d a AD
mamasura	m a AD m a AD s u AF ɾ a AD
mamatay	m a AD m a AD t a AD j AB
mambabae	m a AD m b a AD b a AD ʔ ɛ AD
mambola	m a AD m b o AF l a AD
mamboso	m a AD m b o AF s o AF
mambugaw	m a AD m b u AF ɡ a AD u AF
mambuwisit	m a AD m b u AF i AD s i AD t
mamigay	m a AD m i AD ɡ a AD i AD
mamihasa	m a AD m i AD h AA a AD s a AD ʔ
mamilis	m a AD m i AD l i AD s
mamimili	m a AD m i AD m i AD l i AD
mamintog	m a AD m i AD n t o AF ɡ
mamuhunan	m a AD m u AF h AA u AF n a AD n
mamulaklak	m a AD m u AF l a AD k l a AD k
mamuti	m a AD m u AF t i AD ʔ
mamuyac	m a AD m u AF j AB a AD k
man	m a AD n
mana	m a AD n a AD
manabat	m a AD n a AD b a AD t
manabunot	m a AD n a AD b u AF n o AF t
managinip	m a AD n a AD ɡ i AD n i AD p
manakit	m a AD n a AD k i AD t
manalad	m a AD n a AD l a AD d
manalo	m a AD n a AD l o AF
manaloto	m a AD n a AD l o AF t o AF
manamantala	m a AD n a AD m a AD n t a AD l a AD
mananahi	m a AD n a AD n a AD h AA i AD ʔ
manananggal	m a AD n a AD n a AD ŋ ɡ a AD l
manangan	m a AD n a AD ŋ a AD n
mananghalian	m a AD n a AD ŋ h AA a AD l i AD ʔ a AD n
mananquil	m a AD n a AD n k i AD l
manantan	m a AD n a AD n t a AD n
manaog	m a AD n a AD o AF ɡ
manaois	m a AD n a AD o AF i AD s
manarang	m a AD n a AD ɾ a AD ŋ
manatad	m a AD n a AD t a AD d
mancao	m a AD ŋ k a AD u AF
mandaragat	m a AD n d a AD ɾ a AD ɡ a AD t
mandirigma	m a AD n d i AD ɾ i AD ɡ m a AD ʔ
mandocdoc	m a AD n d o AF k d o AF k
mandukot	m a AD n d u AF k o AF t
mandurukot	m a AD n d u AF ɾ u AF k o AF t
mangagat	m a AD ŋ a AD ɡ a AD t
mangailangan	m a AD ŋ a AD ʔ i AD l a AD ŋ a AD n
mangalunya	m a AD ŋ a AD l u AF n j AB a AD ʔ
mangamba	m a AD ŋ a AD m b a AD
mangamote	m a AD ŋ a AD m o AF t ɛ AD
manganak	m a AD ŋ a AD n a AD k
mangaoang	m a AD ŋ a AD w AC a AD ŋ
mangaway	m a AD ŋ a AD w AC a AD i AD
manggagantso	m a AD ŋ ɡ a AD ɡ a AD n t ʃ o AF
manggantso	m a AD ŋ ɡ a AD n t ʃ o AF
manggas	m a AD ŋ ɡ a AD s
manggulo	m a AD ŋ ɡ u AF l o AF
manghawa	m a AD ŋ h AA a AD w AC a AD
manghimasok	m a AD ŋ h AA i AD m a AD s o AF k
manghuhula	m a AD ŋ h AA u AF h AA u AF l a AD ʔ
manghula	m a AD ŋ h AA u AF l a AD ʔ
manghusga	m a AD ŋ h AA u AF s ɡ a AD
mangikil	m a AD ŋ i AD k i AD l
mangilit	m a AD ŋ i AD l i AD t
mangingisda	m a AD ŋ i AD ŋ i AD s d a AD ʔ
mangisay	m a AD ŋ i AD s a AD i AD
mangisda	m a AD ŋ i AD s d a AD ʔ
mangitlog	m a AD ŋ i AD t l o AF ɡ
mangkok	m a AD ŋ k o AF k
manglicmot	m a AD ŋ l i AD k m o AF t
mangoba	m a AD ŋ o AF b a AD
mangopya	m a AD ŋ o AF p j AB a AD
mangubra	m a AD ŋ u AF b ɾ a AD
manguha	m a AD ŋ u AF h AA a AD
manguiat	m a AD ŋ i AD a AD t
mangulabnan	m a AD ŋ u AF l a AD b n a AD n
mangulangot	m a AD ŋ u AF l a AD ŋ o AF t
mangupit	m a AD ŋ u AF p i AD t
mangwika	m a AD ŋ w AC i AD k a AD ʔ
mangyari	m a AD ŋ j AB a AD ɾ i AD
manhid	m a AD n h AA i AD d
maniago	m a AD n i AD a AD ɡ o AF
maniego	m a AD n j AB ɛ AD ɡ o AF
manilaw	m a AD n i AD l a AD u AF
manilip	m a AD n i AD l i AD p
manindigan	m a AD n i AD n d i AD ɡ a AD n
maniquiz	m a AD n i AD k i AD s
manlaban	m a AD n l a AD b a AD n
manlait	m a AD n l a AD ʔ i AD t
manlangit	m a AD n l a AD ŋ i AD t
manlapaz	m a AD n l a AD p a AD s
manlapig	m a AD n l a AD p i AD ɡ
manlililok	m a AD n l i AD l i AD l o AF k
manloko	m a AD n l o AF k o AF
manlutac	m a AD n l u AF t a AD k
manood	m a AD n o AF o AF d
manoy	m a AD n o AF j AB
manrique	m a AD n ɾ i AD k ɛ AD
mansiyon	m a AD n s j AB o AF n
mansusugnay	m a AD n s u AF s u AF ɡ n a AD j AB
mantika	m a AD n t i AD k a AD ʔ
manuhol	m a AD n u AF h AA o AF l
manuntok	m a AD n u AF n t o AF k
mapagkawanggawa	m a AD p a AD ɡ k a AD w AC a AD ŋ ɡ a AD w AC a AD ʔ
mapagmatyag	m a AD p a AD ɡ m a AD t j AB a AD ɡ
mapagsamantala	m a AD p a AD ɡ s a AD m a AD n t a AD l a AD
mapahiya	m a AD p a AD h AA i AD j AB a AD ʔ
mapalad	m a AD p a AD l a AD d
mapanghusga	m a AD p a AD ŋ h AA u AF s ɡ a AD
mapangutya	m a AD p a AD ŋ u AF t j AB a AD ʔ
mapaniil	m a AD p a AD n i AD i AD l
mapatay	m a AD p a AD t a AD j AB
mapua	m ɐ AF p ʊ AF w AC a AD
mapusyaw	m ɐ AF p ʊ AF s j AB ɐ AF u AF
maputik	m a AD p u AF t i AD k
maralit	m a AD ɾ a AD l i AD t
marapao	m a AD ɾ a AD p a AD o AF
maravilla	m a AD ɾ a AD b i AD l l a AD
marbella	m a AD ɾ b ɛ AD l l a AD
marcial	m a AD ɾ s j AB a AD l
marikit	m a AD ɾ i AD k i AD t
maristela	m a AD ɾ i AD s t ɛ AD l a AD
mariñas	m a AD ɾ i AD ɲ a AD s
marquez	m a AD ɾ k ɛ AD s
marquinez	m a AD ɾ k i AD n ɛ AD s
marso	m a AD ɾ s o AF
marupok	m a AD ɾ u AF p o AF k
masabon	m a AD s a AD b o AF n
masaker	m a AD s a AD k ɛ AD ɾ
masakit	m a AD s a AD k i AD t
masaktan	m a AD s a AD k t a AD n
masamain	m a AD s a AD m a AD i AD n
masamid	m a AD s a AD m i AD d
masangcay	m a AD s a AD ŋ k a AD i AD
masangkay	m a AD s a AD ŋ k a AD i AD
masaya	m a AD s a AD j AB a AD
maselan	m a AD s ɛ AD l a AD n
masikhay	m a AD s i AD k h AA a AD j AB
masikip	m a AD s i AD k i AD p
masipag	m a AD s i AD p a AD ɡ
maski	m a AD s k i AD
masukal	m a AD s u AF k a AD l
masurot	m a AD s u AF ɾ o AF t
mataasnakahoy	m a AD t a AD ʔ a AD s n a AD k a AD h AA o AF i AD
matae	m a AD t a AD ʔ ɛ AD
matalino	m a AD t a AD l i AD n o AF
matalo	m a AD t a AD l o AF
matapang	m a AD t a AD p a AD ŋ
matapon	m a AD t a AD p o AF n
matatakutin	m a AD t a AD t a AD k u AF t i AD n
matauhan	m a AD t a AD ʔ u AF h AA a AD n
matibag	m a AD t i AD b a AD ɡ
matigas	m a AD t i AD ɡ a AD s
matisod	m a AD t i AD s o AF d
matrapik	m a AD t ɾ a AD p i AD k
matris	m a AD t ɾ i AD s
matso	m ɑ AD t ʃ o AF
matulin	m a AD t u AF l i AD n
matulog	m a AD t u AF l o AF ɡ
matwiran	m a AD t w AC i AD ɾ a AD n
maulanan	m a AD u AF l a AD n a AD n
mauleon	m a AD u AF l ɛ AD o AF n
maunahan	m a AD u AF n a AD h AA a AD n
mawo	m a AD w AC o AF ʔ
maya	m a AD j AB a AD
maybahay	m a AD i AD b a AD h AA a AD i AD
maynila	m a AD j AB n i AD l a AD ʔ
mayuga	m a AD j AB u AF ɡ a AD
mañago	m a AD ɲ a AD ɡ o AF
mañalac	m a AD ɲ a AD l a AD k
medalya	m ɛ AD d a AD l j AB a AD
medrano	m ɛ AD d ɾ a AD n o AF
medyor	m ɛ AD d ʒ o AF ɾ
melegrito	m ɛ AD l ɛ AD ɡ ɾ i AD t o AF
menchavez	m ɛ AD n t ʃ a AD b ɛ AD s
menorca	m ɛ AD n o AF ɾ k a AD
mensahe	m ɛ AD n s a AD h AA ɛ AD
merienda	m ɛ AD ɾ j AB ɛ AD n d a AD
meryenda	m ɛ AD ɾ j AB ɛ AD n d a AD
mesa	m ɛ AD s a AD
mga	m ɐ AF ŋ a AD
michelena	m i AD t ʃ ɛ AD l ɛ AD n a AD
mijares	m i AD d ʒ a AD ɾ ɛ AD s
miksipat	m i AD k s i AD p a AD t
militante	m i AD l i AD t a AD n t ɛ AD
minviluz	m i AD n b i AD l u AF s
miranda	m i AD ɾ a AD n d a AD
misay	m i AD s a AD j AB
mismo	m ɪ AD s m ɔ AF
misteryo	m i AD s t ɛ AD ɾ j AB o AF
mitsa	m i AD t ʃ a AD
miyentras	m i AD j AB e AD n t r a AD s
mo	m o AF
mohon	m o AF h AA o AF n
mondragon	m o AF n d ɾ a AD ɡ o AF n
mongol	m o AF ŋ ɡ o AF l
monte	m o AF n t ɛ AD
montealegre	m o AF n t ɛ AD a AD l ɛ AD ɡ ɾ ɛ AD
montecalvo	m o AF n t ɛ AD k a AD l b o AF
montejo	ʔ a AD l k a AD i AD d ɛ AD
montillano	m o AF n t i AD l l a AD n o AF
montinola	m o AF n t i AD n o AF l a AD
montojo	m o AF n t o AF d ʒ o AF
montoya	m o AF n t o AF j AB a AD
morato	m o AF ɾ a AD t o AF
motorsiklo	m o AF t o AF ɾ s i AD k l o AF
mukha	m u AF k h AA a AD ʔ
mulasik	m u AF l a AD s i AD k
mulinsigla	m u AF l i AD n s i AD ɡ l a AD
mulinyari	m u AF l i AD n j AB a AD ɾ i AD ʔ
mulkaphay	m u AF l k a AD p h AA a AD j AB
mulpikan	m u AF l p i AD k a AD n
multa	m u AF l t a AD
mumshie	m a AD m ʃ i AD
munggo	m u AF ŋ ɡ o AF
mura	m u AF ɾ a AD
musika	m u AF s i AD k a AD
musoleyo	m u AF s o AF l ɛ AD j AB o AF
musta	m u AF s t a AD
muta	m u AF t a AD ʔ
mutha	m u AF t h AA a AD ʔ
mutuc	m u AF t u AF k
muwebles	m w AC ɛ AD b l ɛ AD s
na	n a AD
na'ng	n ɐ AF ŋ
nacpil	n a AD k p i AD l
nagbabaon	n a AD ɡ b a AD b a AD ʔ o AF n
nagbaon	n a AD ɡ b a AD ʔ o AF n
nagwas	n a AD ɡ w AC ɐ AF s
nakakaalarma	n a AD k a AD k a AD a AD l a AD ɾ m a AD
nakakabingi	n a AD k a AD k a AD b i AD ŋ i AD
nakakabobo	n ɐ AF k a AD k ɐ AF b ɔ AF b ɔ AF
nakakabuwisit	n a AD k a AD k a AD b w AC i AD s i AD t
nakakabwisit	n a AD k a AD k a AD b w AC i AD s i AD t
nakakahawa	n a AD k a AD k a AD h AA a AD w AC a AD
nakakaintriga	n a AD k a AD k a AD ʔ i AD n t ɾ i AD ɡ a AD
nakakaloko	n a AD k a AD k a AD l o AF k o AF
nakakapagpabagabag	n a AD k a AD k a AD p a AD ɡ p a AD b a AD ɡ a AD b a AD ɡ
nakakatakot	n a AD k a AD k a AD t a AD k o AF t
nakamulaga	n a AD k a AD m u AF l a AD ɡ a AD ʔ
nakawin	n a AD k a AD w AC i AD n
nakayukyok	n a AD k a AD j AB u AF k j AB o AF k
nakpil	n a AD k p i AD l
naman	n a AD m a AD n
namin	n aː AE m ɪ AD n
nang	n ɐ AF ŋ
nanlilimahid	n a AD n l i AD l i AD m a AD h AA i AD d
napnap	n a AD p n a AD p
narvaez	n a AD ɾ b a AD ɛ AD s
natae	n a AD t a AD ʔ ɛ AD
natin	n a AD t ɛ AD n
navoa	n a AD b o AF a AD
nene	n ɛ AD n ɛ AD ʔ
ng	n ɐ AF ŋ
nga	ŋ a AD ʔ
ngalan	ŋ a AD l a AD n
nganga	ŋ a AD ŋ a AD ʔ
ngayon	ŋ a AD j AB o AF n
ngimay	ŋ i AD m a AD i AD
ngo	ŋ o AF
ngumiti	ŋ u AF m i AD t i AD ʔ
ngumuya	ŋ u AF m u AF j AB a AD ʔ
nguso	ŋ u AF s o AF ʔ
nguya	ŋ u AF j AB a AD ʔ
ni	n iː AE
nicdao	n i AD k d a AD o AF
nietes	n j AB ɛ AD t ɛ AD s
niknik	n i AD k n i AD k
nila	n i AD l a AD
nilabhan	n i AD l a AD b h AA a AD n
ninang	n i AD n a AD ŋ
nino	n i AD n o AF
ninyo	n i AD n j AB o AF
nito	n i AD t o AF
nitroheno	n i AD t r o AF h AA e AD n o AF
niya	ɲ a AD
niyo	n i AD o AF
niyon	n u AF n
nobela	n o AF b ɛ AD l a AD
nobleza	n o AF b l ɛ AD s a AD
nolasco	n o AF l a AD s k o AF
noriega	n o AF ɾ j AB ɛ AD ɡ a AD
notarte	n o AF t a AD ɾ t ɛ AD
novero	n o AF b ɛ AD ɾ o AF
nuevo	n u AF ɛ AD b o AF
numero	n u AF m ɛ AD ɾ ɔ AF
o	ɔː AG
obligacion	ʔ o AF b l i AD ɡ a AD s j AB o AF n
obrero	ʔ o AF b ɾ ɛ AD ɾ o AF
ocampo	ʔ o AF k a AD m p o AF
oksiheno	o AF k s i AD h AA e AD n o AF
olaguer	ʔ o AF l a AD ɡ ɛ AD ɾ
olaivar	ʔ o AF l a AD i AD b a AD ɾ
olalia	ʔ o AF l a AD l i AD a AD
olayvar	ʔ o AF l a AD i AD b a AD ɾ
oliva	ʔ o AF l i AD b a AD
olivares	ʔ o AF l i AD b a AD ɾ ɛ AD s
oliveros	ʔ o AF l i AD b ɛ AD ɾ o AF s
olmedo	ʔ o AF l m ɛ AD d o AF
ong	ɔ AF ŋ
ongkiko	ʔ o AF ŋ k i AD k o AF
oo	oː AG ʔ o AF
opeña	ʔ o AF p ɛ AD ɲ a AD
opisyales	ʔ o AF p i AD s j AB a AD l ɛ AD s
opyum	ʔ o AF p j AB u AF m
oracion	ʔ o AF ɾ a AD s j AB o AF n
orasan	o AF r a AD s a AD n
orendain	ʔ o AF ɾ ɛ AD n d a AD i AD n
orense	ʔ o AF ɾ ɛ AD n s ɛ AD
oribello	ʔ o AF ɾ i AD b ɛ AD l l o AF
paalam	p ɐ AF ʔ ɐ AF l a AD m
paano	p a AD ʔ a AD n o AF
paaralan	p a AD a AD ɾ ɐ AF l a AD n
pabalikin	p a AD b a AD l i AD k i AD n
pabebe	p a AD b ɛ AD b ɛ AD
pabiyay	p a AD b i AD j AB a AD j AB
pabor	p a AD b o AF ɾ
paborito	p a AD b o AF ɾ a AD b l ɛ AD
pabuksan	p a AD b u AF k s a AD n
pabuya	p a AD b u AF j AB a AD ʔ
pacana	p a AD k a AD n a AD
pacaña	p a AD k a AD ɲ a AD
padaanin	p a AD d a AD a AD n i AD n
padaliin	p a AD d a AD l i AD i AD n
pader	p a AD d ɛ AD ɾ
pagala	p a AD ɡ a AD l a AD ʔ
pagalingin	p a AD ɡ a AD l i AD ŋ i AD n
pagbabalik	p a AD ɡ b a AD b a AD l i AD k
pagbasehan	p a AD ɡ b a AD s ɛ AD h AA a AD n
pagbati	p a AD ɡ b a AD t i AD ʔ
pagbubuntis	p a AD ɡ b u AF b u AF n t i AD s
pagcaliwagan	p a AD ɡ k a AD l i AD w AC a AD ɡ a AD n
pagdaan	p a AD ɡ d a AD a AD n
pagdila	p a AD ɡ d i AD l a AD ʔ
pagdilao	p a AD ɡ d i AD l a AD u AF
paggiba	p a AD ɡ ɡ i AD b a AD ʔ
paghigantihan	p a AD ɡ h AA i AD ɡ a AD n t i AD h AA a AD n
paghuyad	p a AD ɡ h AA u AF j AB a AD d
pagi	p a AD ɡ i AD
pagitan	p a AD ɡ i AD t a AD n
pagkaigkasin	p a AD ɡ k a AD ʔ i AD ɡ k a AD s i AD n
pagkakaibigan	p a AD ɡ k a AD k a AD i AD b i AD ɡ a AD n
pagkakasakit	p a AD ɡ k a AD k a AD s a AD k i AD t
pagkakataon	p a AD ɡ k a AD k a AD t a AD ʔ o AF n
pagkamakabagunsakupin	p a AD ɡ k a AD m a AD k a AD b a AD ɡ u AF n s a AD k u AF p i AD n
pagkamakagahum	p a AD ɡ k a AD m a AD k a AD ɡ a AD h AA u AF m
pagkawakaak	p a AD ɡ k a AD w AC a AD k a AD ʔ a AD k
pagmamadali	p a AD ɡ m a AD m a AD d a AD l i AD ʔ
pagnanakaw	p a AD ɡ n a AD n a AD k a AD u AF
pagsamantalahan	p a AD ɡ s a AD m a AD n t a AD l a AD h AA a AD n
pagsanjan	p a AD ɡ s a AD n h AA a AD n
pagsuway	p a AD ɡ s u AF a AD i AD
pagtaban	p a AD ɡ t a AD b a AD n
pagtakhan	p a AD ɡ t a AD k h AA a AD n
pagtripan	p a AD ɡ t ɾ i AD p a AD n
pagtutulungan	p a AD ɡ t u AF t u AF l u AF ŋ a AD n
paguia	p a AD ɡ j AB a AD
paguio	p a AD ɡ j AB o AF
pagwawaliwali	p a AD ɡ w AC a AD l i AD w AC a AD l i AD
pagwawasak	p a AD ɡ w AC a AD w AC a AD s a AD k
pagwitwit	p a AD ɡ w AC i AD t w AC i AD t
pagwiwisik	p a AD ɡ w AC i AD w AC i AD s i AD k
pagyukyok	p a AD ɡ j AB u AF k j AB o AF k
pahayagan	p aː AE h AA a AD i AD a AD ɡ a AD n
pahilaga	p a AD h AA i AD l a AD ɡ a AD ʔ
pahina	p a AD h AA i AD n a AD
pahinarya	p ɐ AF h AA i AD n a AD r j AB ɐ AF
pahintulot	p a AD h AA i AD n t u AF l o AF t
pahiyain	p a AD h AA i AD a AD ʔ i AD n
painitin	p a AD ʔ i AD n i AD t i AD n
pajares	p a AD d ʒ a AD ɾ ɛ AD s
pakialam	p a AD k ɛ AD ɐ AF l a AD m
pakialamero	p a AD k i AD ʔ a AD l a AD m e AD ɾ o AF
pakid	p a AD k i AD d
pakikipagtalik	p a AD k i AD k i AD p a AD ɡ t a AD l i AD k
pakiwani	p a AD k i AD w AC a AD n i AD
pakla	p a AD k l a AD
pakulo	p a AD k u AF l o AF ʔ
pakwan	p a AD k w AC a AD n
palacol	p a AD l a AD k o AF l
paladutaan	p a AD l a AD d u AF t a AD ʔ a AD n
palafox	p a AD l a AD p o AF k s
palagyan	p a AD l a AD ɡ j AB a AD n
palahaw	p a AD l a AD h AA a AD u AF
palakol	p a AD l a AD k o AF l
palamakatauhan	p a AD l a AD m a AD k a AD t a AD ʔ u AF h AA a AD n
palamigin	p a AD l a AD m i AD ɡ i AD n
palamuhayan	p a AD l a AD m u AF h AA a AD j AB a AD n
palamuti	p a AD l a AD m u AF t i AD ʔ
palasihayan	p a AD l a AD s i AD h AA a AD j AB a AD n
palasihayanan	p a AD l a AD s i AD h AA a AD j AB a AD n a AD n
palaspas	p a AD l a AD s p a AD s
palatatagnan	p a AD l a AD t a AD t a AD ɡ n a AD n
palatumbasan	p a AD l a AD t u AF m b a AD s a AD n
palaulatan	p a AD l ɐ AF ʔ u AF l ɐ AF t a AD n
palay	p a AD l a AD j AB
palayan	p a AD l a AD j AB a AD n
palayasin	p a AD l a AD j AB a AD s i AD n
palima	p a AD l i AD m a AD
paliparan	p ɐ AF l ɪ AD p ɐ AF ɾ a AD n
palisoc	p a AD l i AD s o AF k
palit	p a AD l i AD t
palitada	p a AD l i AD t a AD d a AD
palitadahan	p a AD l i AD t a AD d a AD h AA a AD n
palitan	p a AD l i AD t a AD n
palo	p a AD l o AF ʔ
palomares	p a AD l o AF m a AD ɾ ɛ AD s
palos	p a AD l ɔ AF s
pamabat	p a AD m a AD b a AD t
pamahalaan	p a AD m a AD h AA a AD l a AD ʔ a AD n
pamalo	p a AD m a AD l o AF ʔ
pamamanhikan	p a AD m a AD m a AD n h AA i AD k a AD n
pamamaril	p a AD m a AD m a AD ɾ i AD l
pamaypay	p a AD m a AD i AD p a AD i AD
pamimilosopo	p a AD m i AD m i AD l o AF s o AF p o AF
paminta	p a AD m i AD n t a AD
pamintuan	p a AD m i AD n t u AF a AD n
pan	p a AD n
panahon	p a AD n a AD h AA o AF n
panalangin	p a AD n a AD l a AD ŋ i AD n
panalo	p a AD n a AD l o AF
pananabotahe	p a AD n a AD n a AD b o AF t a AD h AA ɛ AD
pananagutan	p a AD n a AD n a AD ɡ u AF t a AD n
pandemya	p a AD n d ɛ AD m j AB a AD
pandiwa	p a AD n d i AD w AC a AD ʔ
panelo	p a AD n ɛ AD l o AF
pang	p a AD ŋ
pangalan	p a AD ŋ a AD l a AD n
panghimasukan	p a AD ŋ h AA i AD m a AD s u AF k a AD n
pangit	p a AD ŋ i AD t
pangngalan	p a AD ŋ ŋ a AD l a AD n
pangungusap	p a AD ŋ u AF ŋ u AF s a AD p
pangwilig	p a AD ŋ w AC i AD l i AD ɡ
panibughuin	p a AD n i AD b u AF ɡ h AA u AF ʔ i AD n
panilan	p a AD n i AD l a AD n
paninigarilyo	p a AD n i AD n i AD ɡ a AD ɾ i AD l j AB o AF
panitikan	p a AD n i AD t i AD k a AD n
panlaqui	p a AD n l a AD k i AD
pansamantala	p a AD n s a AD m a AD n t a AD l a AD
pantas	p a AD n t a AD s
pantig	p a AD n t i AD ɡ
panukala	p a AD n u AF k a AD l a AD ʔ
paos	p a AD ʔ o AF s
papel	p a AD p e AD l
para	p aː AE ɾ a AD
paraan	p a AD ɾ a AD ʔ a AD n
parada	p a AD ɾ a AD d a AD
paragas	p a AD ɾ a AD ɡ a AD s
parayno	p a AD ɾ a AD i AD n o AF
pareño	p a AD ɾ ɛ AD ɲ o AF
pari	p a AD ɾ i AD ʔ
parihaba	p ɐ AF r i AD h AA a AD b a AD ʔ
parilla	p a AD ɾ i AD l l a AD
pariugat	p ɐ AF ɾ ɪ AD ʔ u AF ɡ a AD t
parreño	p a AD ɾ ɛ AD ɲ o AF
parusa	p a AD ɾ u AF s a AD
pasabugin	p a AD s a AD b u AF ɡ i AD n
pasaway	p a AD s a AD w AC a AD i AD
pasensya	p a AD s ɛ AD n ɕ a AD
pasiya	p a AD s j AB a AD
paskil	p ɐ AF s k i AD l
pasko	p a AD s k o AF
paskuwa	p a AD s k u AF a AD
pasok	p aː AE s ɔ AF k
pasugalan	p a AD s u AF ɡ a AD l a AD n
pasukan	p a AD s u AF k a AD n
pasukin	p a AD s u AF k i AD n
pasulo	p a AD s u AF l o AF
patahian	p a AD t a AD h AA i AD ʔ a AD n
patakbuhin	p a AD t a AD k b u AF h AA i AD n
patalastas	p a AD t a AD l a AD s t a AD s
patawanin	p a AD t a AD w AC a AD n i AD n
patay	p a AD t a AD ɪ AD
patda	p a AD t d a AD
patiag	p a AD t j AB a AD ɡ
patidyugto	p a AD t i AD d j AB u AF ɡ t o AF ʔ
patimog	p a AD t i AD m o AF ɡ
patiño	p a AD t i AD ɲ o AF
patnubay	p a AD t n u AF b a AD i AD
pato	p aː AE t ɔ AF
patron	p a AD t ɾ o AF n
patupat	p a AD t u AF p a AD t
patutsada	p a AD t u AF t s a AD d a AD
patuusan	p a AD t u AF ʔ ɔ AF s a AD n
paupahan	p a AD u AF p a AD h AA a AD n
pausukan	p a AD u AF s u AF k a AD n
pauwiin	p a AD u AF w AC i AD i AD n
pawis	p a AD w AC i AD s
payak	p a AD j AB a AD k
payamanin	p a AD j AB a AD m a AD n i AD n
payumo	p a AD j AB u AF m o AF
paz	p a AD s
pebrero	p ɛ AD b ɾ ɛ AD ɾ o AF
pecson	p ɛ AD k s o AF n
peke	p ɛ AD k ɛ AD ʔ
peklat	p ɛ AD k l a AD t
peste	p ɛ AD s t ɛ AD
pestisidyo	p ɛ AD s t i AD s i AD d j AB o AF
petmalu	p e AD t m a AD l u AF
petsay	p e AD t t ʃ a AD j AB
peñaflor	p ɛ AD ɲ a AD p l o AF ɾ
peñaflorida	p ɛ AD ɲ a AD p l o AF ɾ i AD d a AD
peñaranda	p ɛ AD ɲ a AD ɾ a AD n d a AD
piga	p i AD ɡ a AD ʔ
pigain	p i AD ɡ a AD ʔ i AD n
pigsa	p i AD ɡ s a AD ʔ
pihikan	p i AD h AA i AD k a AD n
piho	p i AD h AA o AF
pila	p i AD l a AD
pilantik	p i AD l a AD n t i AD k
pilantropo	p i AD l a AD n t ɾ o AF p o AF
pilapil	p i AD l a AD p i AD l
pilat	p i AD l a AD t
pilay	p i AD l a AD j AB
pilipinas	p i AD l i AD p i AD n a AD s
pilosopiya	p i AD l o AF s o AF p i AD a AD
pilosopo	p i AD l o AF s o AF p o AF
pilyo	p i AD l j AB o AF
pinaghihinalaan	p i AD n a AD ɡ h AA i AD h AA i AD n a AD l a AD a AD n
pinagsamantalahan	p i AD n a AD ɡ s a AD m a AD n t a AD l a AD h AA a AD n
pindot	p i AD n d o AF t
pinggan	p i AD ŋ ɡ a AD n
pinlac	p i AD n l a AD k
pino	p i AD n o AF
pintakasi	p i AD n t a AD k a AD s i AD
piraso	p i AD ɾ a AD s o AF
pirmahan	p i AD ɾ m a AD h AA a AD n
pisika	p i AD s ɪ AD k ɐ AF
piskal	p i AD s k a AD l
piskalya	p i AD s k a AD l j AB a AD
pista	p i AD s t a AD
pitis	p i AD t i AD s
pito	p i AD t ɔ AF
pitumpu	p i AD t u AF m p u AF ʔ
pitundaan	p i AD t u AF n d a AD a AD n
piyo	p i AD j AB o AF ʔ
pizarro	p i AD s a AD ɾ ɾ o AF
piñon	p i AD ɲ o AF n
planas	p l a AD n a AD s
plastik	p l a AD s t i AD k
plebisito	p l e AD b i AD s i AD t o AF
po	p ɔ AF
pobre	p ɔː AG b r ɛ AD
pokpok	p ɔ AF k p ɔ AF k
policarpio	p o AF l i AD k a AD ɾ p j AB o AF
polintan	p o AF l i AD n t a AD n
polo	p o AF l o AF
pondo	p o AF n d o AF
pondohan	p o AF n d o AF h AA a AD n
ponkan	p o AF ŋ k a AD n
poon	p u AF n
portuges	p o AF ɾ t u AF ɡ ɛ AD s
posas	p o AF s a AD s
post	p o AF u AF s t
prado	p ɾ a AD d o AF
praning	p ɾ a AD n i AD ŋ
prayoridad	p ɾ a AD j AB o AF ɾ i AD d a AD d
premyo	p ɾ ɛ AD m j AB o AF
preso	p ɾ ɛ AD s o AF
proklamasyon	p ɾ o AF k l a AD m a AD s j AB o AF n
promdi	p r o AF m d i AD
prudente	p ɾ u AF d ɛ AD n t ɛ AD
pua	p u AF w AC a AD
pudpod	p u AF d p o AF d
pugad	p u AF ɡ a AD d
pugo	p u AF ɡ o AF ʔ
pugot	p u AF ɡ o AF t
pugutan	p u AF ɡ u AF t a AD n
puhunan	p u AF h AA u AF n a AD n
pukyutan	p u AF k j AB u AF t a AD n
pula	p ʊ AF l a AD
pulahan	p u AF l a AD h AA a AD n
pulgada	p u AF l ɡ a AD d a AD
pulgas	p u AF l ɡ a AD s
pulikat	p u AF l i AD k a AD t
pulmonya	p u AF l m o AF n j AB a AD
pulo	p u AF l o AF ʔ
pulot	p u AF l o AF t
pultaon	p u AF l t a AD ʔ ɔ AF n
pulubi	p u AF l u AF b i AD
pulutan	p u AF l u AF t a AD n
pumalakpak	p u AF m a AD l a AD k p a AD k
pumasok	p u AF m a AD s o AF k
pumatay	p u AF m a AD t a AD j AB
pumayag	p u AF m a AD j AB a AD ɡ
pumila	p u AF m i AD l a AD
pumisik	p u AF m i AD s i AD k
pumula	p u AF m u AF l a AD
pumunta	p u AF m u AF n t a AD
pumuti	p u AF m u AF t i AD ʔ
pumutok	p u AF m u AF t o AF k
pundido	p u AF n d i AD d o AF
puno	p u AF n o AF ʔ
punongbayan	p u AF n o AF ŋ b a AD j AB a AD n
punsalang	p u AF n s a AD l a AD ŋ
punta	p u AF n t a AD ʔ
puntahan	p u AF n t a AD h AA a AD n
puntirya	p u AF n t i AD ɾ j AB a AD
punzalan	p u AF n s a AD l a AD n
pusit	p u AF s i AD t
puson	p u AF s o AF n
pusta	p u AF s t a AD
pustiso	p u AF s t i AD s o AF
pusyaw	p ʊ AF s j AB a AD u AF
putakti	p u AF t a AD k t i AD
puti	p u AF t ɪ AD
putik	p u AF t i AD k
putol	p u AF t o AF l
putulin	p u AF t u AF l i AD n
puyod	p u AF j AB o AF d
que	k ɛ AD
quezon	k ɛ AD s o AF n
quiambao	k j AB a AD m b a AD u AF
quimpo	k i AD m p o AF
quintos	k i AD n t o AF s
quirante	k i AD ɾ a AD n t ɛ AD
quisumbing	k i AD s u AF m b i AD ŋ
quitain	k i AD t a AD i AD n
quiñones	k i AD ɲ o AF n ɛ AD s
racelis	ɾ a AD s ɛ AD l i AD s
ragas	ɾ a AD ɡ a AD s
ragudo	ɾ a AD ɡ u AF d o AF
rajah	r a AD h AA a AD
rali	ɾ a AD l i AD
raliyista	ɾ a AD l i AD j AB i AD s t a AD
rambol	ɾ a AD m b o AF l
rambulan	ɾ a AD m b u AF l a AD n
rantso	ɾ a AD n t ʃ o AF
rason	ɾ a AD s o AF n
rayos	ɾ a AD j AB o AF s
razon	ɾ a AD s o AF n
reaño	ɾ ɛ AD a AD ɲ o AF
rebelde	ɾ e AD b e AD l d e AD
rebelyon	r ɛ AD b ɛ AD l j AB o AF n
redondo	ɾ ɛ AD d o AF n d o AF
regala	ɾ ɛ AD ɡ a AD l a AD
regidor	ɾ ɛ AD h AA i AD d o AF ɾ
rehas	ɾ ɛ AD h AA a AD s
rehistro	ɾ ɛ AD h AA i AD s t ɾ o AF
rekisito	ɾ ɛ AD k i AD s i AD t o AF
rekisitos	ɾ ɛ AD k i AD s i AD t o AF s
relo	ɾ ɛ AD l o AF
remigio	ɾ ɛ AD m i AD h AA j AB o AF
remulla	ɾ ɛ AD m u AF l l a AD
reodica	ɾ ɛ AD o AF d i AD k a AD
reperendum	ɾ ɛ AD p ɛ AD ɾ ɛ AD n d u AF m
resistensya	ɾ ɛ AD s i AD s t ɛ AD n s j AB a AD
responsable	ɾ ɛ AD s p o AF n s a AD b l ɛ AD
resurreccion	ɾ ɛ AD s u AF ɾ ɛ AD k s j AB o AF n
ricafort	ɾ i AD k a AD p o AF ɾ t
ricarte	ɾ i AD k a AD ɾ t ɛ AD
riles	ɾ i AD l ɛ AD s
rin	ɾ i AD n
rivero	ɾ i AD b ɛ AD ɾ o AF
riñon	ɾ i AD ɲ o AF n
rombaoa	ɾ o AF m b a AD w AC a AD
romualdez	ɾ o AF m w AC a AD l d ɛ AD s
romualdo	ɾ o AF m w AC a AD l d o AF
rosete	ɾ o AF s ɛ AD t ɛ AD
roxas	ɾ o AF d ʒ a AD s
rulloda	ɾ u AF l l o AF d a AD
rumupok	ɾ u AF m u AF p o AF k
ruta	r u AF t a AD
sa	s a AD
saan	s a AD a AD n
sabado	s a AD b a AD d o AF
sabana	s a AD b a AD n a AD
sabangan	s a AD b a AD ŋ a AD n
sabi	s a AD b i AD
sabon	s a AD b o AF n
saboy	s a AD b o AF i AD
sabunin	s a AD b u AF n i AD n
sabunot	s a AD b u AF n o AF t
sabunutan	s a AD b u AF n u AF t a AD n
sacdalan	s a AD k d a AD l a AD n
sadya	s a AD d j AB a AD ʔ
sagay	s a AD ɡ a AD j AB
sagilap	s ɐ AF ɡ i AD l a AD p
sagimuymoy	s a AD ɡ i AD m u AF j AB m o AF j AB
saglit	s a AD ɡ l i AD t
saguinsin	s a AD ɡ i AD n s i AD n
sagun	s a AD ɡ u AF n
saha	s a AD h AA a AD ʔ
sahagun	s a AD h AA a AD ɡ u AF n
sahog	s a AD h AA o AF ɡ
sais	s a AD ʔ i AD s
saka	s a AD k a AD
sakal	s a AD k a AD l
sakit	s a AD k i AD t
sakitin	s a AD k i AD t i AD n
saksi	s a AD k s i AD
saksihan	s a AD k s i AD h AA a AD n
saktan	s a AD k t a AD n
sakuna	s a AD k u AF n a AD
sakupbayan	s a AD k u AF p b a AD j AB a AD n
sakwa	s a AD k w AC a AD
sala	s a AD l a AD
salagubang	s a AD l a AD ɡ u AF b a AD ŋ
salarin	s a AD l a AD ɾ i AD n
salaula	s a AD l a AD ʔ u AF l a AD ʔ
salawal	s a AD l a AD w AC a AD l
saldaña	s a AD l d a AD ɲ a AD
sales	s a AD l ɛ AD s
salipawpaw	s a AD l i AD p a AD u AF p a AD u AF
salitre	s a AD l i AD t ɾ ɛ AD
salog	s a AD l o AF ɡ
salonga	s a AD l o AF ŋ ɡ a AD
salot	s a AD l o AF t
salud	s a AD l u AF d
salumbides	s a AD l u AF m b i AD d ɛ AD s
salvacion	s a AD l b a AD s i AD o AF n
salvatierra	s a AD l b a AD t i AD ɛ AD ɾ ɾ a AD
samaniego	s a AD m a AD n j AB ɛ AD ɡ o AF
samantala	s a AD m a AD n t a AD l a AD ʔ
samantha	s a AD m a AD n t a AD
samat	s a AD m a AD t
sambasamba	s a AD m b a AD s a AD m b a AD
samid	s a AD m i AD d
samonte	s a AD m o AF n t ɛ AD
sampaloc	s a AD m p a AD l o AF k
sampalok	s a AD m p a AD l o AF k
sampo	s a AD m p ɔ AF ʔ
sampu	s a AD m p u AF ʔ
sandali	s a AD n d ɐ AF l i AD ʔ
sangalang	s a AD ŋ ɡ a AD l a AD ŋ
sangat	s a AD ŋ a AD t
sangco	s a AD ŋ k o AF
sanggol	s a AD ŋ ɡ o AF l
sangkot	s a AD ŋ k o AF t
santo	s a AD n t o AF
sapa	s a AD p a AD ʔ
sapak	s a AD p a AD k
sapok	s a AD p o AF k
sapot	s a AD p o AF t
saquing	s a AD k i AD ŋ
sara	s ɐ AF ɾ a AD
sarabia	s a AD r a AD b j AB a AD
sarhento	s a AD ɾ h AA ɛ AD n t o AF
sawa	s a AD w AC a AD ʔ
saway	s a AD w AC a AD i AD
sawayin	s a AD w AC a AD j AB i AD n
saya	s a AD j AB a AD
sayari	s a AD j AB a AD ɾ i AD ʔ
sayson	s a AD i AD s o AF n
see	s iː AE
segismundo	s ɛ AD ɡ i AD s m u AF n d o AF
segui	s ɛ AD ɡ i AD
sekreto	s ɛ AD k ɾ ɛ AD t o AF
selepono	s e AD l e AD p o AF n o AF
selula	s ɛ AD l ʊ AF l ɐ AF
semantika	s ɛ AD m a AD n t i AD k a AD
semaña	s ɛ AD m a AD ɲ a AD
semilla	s e AD m i AD l j AB a AD
sentenaryo	s ɛ AD n t ɛ AD n a AD ɾ j AB o AF
sentensiya	s ɛ AD n t ɛ AD n s j AB a AD
sentensiyahan	s ɛ AD n t ɛ AD n s j AB a AD h AA a AD n
sentido	s ɛ AD n t i AD d o AF
seremonya	s ɛ AD ɾ ɛ AD m o AF n j AB a AD
serna	s ɛ AD ɾ n a AD
shabu	s j AB a AD b u AF
shao	ʃ a AD ʊ AF
shau	ʃ a AD ʊ AF
shaw	ʃ a AD ʊ AF
sia	s j AB a AD
siao	ʃ a AD ʊ AF
siason	s j AB a AD s o AF n
sibayan	s i AD b a AD j AB a AD n
sibog	s i AD b o AF ɡ
sibug	s i AD b u AF ɡ
sibuyas	s i AD b u AF j AB a AD s
siga	s i AD ɡ a AD ʔ
sigarilyas	s i AD ɡ a AD ɾ i AD l j AB a AD s
sige	s i AD ɡ ɛ AD
siglo	s i AD ɡ l o AF
sigmuan	s i AD ɡ m u AF a AD n
siguraduhin	s i AD ɡ u AF ɾ a AD d u AF h AA i AD n
sihay	s i AD h AA a AD j AB
sihayan	s i AD h AA a AD j AB a AD n
sikatsikat	s i AD k a AD t s i AD k a AD t
sikhay	s i AD k h AA a AD j AB
siko	s i AD k o AF
siksin	s i AD k s i AD n
silang	s i AD l a AD ŋ
silangan	s i AD l a AD ŋ a AD n
silayan	s i AD l a AD j AB a AD n
silid	s ɪ AD l ɪ AD d
silidkaphay	s i AD l i AD d k a AD p h AA a AD j AB
silidkapnayan	s i AD l i AD d k a AD p n a AD j AB a AD n
silidkatwan	s i AD l i AD d k a AD t w AC a AD n
silidkilos	s i AD l i AD d k i AD l o AF s
silidkulay	s i AD l i AD d k u AF l a AD j AB
silidlawas	s i AD l i AD d l a AD w AC a AD s
silidmanahan	s i AD l i AD d m a AD n a AD h AA a AD n
silindro	s i AD l i AD n d ɾ o AF
simbulan	s i AD m b u AF l a AD n
simoy	s i AD m o AF j AB
simple	s i AD m p l ɛ AD
sinapupunan	s i AD n a AD p u AF p u AF n a AD n
sinat	s i AD n a AD t
sinauna	s i AD n a AD u AF n a AD
sinco	s i AD n k o AF
singil	s i AD ŋ i AD l
singkal	s i AD ŋ k a AD l
singkamasan	o AF r a AD s a AD n
sioson	s j AB o AF s o AF n
siping	s i AD p i AD ŋ
sipnayan	s ɪ AD p n a AD i AD ɐ AF n
sipon	s i AD p ʔ o AF n
sipsip	s i AD p s i AD p
sira	s i AD ɾ a AD ʔ
sirain	s i AD ɾ a AD ʔ i AD n
sisi	s i AD s i AD
sisid	s i AD s i AD d
sisihan	s i AD s i AD h AA a AD n
sitwasyon	s i AD t w AC a AD s j AB o AF n
siya	s i AD j AB a AD
siyam	ʃ j AB a AD m
siyamnapu	s i AD j AB a AD m n a AD p u AF ʔ
siyamnaraan	s i AD j AB a AD m n a AD r a AD a AD n
so	s ɔ AF
sobrepeña	s o AF b ɾ ɛ AD p ɛ AD ɲ a AD
soledad	s o AF l ɛ AD d a AD d
solis	s o AF l i AD s
son	s o AF n
songco	s o AF ŋ k o AF
sosa	s o AF s a AD
sosyal	s o AF ʃ a AD l
suan	s w AC a AD n
suazo	s w AC a AD s o AF
subok	s u AF b ɔ AF k
sucgang	s u AF k ɡ a AD ŋ
sugaan	s u AF ɡ a AD ʔ a AD n
sugal	s u AF ɡ a AD l
suglaguman	s u AF ɡ l a AD ɡ u AF m a AD n
sugnay	s u AF ɡ n a AD j AB
sugnayan	s u AF ɡ n a AD j AB a AD n
sugnayanin	s u AF ɡ n a AD j AB a AD n i AD n
sugnayanon	s u AF ɡ n a AD j AB a AD n o AF n
sugnayin	s u AF ɡ n a AD j AB i AD n
suhi	s u AF h AA i AD ʔ
suhol	s u AF h AA o AF l
suico	s u AF i AD k o AF
suka	s u AF k a AD ʔ
sukal	s u AF k a AD l
sulidlawas	s u AF l i AD d l a AD w AC a AD s
sulsol	s u AF l s o AF l
sultan	s u AF l t a AD n
sultana	s u AF l t a AD n a AD
sultanato	s u AF l t a AD n a AD t o AF
sumabog	s u AF m a AD b o AF ɡ
sumadsad	s u AF m a AD d s a AD d
sumagot	s u AF m a AD ɡ o AF t
sumakit	s u AF m a AD k i AD t
sumalapang	s u AF m a AD l a AD p a AD ŋ
sumalapaw	s u AF m a AD l a AD p a AD u AF
sumama	s u AF m a AD m a AD ʔ
sumeksi	s u AF m ɛ AD k s i AD
sumemplang	s u AF m ɛ AD m p l a AD ŋ
sumikat	s u AF m i AD k a AD t
sumikip	s u AF m i AD k i AD p
sumimangot	s u AF m i AD m a AD ŋ o AF t
suminga	s u AF m i AD ŋ a AD
sumuka	s u AF m u AF k a AD
sumulat	s u AF m u AF l a AD t
suntok	s u AF n t o AF k
suntukan	s u AF n t u AF k a AD n
suntukin	s u AF n t u AF k i AD n
suplete	s u AF p l ɛ AD t ɛ AD
supling	s u AF p l i AD ŋ
surot	s u AF ɾ o AF t
susmaryosep	s u AF s m a AD ɾ i AD ɔː AG s e AD p
sustento	s u AF s t ɛ AD n t o AF
suweldo	s w AC ɛ AD l d o AF
suya	s u AF j AB a AD ʔ
swerte	s w AC e AD r t e AD
sy	s iː AE
syaw	ʃ a AD ʊ AF
sze	t ʃ e AD
tabigi	t a AD b i AD ɡ i AD ʔ
tablaw	t a AD b l a AD w AC
tabon	t a AD b o AF n
taduran	t a AD d u AF ɾ a AD n
tae	t aː AE ʔ eː AE
tagalog	t ɐ AF ɡ aː AE l o AF ɡ
tagapagmana	t a AD ɡ a AD p a AD ɡ m a AD n a AD
tagas	t a AD ɡ a AD s
tagiktik	t a AD ɡ i AD k t i AD k
taglagas	t a AD ɡ l a AD ɡ a AD s
tagtuyot	t a AD ɡ t u AF j AB o AF t
taguba	t a AD ɡ u AF b a AD
tagubilin	t a AD ɡ u AF b i AD l i AD n
taguinod	t a AD ɡ i AD n o AF d
tagupa	t a AD ɡ u AF p a AD
tahasik	t a AD h AA a AD s i AD k
taib	t a AD ʔ i AD b
taihan	t a AD i AD h AA a AD n
takahashi	t a AD k a AD h AA a AD s j AB i AD
takbo	t a AD k b ɔ AF
takilya	t a AD k i AD l j AB a AD
talag	t a AD l a AD ɡ
talampas	t a AD l a AD m p a AD s
talavera	t a AD l a AD b ɛ AD ɾ a AD
talento	t a AD l ɛ AD n t o AF
talo	t a AD l o AF
talon	t a AD l o AF n
talong	t a AD l o AF ŋ
talukbong	t a AD l u AF k b o AF ŋ
talulot	t a AD l u AF l o AF t
talunan	t a AD l u AF n a AD n
tam	t a AD m
tambakol	t a AD m b a AD k o AF l
tamban	t a AD m b a AD n
tambayan	t a AD m b a AD j AB a AD n
tamis	t a AD m i AD s
tampal	t a AD m p a AD l
tan	t a AD n
tanauan	t a AD n ʔ a AD w AC a AD n
tancinco	t a AD n s i AD n k o AF
tang	t a AD ŋ
tanga	t a AD ŋ a AD
tangco	t a AD ŋ k o AF
tanggal	t a AD ŋ ɡ a AD l
tanghalian	t a AD ŋ h AA a AD l i AD ʔ a AD n
tanghas	t a AD ŋ h AA a AD s
tanikala	t a AD n i AD k a AD l a AD ʔ
tanso	t a AD n s o AF ʔ
tantiya	t a AD n t ʃ a AD
tao	t a AD ʔ o AF
taog	t a AD ʔ o AF ɡ
taon	t a AD ʔ o AF n
tapales	t a AD p a AD l ɛ AD s
tapat	t a AD p a AD t
tapay	t a AD p a AD j AB
tapilok	t a AD p i AD l o AF k
tapos	t a AD p o AF s
tapunan	t a AD p u AF n a AD n
tapusin	t a AD p u AF s i AD n
tarik	t a AD ɾ i AD k
taruc	t a AD ɾ u AF k
tasa	t a AD s a AD
tataw	t a AD t a AD w AC
tatlo	t a AD t l ɔ AF
tatlonghari	t a AD t l o AF ŋ h AA a AD ɾ i AD
tatlumpu	t a AD t l u AF m p u AF ʔ
tatlundaan	t a AD t l u AF n d a AD a AD n
tato	t a AD t o AF ʔ
tatsulok	t ɐ AF t s u AF l ɔ AF k
tawag	t a AD w AC a AD ɡ
tayahan	t a AD j AB a AD h AA a AD n
tayo	t aː AE j AB ɔ AF
tañada	t a AD ɲ a AD d a AD
tecson	t ɛ AD k s o AF n
tee	t iː AE
teklado	t e AD k l a AD d o AF
telepono	t ɛ AD l ɛ AD p o AF n o AF
tenga	t ɛː AE ŋ a AD
tenorio	t ɛ AD n o AF ɾ j AB o AF
tenyente	t ɛ AD n j AB ɛ AD n t ɛ AD
teoriya	t ɛ AD o AF ɾ i AD a AD
teritoryo	t ɛ AD ɾ i AD t o AF ɾ j AB o AF
tiamson	t j AB a AD m s o AF n
tian	t j AB a AD n
tiangco	t j AB a AD ŋ k o AF
tibay	t i AD b a AD i AD
tibo	t ɪ AD b ɔ AF ʔ
tiburcio	t i AD b u AF ɾ s j AB o AF
ticzon	t i AD k s o AF n
tien	t j AB e AD n
tigang	t i AD ɡ a AD ŋ
tigas	t i AD ɡ a AD s
tigilan	t i AD ɡ i AD l a AD n
tiis	t i AD ʔ i AD s
tikbalang	t i AD k b a AD l a AD ŋ
tikling	t i AD k l i AD ŋ
tiklop	t i AD k l o AF p
tiktik	t i AD k t i AD k
timbang	t i AD m b a AD ŋ
timog	t i AD m o AF ɡ
tin	t ɪ AD n
tindero	t i AD n d ɛ AD ɾ o AF
tindig	t i AD n d i AD ɡ
ting	t ɪ AD ŋ
tinga	t i AD ŋ a AD
tingala	t i AD ŋ a AD l a AD ʔ
tingalaan	t i AD ŋ a AD l a AD a AD n
tingid	t i AD ŋ i AD d
tingin	t i AD ŋ i AD n
tinidor	t i AD n i AD d o AF ɾ
tinig	t i AD n i AD ɡ
tinik	t i AD n i AD k
tinikling	t i AD n i AD k l i AD ŋ
tinta	t i AD n t a AD
tio	t j AB o AF
tiongco	t i AD o AF ŋ k o AF
tiozon	t j AB o AF s o AF n
tipaklong	t i AD p a AD k l o AF ŋ
tipon	t i AD p o AF n
tira	t i AD ɾ a AD
tiraniya	t i AD ɾ a AD n i AD a AD
tirik	t i AD ɾ i AD k
tiris	t i AD ɾ i AD s
tirona	t i AD ɾ o AF n a AD
tisod	t i AD s o AF d
tita	t i AD t a AD
tito	t i AD t o AF ʔ
tiu	t j AB uː AG
tiwala	t i AD w AC a AD l a AD ʔ
tiwali	t i AD w AC a AD l i AD ʔ
tiya	t i AD a AD
tiyaga	t i AD a AD ɡ a AD ʔ
tiyahin	t ʃ a AD h AA i AD n
tiyan	t i AD a AD n
tiyanak	t i AD a AD n a AD k
tiyangge	t i AD a AD ŋ ɡ ɛ AD ʔ
tiyo	t i AD o AF
tiyubibo	t i AD j AB u AF b i AD b ɔ AF
tiyuhin	t ʃ u AF h AA i AD n
to	t o AF
tonelada	t o AF n ɛ AD l a AD d a AD
tong	t o AF ŋ
topacio	t o AF p a AD s j AB o AF
tore	t o AF ɾ ɛ AD
torotot	t o AF ɾ o AF t o AF t
torrecampo	t o AF ɾ ɾ ɛ AD k a AD m p o AF
totanes	t o AF t a AD n ɛ AD s
trabaho	t r a AD b a AD h AA o AF
trangkaso	t ɾ a AD ŋ k a AD s o AF
trapik	t ɾ a AD p i AD k
traqueña	t ɾ a AD k ɛ AD ɲ a AD
tratado	t ɾ a AD t a AD d o AF
trato	t ɾ a AD t o AF
traydor	t ɾ a AD i AD d o AF ɾ
tria	t ɾ i AD a AD
triguhan	t r ɪ AD ɡ ʊ AF h AA a AD n
trillanes	t ɾ i AD l l a AD n ɛ AD s
trip	t ɾ i AD p
tropatuts	t r o AF p a AD t u AF t s
tsaka	t ʃ a AD k a AD
tsikinini	t ʃ i AD k i AD n i AD n i AD ʔ
tsiklet	t ʃ i AD k l ɛ AD t
tsikot	t ʃ i AD k o AF t
tsina	t s i AD n a AD
tsinelas	t ʃ i AD n ɛ AD l a AD s
tsinoy	t s ɪ AD n ɔ AF ɪ AD
tsong	t ʃ o AF ŋ
tsonggo	t ʃ o AF ŋ ɡ o AF
tsugi	t ʃ u AF ɡ i AD
tsuper	t ʃ u AF p e AD ɾ
tuason	t w AC a AD s o AF n
tuba	t u AF b a AD
tubero	t u AF b ɛ AD ɾ o AF
tubig	t u AF b i AD ɡ
tubo	t u AF b o AF ʔ
tubuhan	t u AF b u AF h AA a AD n
tugade	t u AF ɡ a AD d ɛ AD
tugtog	t u AF ɡ t o AF ɡ
tugtugin	t u AF ɡ t u AF ɡ i AD n
tuhod	t u AF h AA o AF d
tuklaw	t u AF k l a AD u AF
tukod	t u AF k o AF d
tukso	t u AF k s o AF
tulad	t u AF l a AD d
tulak	t u AF l a AD k
tulatod	t u AF l a AD t o AF d
tulay	t u AF l a AD i AD
tulingan	t u AF l i AD ŋ a AD n
tullao	t u AF l j AB a AD u AF
tulo	t u AF l o AF ʔ
tulog	t u AF l o AF ɡ
tulong	t u AF l o AF ŋ
tuloy	t u AF l o AF i AD
tumaba	t u AF m a AD b a AD ʔ
tumacder	t u AF m a AD k d ɛ AD ɾ
tumae	t u AF m a AD ʔ ɛ AD
tumahimik	t u AF m a AD h AA i AD m i AD k
tumakbo	t u AF m a AD k b ɔ AF
tumalima	t u AF m a AD l i AD m a AD
tumalon	t u AF m a AD l o AF n
tumanggi	t u AF m a AD ŋ ɡ i AD
tumapon	t u AF m a AD p o AF n
tumawa	t u AF m a AD w AC a AD
tumayo	t u AF m a AD j AB o AF ʔ
tumbaga	t u AF m b a AD ɡ a AD
tumbalik	t u AF m b a AD l i AD k
tumbok	t u AF m b o AF k
tumbong	t u AF m b o AF ŋ
tumimos	t u AF m i AD m o AF s
tumingala	t u AF m i AD ŋ a AD l a AD ʔ
tumira	t u AF m i AD ɾ a AD
tumirik	t u AF m i AD r i AD k
tumpang	t u AF m p a AD ŋ
tumpok	t u AF m p o AF k
tumugtog	t u AF m u AF ɡ t o AF ɡ
tumukso	t u AF m u AF k s o AF
tumula	t u AF m u AF l a AD ʔ
tumulong	t u AF m u AF l o AF ŋ
tunaw	t u AF n a AD w AC
tunay	t u AF n a AD i AD
tung	t u AF ŋ
tungaw	t u AF ŋ a AD u AF
tungkab	t u AF ŋ k a AD b
tungkod	t u AF ŋ k o AF d
tungkol	t u AF ŋ k o AF l
tungkos	t u AF ŋ k o AF s
tunog	t u AF n o AF ɡ
tunton	t u AF n t o AF n
tunugan	t u AF n u AF ɡ a AD n
tupad	t u AF p a AD d
tupi	t u AF p i AD ʔ
turnilyo	t u AF ɾ n i AD l j AB o AF
turok	t u AF ɾ o AF k
tuso	t u AF s o AF
tutol	t u AF t o AF l
tutubi	t u AF t u AF b i AD
tuwa	t u AF w AC a AD ʔ
tuwad	t u AF a AD d
tuwalya	t u AF a AD l j AB a AD
tuwang	t u AF a AD ŋ
ty	t iː AE
uang	u AF ʔ a AD ŋ
ubad	ʔ u AF b a AD d
ubalde	u AF b a AD l d e AD
ubas	ʔ u AF b a AD s
ubasan	ʔ u AF b a AD s a AD n
ubo	ʔ u AF b o AF ʔ
udyukan	ʔ u AF d j AB u AF k a AD n
ugat	ʔ u AF ɡ a AD t
uhaw	ʔ u AF h AA a AD w AC
ulam	ʔ u AF l a AD m
ulep	ʔ u AF l ɛ AD p
ulila	ʔ u AF l i AD l a AD
uling	ʔ u AF l i AD ŋ
ulo	u AF l o AF
umabay	ʔ u AF m a AD b a AD j AB
umagahas	ʔ u AF m a AD ɡ a AD h AA a AD s
umakyat	ʔ u AF m a AD k j AB a AD t
umalis	ʔ u AF m a AD l i AD s
umang	ʔ u AF m a AD ŋ
umanta	ʔ u AF m a AD n t a AD
umaraw	u AF m a AD r a AD w AC
umasa	ʔ u AF m a AD s a AD
umasinta	ʔ u AF m a AD s i AD n t a AD
umawat	ʔ u AF m a AD w AC a AD t
umawit	ʔ u AF m a AD w AC i AD t
umibig	ʔ u AF m i AD b i AD ɡ
umihi	ʔ u AF m i AD h AA i AD ʔ
uminom	ʔ u AF m i AD n o AF m
umiwas	ʔ u AF m i AD w AC a AD s
umiyak	ʔ u AF m i AD j AB a AD k
umpisa	ʔ u AF m p i AD s a AD
umuha	ʔ u AF m u AF h AA a AD ʔ
umunlad	ʔ u AF m u AF n l a AD d
umupo	ʔ u AF m u AF p o AF ʔ
umutot	ʔ u AF m u AF t o AF t
umuwi	ʔ u AF m u AF w AC i AD ʔ
unan	u AF n a AD n
untalan	ʔ u AF n t a AD l a AD n
upa	ʔ u AF p a AD
upaw	ʔ u AF p a AD w AC
uriarte	ʔ u AF ɾ j AB a AD ɾ t ɛ AD
ursua	ʔ u AF ɾ s u AF a AD
usap	ʔ u AF s a AD p
usapan	u AF s a AD p a AD n
usisero	ʔ u AF s i AD s ɛ AD ɾ o AF
usog	u AF s o AF ɡ
utak	ʔ u AF t a AD k
utang	u AF t a AD ŋ
utong	ʔ u AF t o AF ŋ
utot	ʔ u AF t o AF t
uwak	ʔ u AF a AD k
uwang	u AF w AC a AD ŋ
uwi	ʔ u AF w AC i AD ʔ
uwian	u AF w AC i AD a AD n
uy	u AF i AD
uyaw	ʔ u AF j AB a AD w AC
valera	b a AD l ɛ AD ɾ a AD
valle	b a AD l l ɛ AD
valmores	b a AD l m o AF ɾ ɛ AD s
vangie	b a AD n d ʒ i AD
varias	b a AD ɾ i AD a AD s
varona	b a AD ɾ o AF n a AD
vecino	b ɛ AD s i AD n o AF
velarde	b ɛ AD l a AD ɾ d ɛ AD
velasquez	b ɛ AD l a AD s k ɛ AD s
velez	b ɛ AD l ɛ AD s
veloria	b ɛ AD l o AF ɾ j AB a AD
veneracion	b ɛ AD n ɛ AD ɾ a AD s j AB o AF n
venturina	b ɛ AD n t u AF ɾ i AD n a AD
versoza	b ɛ AD ɾ s o AF s a AD
viernes	b j AB ɛ AD ɾ n ɛ AD s
vigilante	b i AD d ʒ i AD l a AD n t e AD
villablanca	b i AD l l a AD b l a AD n k a AD
villacarlos	b i AD l l a AD k a AD ɾ l o AF s
villafranca	b i AD l l a AD p ɾ a AD n k a AD
villafuerte	b i AD l l a AD p w AC ɛ AD ɾ t ɛ AD
villagracia	b i AD l l a AD ɡ ɾ a AD s j AB a AD
villamater	b i AD l l a AD m a AD t ɛ AD ɾ
villamin	b i AD l l a AD m i AD n
villamor	b i AD l l a AD m o AF ɾ
villapando	b i AD l l a AD p a AD n d o AF
villareal	b i AD l l a AD ɾ ɛ AD a AD l
villarino	b i AD l l a AD ɾ i AD n o AF
villaruz	b i AD l l a AD ɾ u AF s
villaseñor	b i AD l l a AD s ɛ AD ɲ o AF ɾ
villasis	b i AD l l a AD s i AD s
villaverde	b i AD l l a AD b ɛ AD ɾ d ɛ AD
villavicencio	b i AD l l a AD b i AD s ɛ AD n s j AB o AF
villegas	b i AD l l ɛ AD ɡ a AD s
vinoya	b i AD n o AF j AB a AD
virata	b i AD ɾ a AD t a AD
virrey	b i AD ɾ ɾ ɛ AD i AD
visaya	b i AD s a AD j AB a AD ʔ
volante	b o AF l a AD n t ɛ AD
waag	w AC a AD ʔ a AD ɡ
waagan	w AC a AD ʔ a AD ɡ a AD n
waak	w AC a AD ʔ a AD k
waang	w AC a AD ʔ a AD ŋ
wadwad	w AC a AD d w AC a AD d
wagayway	w AC a AD ɡ a AD j AB w AC a AD j AB
wagaywayan	w AC a AD ɡ a AD j AB w AC a AD j AB a AD n
wagi	w AC a AD ɡ i AD
wagiswis	w AC a AD ɡ i AD s w AC i AD s
wagwag	w AC a AD ɡ w AC a AD ɡ
wakaak	w AC a AD k a AD ʔ a AD k
wakas	w AC a AD k a AD s
waklas	w AC a AD k l a AD s
wakwak	w AC a AD k w AC a AD k
wakya	w AC a AD k j AB a AD ʔ
wala	w AC a AD l a AD ʔ
walawad	w AC a AD l a AD w AC a AD d
waldas	w AC a AD l d a AD s
waley	w AC a AD l e AD ɪ AD
walidwid	w AC a AD l i AD d w AC i AD d
waling	w AC a AD l i AD ŋ
walingwaling	w AC a AD l i AD ŋ w AC a AD l i AD ŋ
waliswis	w AC a AD l i AD s w AC i AD s
waliwali	w AC a AD l i AD w AC a AD l i AD
walna	w AC a AD l n a AD ʔ
walo	w AC a AD l o AF
walumpu	w AC a AD l u AF m p u AF ʔ
walundaan	w AC a AD l u AF n d a AD ʔ a AD n
walunlibo	w AC a AD l u AF n l i AD b o AF
walwal	w AC a AD l w AC a AD l
wang	w AC a AD ŋ
wangis	w AC a AD ŋ i AD s
wani	w AC a AD n i AD ʔ
waray	w AC a AD ɾ a AD j AB
wardi	w AC a AD ɾ d i AD
wasak	w AC a AD s a AD k
watawat	w AC a AD t a AD w AC a AD t
wating	w AC a AD t i AD ŋ
wawa	w AC a AD w AC a AD ʔ
webera	w AC e AD b e AD ɾ a AD
wee	w AC i AD
welga	w AC e AD l ɡ a AD
werpa	w AC e AD r p a AD
wigwig	w AC i AD ɡ w AC i AD ɡ
wika	w AC i AD k a AD ʔ
wiklas	w AC i AD k l a AD s
wilik	w AC i AD l i AD k
wiliwid	w AC i AD l i AD w AC i AD d
windang	w AC i AD n d a AD ŋ
wingkag	w AC i AD ŋ k a AD ɡ
wisik	w AC i AD s i AD k
wisit	w AC i AD s i AD t
wiski	w AC i AD s k i AD
wiswis	w AC i AD s w AC i AD s
witwit	w AC i AD t w AC i AD t
wong	w AC o AF ŋ
wu	w AC uː AG
yaang	j AB a AD ʔ a AD ŋ
yagban	j AB a AD ɡ b a AD n
yagit	j AB a AD ɡ i AD t
yakap	j AB a AD k a AD p
yalung	j AB a AD l u AF ŋ
yaman	j AB a AD m a AD n
yamutmot	j AB a AD m u AF t m o AF t
yan	j AB a AD n
yang	j AB a AD ŋ
yangasngas	j AB a AD ŋ a AD s ŋ a AD s
yangit	j AB a AD ŋ i AD t
yangot	j AB a AD ŋ o AF t
yanig	j AB a AD n i AD ɡ
yano	j AB a AD n o AF
yantas	j AB a AD n t a AD s
yantok	j AB a AD n t o AF k
yao	j AB a AD w AC
yaon	j AB a AD o AF n
yap	j AB a AD p
yarda	j AB a AD ɾ d a AD
yasay	j AB a AD s a AD i AD
yata	j AB a AD t a AD ʔ
yatab	j AB a AD t a AD b
yatco	j AB a AD t k o AF
yate	j AB a AD t e AD
yatyat	j AB a AD t j AB a AD t
ybañez	ʔ i AD b a AD ɲ ɛ AD s
yee	j AB i AD
yelo	j AB e AD l o AF
yepes	j AB ɛ AD p ɛ AD s
yongco	j AB ɔ AF ŋ k o AF
young	j AB ɐ AF ŋ
yukyok	j AB u AF k j AB o AF k
yumabang	j AB u AF m a AD b a AD ŋ
yumabong	j AB u AF m a AD b o AF ŋ
yumahod	j AB u AF m a AD h AA o AF d
yumakap	j AB u AF m a AD k a AD p
yumaman	j AB u AF m a AD m a AD n
yumamot	j AB u AF m a AD m o AF t
yumanig	j AB u AF m a AD n i AD ɡ
yumari	j AB u AF m a AD ɾ i AD ʔ
yumasak	j AB u AF m a AD s a AD k
yumukdo	j AB u AF m u AF k d o AF
yumuko	j AB u AF m u AF k o AF ʔ
yumurak	j AB u AF m u AF ɾ a AD k
yung	j AB ʊ AF ŋ
yungib	j AB u AF ŋ i AD b
yuvienco	j AB u AF b i AD ɛ AD n k o AF
yñiguez	j AB ɲ i AD ɡ ɛ AD s
zafra	s a AD p ɾ a AD
zaide	s a AD i AD d ɛ AD
zapanta	s a AD p a AD n t a AD
zavalla	s a AD b a AD l l a AD
zhang	t ʃ o AF ŋ
zoleta	s o AF l ɛ AD t a AD
zubiri	a AD b a AD d j AB a AD n o AF
zuñiga	s u AF ɲ i AD ɡ a AD
