't	t AC
'y	i AK
aa	ʔ AJ a AK a AK ʔ AJ
aam	ʔ AJ a AK a AK m AE
aba	ʔ AJ a AK b AG a AK ʔ AJ
abadiano	a AK b AG a AK d AC d AC ʒ AH a AK n AF o AM
abaka	a AK b AG a AK k AC a AK
abako	a AK b AG a AK k AC o AM
abakus	a AK b AG a AK k AC u AM s AH
abala	ɐ AM b AG ɐ AM l AD a AK
abalos	ʔ AJ a AK b AG a AK l AD o AM s AH
abandonado	ʔ AJ a AK b AG a AK n AF d AC o AM n AF a AK d AC o AM
abangan	ʔ AJ a AK b AG a AK ŋ AF a AK n AF
abaniko	ʔ AJ a AK b AG a AK n AF i AK k AC o AM
abay	ʔ AJ a AK b AG a AK j AB
abayan	ʔ AJ a AK b AG a AK j AB a AK n AF
abejuela	ʔ AJ a AK b AG ɛ AK d AC ʒ AH u AM ɛ AK l AD a AK
abelgas	ʔ AJ a AK b AG ɛ AK l AD ɡ AC a AK s AH
abellera	ʔ AJ a AK b AG ɛ AK l AD l AD ɛ AK ɾ BD a AK
abenida	a AK b AG ɛ AK n AF iː AL d AC a AK
aberya	ɑ AK b AG ɛ AK r BA j AB ɑ AK
abing	ʔ AJ a AK b AG i AK ŋ AF
abiso	a AK b AG i AK s AH ɔ AM
abisuhan	ʔ AJ a AK b AG i AK s AH u AM h AA a AK n AF
abitsuwelas	a AK b AG i AK t AC s AH u AM ɛ AK l AD a AK s AH
abnoy	a AK b AG n AF ɔ AM j AB
abo	ʔ AJ a AK b AG o AM
abogasya	ɑ AK b AG ɔ AM ɡ AC ɑ AK ɕ AH ɑ AK
aborsyonista	ɑ AK b AG ɔ AM r BA ɕ AH ɔ AM n AF i AK s AH t AC ɑ AK
abot	ʔ AJ a AK b AG ɔ AM t AC
abrasyete	ɑ AK b AG r BA ɑ AK ɕ AH ɛ AK t AC ɛ AK
abrazado	ʔ AJ a AK b AG ɾ BD a AK s AH a AK d AC o AM
abrenica	ʔ AJ a AK b AG ɾ BD ɛ AK n AF i AK k AC a AK
abril	a AK b AG ɾ BD i AK l AD
abueg	ʔ AJ a AK b AG w AI ɛ AK ɡ AC
abulencia	ʔ AJ a AK b AG u AM l AD ɛ AK n AF s AH j AB a AK
abusado	ʔ AJ a AK b AG u AM s AH a AK d AC o AM
abusuhin	ʔ AJ a AK b AG u AM s AH u AM h AA i AK n AF
abutin	ʔ AJ a AK b AG u AM t AC i AK n AF
abyad	ʔ AJ a AK b AG j AB a AK d AC
abyador	ʔ AJ a AK b AG j AB a AK d AC o AM ɾ BD
abyasyon	ɑ AK b AG j AB ɑ AK ɕ AH ɔ AM n AF
acierto	ʔ AJ a AK s AH j AB ɛ AK ɾ BD t AC o AM
acorda	ʔ AJ a AK k AC o AM ɾ BD d AC a AK
acuzar	ʔ AJ a AK k AC u AM s AH a AK ɾ BD
adajar	ʔ AJ a AK d AC a AK d AC ʒ AH a AK ɾ BD
adelpa	a AK d AC e AK l AD p AG a AK
adidas	a AK d AC i AK d AC a AK s AH
adik	ʔ AJ a AK d AC i AK k AC
adiksyon	ɑ AK d AC i AK k̚ ɕ AH ɔ AM n AF
adisyunal	ɑ AK d AC i AK ɕ AH u AM n AF ɑ AK l AD
adlawan	ʔ AJ a AK d AC l AD a AK w AI a AK n AF
administrasyon	ɑ AK d AC m AE i AK n AF i AK s AH t AC r BA ɑ AK ɕ AH ɔ AM n AF
adopsyon	ɑ AK d AC ɔ AM p̚ ɕ AH ɔ AM n AF
adres	ʔ AJ a AK d AC ɾ BD ɛ AK s AH
adrias	ʔ AJ a AK d AC ɾ BD i AK a AK s AH
adyenda	ɑ AK dʲ AC ɛ AK n AF d AC ɑ AK
afam	a AK f BB a AK m AE
agamahan	ʔ AJ a AK ɡ AC a AK m AE a AK h AA a AK n AF
agapay	ʔ AJ a AK ɡ AC a AK p AG a AK i AK
agaran	ʔ AJ a AK ɡ AC a AK ɾ BD a AK n AF
agbarog	ʔ AJ a AK ɡ AC b AG a AK ɾ BD o AM ɡ AC
agbarugan	ʔ AJ a AK ɡ AC b AG a AK ɾ BD u AM ɡ AC a AK n AF
aghamwika	a AK ɡ AC h AA a AK m AE w AI i AK k AC a AK ʔ AJ
aghimo	ʔ AJ a AK ɡ AC h AA i AK m AE o AM ʔ AJ
aghimuan	ʔ AJ a AK ɡ AC h AA i AK m AE u AM ʔ AJ a AK n AF
aghimuin	ʔ AJ a AK ɡ AC h AA i AK m AE u AM ʔ AJ i AK n AF
agila	ʔ AJ a AK ɡ AC i AK l AD a AK
agimat	ʔ AJ a AK ɡ AC i AK m AE a AK t AC
agimatan	ʔ AJ a AK ɡ AC i AK m AE a AK t AC a AK n AF
agiw	ʔ AJ a AK ɡ AC i AK u AM
agosto	a AK ɡ AC o AM s AH t AC o AM
agrabyado	ʔ AJ a AK ɡ AC ɾ BD a AK b AG j AB a AK d AC o AM
agsikap	ʔ AJ a AK ɡ AC s AH i AK k AC a AK p AG
agsikapan	ʔ AJ a AK ɡ AC s AH i AK k AC a AK p AG a AK n AF
aguas	ʔ AJ a AK ɡ AC u AM a AK s AH
aguda	ʔ AJ a AK ɡ AC u AM d AC a AK
aguilera	ʔ AJ a AK ɡ AC i AK l AD ɛ AK ɾ BD a AK
aguirre	ʔ AJ a AK ɡ AC i AK ɾ BD ɛ AK
agustin	ʔ AJ a AK ɡ AC u AM s AH t AC i AK n AF
agwa	a AK ɡ AC w AI ɐ AM
agwat	ʔ AJ a AK ɡ AC w AI a AK t AC
ahensya	ɑ AK ɦ AA ɛ AK n AF ɕ AH ɑ AK
aklat	ɐ AM k AC l AD a AK t AC
aklatan	ɐ AM k AC l AD aː AL t AC ɐ AM n AF
aksayado	ʔ AJ a AK k AC s AH a AK j AB a AK d AC o AM
alam	ɐ AM l AD a AK m AE
alambre	ʔ AJ a AK l AD a AK m AE b AG ɾ BD ɛ AK
alamin	ʔ AJ a AK l AD a AK m AE i AK n AF
alcaide	ʔ AJ a AK l AD k AC a AK i AK d AC ɛ AK
aldover	ʔ AJ a AK l AD d AC o AM b AG ɛ AK ɾ BD
alegre	ʔ AJ a AK l AD ɛ AK ɡ AC ɾ BD ɛ AK
alfaro	a AK l AD f BB a AK ɾ BD o AM
alila	ʔ AJ a AK l AD i AK l AD a AK ʔ AJ
alimasag	ʔ AJ a AK l AD i AK m AE a AK s AH a AK ɡ AC
alimuom	a AK l AD i AK m AE u AM o AM m AE
alipin	ʔ AJ a AK l AD i AK p AG i AK n AF
alis	ʔ AJ a AK l AD i AK s AH
almaden	ʔ AJ a AK l AD m AE a AK d AC ɛ AK n AF
almarez	ʔ AJ a AK l AD m AE a AK ɾ BD ɛ AK s AH
almario	ʔ AJ a AK l AD m AE a AK ɾ BD i AK o AM
almendrala	ʔ AJ a AK l AD m AE ɛ AK n AF d AC ɾ BD a AK l AD a AK
almirol	ʔ AJ a AK l AD m AE i AK ɾ BD o AM l AD
almohadilya	a AK l AD m AE o AM h AA a AK d AC i AK l AD j AB a AK ʔ AJ
alonte	ʔ AJ a AK l AD o AM n AF t AC ɛ AK
alonto	ʔ AJ a AK l AD o AM n AF t AC o AM
alperes	ʔ AJ a AK l AD p AG ɛ AK ɾ BD ɛ AK s AH
altapresyon	ʔ AJ a AK l AD t AC a AK p AG ɾ BD ɛ AK s AH j AB o AM n AF
alulod	ɐ AM l AD u AM l AD ɔ AM d AC
alusitha	ʔ AJ a AK l AD u AM s AH i AK t AC h AA a AK ʔ AJ
alviar	ʔ AJ a AK l AD b AG j AB a AK ɾ BD
alzaga	a AK l AD s AH a AK ɡ AC a AK
amante	ʔ AJ a AK m AE a AK n AF t AC ɛ AK
ambag	ʔ AJ a AK m AE b AG a AK ɡ AC
amerikana	ʔ AJ a AK m AE ɛ AK ɾ BD i AK k AC a AK n AF a AK
amin	ʔ AJ a AK m AE i AK n AF
aminado	ʔ AJ a AK m AE i AK n AF a AK d AC o AM
aming	a AK m AE i AK ŋ AF
aminin	a AK m AE i AK n AF i AK n AF
amo	ʔ AJ a AK m AE o AM
amon	ʔ AJ a AK m AE o AM n AF
amoranto	ʔ AJ a AK m AE o AM ɾ BD a AK n AF t AC o AM
ampaw	ʔ AJ a AK m AE p AG a AK u AM
amurao	ʔ AJ a AK m AE u AM ɾ BD a AK u AM
analisis	ʔ AJ a AK n AF a AK l AD i AK s AH i AK s AH
anatomiya	ʔ AJ a AK n AF a AK t AC o AM m AE i AK a AK
anay	ʔ AJ a AK n AF a AK i AK
anayin	ʔ AJ a AK n AF a AK j AB i AK n AF
anda	a AK n AF d AC a AK
andal	ʔ AJ a AK n AF d AC a AK l AD
andaya	a AK n AF d AC a AK y AM a AK
ang	a AK ŋ AF
anga	ʔ AJ a AK ŋ AF a AK
angaw	a AK ŋ AF a AK w AI
anggo	ʔ AJ a AK ŋ AF ɡ AC o AM
anghel	ʔ AJ a AK ŋ AF h AA ɛ AK l AD
angis	ʔ AJ a AK ŋ AF i AK s AH
angkla	ʔ AJ a AK ŋ AF k AC l AD a AK
ango	ʔ AJ a AK ŋ AF o AM
angot	ʔ AJ a AK ŋ AF o AM t AC
anim	ʔ AJ a AK n AF i AK m AE
animnapu	a AK n AF i AK m AE n AF a AK p AG u AM ʔ AJ
anis	ʔ AJ a AK n AF i AK s AH
ano	a AK n AF o AM
anos	ʔ AJ a AK n AF o AM s AH
anta	ʔ AJ a AK n AF t AC a AK
antas	ʔ AJ a AK n AF t AC a AK s AH
antipona	ʔ AJ a AK n AF t AC i AK p AG o AM n AF a AK
antok	ʔ AJ a AK n AF t AC o AM k AC
antukin	ʔ AJ a AK n AF t AC u AM k AC i AK n AF
anunsyo	ɑ AK n AF u AM n AF ɕ AH ɔ AM
anyayahan	ʔ AJ a AK n AF j AB a AK j AB a AK h AA a AK n AF
apahap	ʔ AJ a AK p AG a AK h AA a AK p AG
apalit	ʔ AJ a AK p AG a AK l AD i AK t AC
apat	a AK p AG a AK t AC
apatnapu	a AK p AG a AK t AC n AF a AK p AG u AM ʔ AJ
apatnaraan	a AK p AG a AK t AC n AF a AK r BA a AK a AK n AF
apela	ʔ AJ a AK p AG ɛ AK l AD a AK
apilado	ʔ AJ a AK p AG i AK l AD a AK d AC o AM
apostasiya	ʔ AJ a AK p AG o AM s AH t AC a AK s AH i AK a AK
aral	a AK ɾ BD ɐ AM l AD
aranda	ʔ AJ a AK ɾ BD a AK n AF d AC a AK
araw	ɐ AM ɾ BD a AK w AI
aray	ʔ AJ a AK ɾ BD a AK i AK
arañas	ʔ AJ a AK ɾ BD a AK ɲ AF a AK s AH
arce	ʔ AJ a AK ɾ BD s AH ɛ AK
arcega	ʔ AJ a AK ɾ BD s AH ɛ AK ɡ AC a AK
arceo	ʔ AJ a AK ɾ BD s AH ɛ AK o AM
arcilla	ʔ AJ a AK ɾ BD s AH i AK l AD l AD a AK
arcillas	ʔ AJ a AK ɾ BD s AH i AK l AD l AD a AK s AH
arcinas	ʔ AJ a AK ɾ BD s AH i AK n AF a AK s AH
arenas	ʔ AJ a AK ɾ BD ɛ AK n AF a AK s AH
arevalo	ʔ AJ a AK ɾ BD ɛ AK b AG a AK l AD o AM
argente	ʔ AJ a AK ɾ BD ɡ AC ɛ AK n AF t AC ɛ AK
arguelles	a AK ɾ BD ɡ AC w AI e AK l AD j AB e AK s AH
arkila	ʔ AJ a AK ɾ BD k AC i AK l AD a AK
arlene	a AK r BA l AD i AK n AF
arnibal	a AK r BA n AF i AK b AG a AK l AD
arquiza	ʔ AJ a AK ɾ BD k AC i AK s AH a AK
arriola	ʔ AJ a AK ɾ BD i AK o AM l AD a AK
arrogante	ʔ AJ a AK ɾ BD o AM ɡ AC a AK n AF t AC ɛ AK
artiaga	ʔ AJ a AK ɾ BD t AC j AB a AK ɡ AC a AK
artista	a AK r BA t AC i AK s AH t AC a AK
arzadon	ʔ AJ a AK ɾ BD s AH a AK d AC o AM n AF
ashley	a AK ʃ AH l AD i AK
asilo	ʔ AJ a AK s AH i AK l AD o AM
asinta	ʔ AJ a AK s AH i AK n AF t AC a AK
aso	a AK s AH o AM
asukal	a AK s AH uː AN k AC a AK l AD
asul	ʔ AJ a AK s AH u AM l AD
asungot	ʔ AJ a AK s AH u AM ŋ AF o AM t AC
at	ʔ AJ a AK t AC
ataul	ʔ AJ a AK t AC a AK ʔ AJ u AM l AD
atendido	ʔ AJ a AK t AC ɛ AK n AF d AC i AK d AC o AM
atip	a AK t AC i AK p AG
auyong	a AK w AI j AB ɔ AM ŋ AF
avanceña	ʔ AJ a AK b AG a AK n AF s AH ɛ AK ɲ AF a AK
avendaño	ʔ AJ a AK b AG ɛ AK n AF d AC a AK ɲ AF o AM
awat	ʔ AJ a AK w AI a AK t AC
away	a AK w AI a AK j AB
awayin	a AK w AI a AK j AB i AK n AF
awyoung	a AK w AI j AB ɐ AM ŋ AF
ay	ʔ AJ a AK i AK
ayam	a AK y AM a AK m AE
ayson	ʔ AJ a AK i AK s AH o AM n AF
azaña	ʔ AJ a AK s AH a AK ɲ AF a AK
azucena	ʔ AJ a AK s AH u AM s AH ɛ AK n AF a AK
ba	b AG a AK
ba't	b AG a AK t AC
babae	b AG a AK b AG a AK ʔ AJ ɛ AK
babaero	b AG a AK b AG a AK ʔ AJ ɛ AK ɾ BD o AM
babaihin	b AG a AK b AG a AK i AK h AA i AK n AF
babao	b AG a AK b AG a AK u AM
babasa	b AG a AK b AG a AK s AH a AK
babasagin	b AG a AK b AG a AK s AH a AK ɡ AC i AK n AF
babasahin	b AG a AK b AG a AK s AH a AK h AA i AK n AF
bacani	b AG a AK k AC a AK n AF i AK
baclig	b AG a AK k AC l AD i AK ɡ AC
bacsa	b AG a AK k AC s AH a AK
bactol	b AG a AK k AC t AC o AM l AD
baculi	b AG a AK k AC u AM l AD i AK
badayos	b AG a AK d AC a AK j AB o AM s AH
baga	b AG a AK ɡ AC a AK ʔ AJ
bagaman	b AG a AK ɡ AC a AK m AE a AK n AF
bagamat	b AG a AK ɡ AC a AK m AE a AK t AC
bagang	b AG a AK ɡ AC ʔ AJ a AK ŋ AF
bagaoisan	b AG a AK ɡ AC a AK w AI i AK s AH a AK n AF
baging	b AG a AK ɡ AC i AK ŋ AF
bagon	b AG a AK ɡ AC o AM n AF
bagsak	b AG a AK ɡ AC s AH a AK k AC
bagsik	b AG a AK ɡ AC s AH i AK k AC
bagsit	b AG a AK ɡ AC s AH i AK t AC
bagunsakupin	b AG a AK ɡ AC u AM n AF s AH a AK k AC u AM p AG i AK n AF
bahaghari	b AG a AK h AA a AK ɡ AC h AA a AK ɾ BD i AK ʔ AJ
bahaw	b AG a AK h AA a AK w AI
bahay	b AG a AK h AA a AK j AB
bahing	b AG a AK h AA i AK ŋ AF
bahon	b AG a AK h AA o AM n AF
baka	b AG ɐ AM k AC a AK ʔ AJ
bakahan	b AG a AK k AC a AK h AA a AK n AF
bakas	b AG a AK k AC a AK s AH
bakasyon	b AG a AK k AC a AK ʃ AH o AM n AF
bakit	b AG a AK k AC ɛ AK t AC
baklad	b AG a AK k AC l AD a AK d AC
bakulaw	b AG a AK k AC u AM l AD a AK u AM
bakuna	b AG a AK k AC u AM n AF a AK
bakunahan	b AG a AK k AC u AM n AF a AK h AA a AK n AF
bakuran	b AG a AK k AC u AM ɾ BD a AK n AF
balae	b AG a AK l AD a AK ʔ AJ ɛ AK
balaguer	b AG a AK l AD a AK ɡ AC ɛ AK ɾ BD
balahak	b AG a AK l AD a AK h AA a AK k AC
balahakan	b AG a AK l AD a AK h AA a AK k AC a AK n AF
balahibo	b AG a AK l AD a AK h AA i AK b AG o AM
balakubak	b AG a AK l AD a AK k AC u AM b AG a AK k AC
balani	b AG ɐ AM l AD a AK n AF i AK ʔ AJ
balasa	b AG a AK l AD a AK s AH a AK
balasabas	b AG a AK l AD a AK s AH a AK b AG a AK s AH
balat	b AG a AK l AD a AK t AC
balato	b AG a AK l AD a AK t AC o AM
balatong	b AG a AK l AD a AK t AC o AM ŋ AF
balbas	b AG a AK l AD b AG a AK s AH
balde	b AG a AK l AD d AC e AK
baldonado	b AG a AK l AD d AC o AM n AF a AK d AC o AM
baldosa	b AG ɐ AM l AD d AC o AM s AH ɐ AM
bali	b AG a AK l AD i AK ʔ AJ
baligtad	b AG a AK l AD i AK ɡ AC t AC a AK d AC
balik	b AG a AK l AD i AK k AC
balimbing	b AG ɐ AM l AD i AK m AE b AG i AK ŋ AF
balingit	b AG a AK l AD i AK ŋ AF i AK t AC
balisa	b AG a AK l AD i AK s AH a AK ʔ AJ
balisacan	b AG a AK l AD i AK s AH a AK k AC a AK n AF
balisungsong	b AG a AK l AD i AK s AH u AM ŋ AF s AH ɔ AM ŋ AF
balita	b AG ɐ AM l AD i AK t AC a AK ʔ AJ
balite	b AG a AK l AD i AK t AC ɛ AK
balnian	b AG a AK l AD n AF i AK a AK n AF
balo	b AG a AK l AD o AM ʔ AJ
balon	b AG a AK l AD o AM n AF
baluga	b AG a AK l AD u AM ɡ AC a AK ʔ AJ
balukay	b AG a AK l AD u AM k AC a AK j AB
baluktot	b AG a AK l AD u AM k AC t AC o AM t AC
balwarte	b AG a AK l AD w AI a AK ɾ BD t AC ɛ AK
banawa	b AG a AK n AF a AK w AI a AK
bandila	b AG a AK n AF d AC i AK l AD a AK ʔ AJ
bangaw	b AG a AK ŋ AF a AK u AM
bangkay	b AG a AK ŋ AF k AC a AK i AK
bangkiling	b AG a AK ŋ AF k AC i AK l AD i AK ŋ AF
bango	b AG a AK ŋ AF o AM
baniaga	b AG a AK n AF j AB a AK ɡ AC a AK
banig	b AG a AK n AF i AK ɡ AC
banlaw	b AG a AK n AF l AD a AK u AM
banta	b AG a AK n AF t AC a AK ʔ AJ
bantay	b AG a AK n AF t AC a AK i AK
bantayog	b AG a AK n AF t AC a AK j AB o AM ɡ AC
bantog	b AG a AK n AF t AC o AM ɡ AC
banyaga	b AG a AK n AF j AB a AK ɡ AC a AK ʔ AJ
banyuhay	b AG ɐ AM n AF y AM u AM h AA ɐ AM j AB
bao	b AG a AK o AM
baog	b AG a AK ʔ AJ o AM ɡ AC
baon	b AG a AK ʔ AJ o AM n AF
baquiran	b AG a AK k AC i AK ɾ BD a AK n AF
bara	b AG a AK ɾ BD a AK
barado	b AG a AK ɾ BD a AK d AC o AM
baraha	b AG a AK ɾ BD a AK h AA a AK
barangay	b AG a AK r BA a AK ŋ AF ɡ AC a AK j AB
barbosa	b AG a AK ɾ BD b AG o AM s AH a AK
barquilla	b AG a AK ɾ BD k AC i AK l AD l AD a AK
barrios	b AG a AK ɾ BD j AB o AM s AH
bartolome	b AG a AK ɾ BD t AC o AM l AD o AM m AE ɛ AK
barya	b AG a AK ɾ BD j AB a AK
basa	b AG a AK s AH a AK
basag	b AG a AK s AH a AK ɡ AC
basahan	b AG a AK s AH a AK h AA a AK n AF
basakay	b AG a AK s AH a AK k AC a AK j AB
basallote	b AG ɐ AM s AH ɐ AM l AD j AB o AM t AC ɛ AK
basco	b AG a AK s AH k AC o AM
base	b AG a AK s AH ɛ AK
basehan	b AG a AK s AH ɛ AK h AA a AK n AF
basilan	b AG a AK s AH i AK l AD a AK n AF
basta	b AG a AK s AH t AC a AK
bastos	b AG a AK s AH t AC o AM s AH
basurahan	b AG a AK s AH u AM ɾ BD a AK h AA a AK n AF
basurero	b AG a AK s AH u AM ɾ BD ɛ AK ɾ BD o AM
basyo	b AG a AK ʃ AH o AM
basyuhin	b AG a AK ʃ AH u AM h AA i AK n AF
bata	b AG ɐ AM t AC a AK
batallones	b AG a AK t AC a AK l AD l AD o AM n AF ɛ AK s AH
batalyon	b AG a AK t AC a AK l AD j AB o AM n AF
batangas	b AG a AK t AC a AK n AF ɡ AC a AK s AH
batas	b AG a AK t AC a AK s AH
bathalaan	b AG a AK t AC h AA a AK l AD a AK ʔ AJ a AK n AF
bati	b AG a AK t AC i AK ʔ AJ
bato	b AG a AK t AC o AM ʔ AJ
batok	b AG a AK t AC o AM k AC
batugan	b AG a AK t AC u AM ɡ AC a AK n AF
batukan	b AG a AK t AC u AM k AC a AK n AF
batya	b AG a AK t AC j AB a AK ʔ AJ
batyaw	b AG a AK tʲ AC a AK w AI
baunan	b AG a AK ʔ AJ u AM n AF a AK n AF
bauzon	b AG a AK u AM s AH o AM n AF
bawang	b AG aː AL w AI a AK ŋ AF
bayabas	b AG a AK j AB a AK b AG a AK s AH
bayad	b AG a AK j AB a AK d AC
bayanihan	b AG a AK j AB ɐ AM n AF ɪ AK h AA a AK n AF
bayarin	b AG a AK y AM a AK r BA i AK n AF
bayawak	b AG a AK j AB a AK w AI a AK k AC
bayna	b AG a AK j AB n AF a AK
bayong	b AG a AK j AB o AM ŋ AF
bayugo	b AG a AK j AB u AM ɡ AC o AM
baywang	b AG ɛ AK w AI a AK ŋ AF
bañaga	b AG a AK ɲ AF a AK ɡ AC a AK
bebot	b AG ɛː AL b AG ɔ AM t AC
bejasa	b AG ɛ AK d AC ʒ AH a AK s AH a AK
belhiko	b AG ɛ AK l AD h AA i AK k AC o AM
belmonte	b AG ɛ AK l AD m AE o AM n AF t AC ɛ AK
beltran	b AG ɛ AK l AD t AC ɾ BD a AK n AF
benepisyo	b AG ɛ AK n AF ɛ AK p AG i AK s AH j AB o AM
benipayo	b AG ɛ AK n AF i AK p AG a AK j AB o AM
benta	b AG e AK n AF t AC a AK
berde	b AG ɛ AK ɾ BD d AC ɛ AK
bergonia	b AG ɛ AK ɾ BD ɡ AC o AM n AF j AB a AK
beripikahin	b AG ɛ AK r BA i AK p AG i AK k AC a AK h AA i AK n AF
bermudez	b AG ɛ AK ɾ BD m AE u AM d AC ɛ AK s AH
beshie	b AG e AK s AH h AA i AK
bibe	b AG i AK b AG e AK
bibili	b AG i AK b AG i AK l AD i AK
bibingka	b AG i AK b AG i AK ŋ AF k AC a AK
bigat	b AG i AK ɡ AC ʔ AJ a AK t AC
bigo	b AG i AK ɡ AC o AM ʔ AJ
bigote	b AG i AK ɡ AC ɔ AM t AC ɛ AK
bigti	b AG i AK ɡ AC t AC i AK ʔ AJ
biguin	b AG i AK ɡ AC u AM i AK n AF
bihag	b AG i AK h AA a AK ɡ AC
bihira	b AG i AK h AA i AK ɾ BD a AK ʔ AJ
bihis	b AG i AK h AA i AK s AH
biik	b AG i AK i AK k AC
bilang	b AG iː AL l AD a AK ŋ AF
bilangguan	b AG i AK l AD a AK ŋ AF ɡ AC u AM ʔ AJ a AK n AF
bilao	b AG i AK l AD a AK o AM
bilas	b AG i AK l AD a AK s AH
bilhan	b AG i AK l AD h AA a AK n AF
bilhin	b AG i AK l AD h AA i AK n AF
bili	b AG i AK l AD i AK
bilog	b AG i AK l AD ɔ AM ɡ AC
bilot	b AG i AK l AD o AM t AC
biloy	b AG i AK l AD o AM j AB
bilubilo	b AG i AK l AD u AM b AG i AK l AD o AM
bilugan	b AG i AK l AD u AM ɡ AC a AK n AF
binabae	b AG i AK n AF a AK b AG a AK ʔ AJ ɛ AK
binatilyo	b AG i AK n AF a AK t AC i AK l AD j AB o AM
binaysok	b AG i AK n AF a AK j AB s AH o AM k AC
bingwit	b AG i AK ŋ AF w AI i AK t AC
bintag	b AG i AK n AF t AC a AK ɡ AC
bintana	b AG i AK n AF t AC a AK n AF a AK
bintang	b AG i AK n AF t AC a AK ŋ AF
bintog	b AG i AK n AF t AC o AM ɡ AC
binutil	b AG i AK n AF u AM t AC i AK l AD
binuya	b AG i AK n AF u AM j AB a AK
biro	b AG iː AL ɾ BD o AM ʔ AJ
bisaya	b AG i AK s AH a AK j AB a AK ʔ AJ
biscocho	b AG i AK s AH k AC o AM t AC ʃ AH o AM
bisikleta	b AG i AK s AH i AK k AC l AD ɛ AK t AC a AK
bisita	b AG i AK s AH i AK t AC a AK
bisitahin	b AG i AK s AH i AK t AC a AK h AA i AK n AF
bitamina	b AG ɪ AK t AC ɐ AM m AE i AK n AF ɐ AM
bitay	b AG i AK t AC a AK i AK
biyas	b AG i AK a AK s AH
biyaya	b AG i AK a AK j AB a AK ʔ AJ
biyernes	b AG j AB ɛ AK ɾ BD n AF ɛ AK s AH
biyolohiya	b AG i AK j AB o AM l AD o AM h AA i AK j AB ɐ AM
biyuda	b AG i AK u AM d AC a AK
bobadilla	b AG o AM b AG a AK d AC i AK l AD l AD a AK
bobo	b AG o AM b AG o AM
bobotante	b AG ɔ AM b AG ɔ AM t AC a AK n AF t AC ɛ AK
bodega	b AG o AM d AC ɛ AK ɡ AC a AK
boksing	b AG o AM k AC s AH i AK ŋ AF
bolante	b AG o AM l AD a AK n AF t AC ɛ AK
bolaños	b AG o AM l AD a AK ɲ AF o AM s AH
bolpen	b AG o AM l AD p AG ɛ AK n AF
boluntaryo	b AG o AM l AD u AM n AF t AC a AK ɾ BD j AB o AM
bonifacio	b AG o AM n AF i AK f BB a AK ʃ AH o AM
bonilla	b AG o AM n AF i AK l AD l AD a AK
boongaling	b AG o AM o AM ŋ AF ɡ AC a AK l AD i AK ŋ AF
borbon	b AG o AM ɾ BD b AG o AM n AF
borillo	b AG o AM ɾ BD i AK l AD l AD o AM
borlaza	b AG o AM ɾ BD l AD a AK s AH a AK
boso	b AG o AM s AH o AM
botante	b AG o AM t AC a AK n AF t AC ɛ AK
bote	b AG o AM t AC ɛ AK
botelya	b AG o AM t AC ɛ AK l AD j AB a AK
botika	b AG o AM t AC i AK k AC a AK
botohan	b AG o AM t AC o AM h AA a AK n AF
braso	b AG ɾ BD a AK s AH o AM
brillantes	b AG ɾ BD i AK l AD l AD a AK n AF t AC ɛ AK s AH
bruha	b AG ɾ BD u AM h AA a AK
bubo	b AG u AM b AG o AM ʔ AJ
bubog	b AG u AM b AG o AM ɡ AC
bubuli	b AG u AM b AG u AM l AD i AK
budhi	b AG u AM d AC h AA i AK ʔ AJ
buenafe	b AG u AM ɛ AK n AF a AK p AG ɛ AK
buga	b AG u AM ɡ AC a AK
bugarin	b AG u AM ɡ AC a AK ɾ BD i AK n AF
bugat	b AG u AM ɡ AC a AK t AC
bugaw	b AG u AM ɡ AC a AK u AM
bugayong	b AG u AM ɡ AC a AK j AB o AM ŋ AF
bughaw	b AG u AM ɡ AC h AA a AK w AI
bugnit	b AG u AM ɡ AC n AF i AK t AC
bugtong	b AG u AM ɡ AC t AC o AM ŋ AF
buhag	b AG u AM h AA a AK ɡ AC
buhaghag	b AG u AM h AA a AK ɡ AC h AA a AK ɡ AC
buhagsigan	b AG u AM h AA a AK ɡ AC s AH i AK ɡ AC a AK n AF
buhagsigwasan	b AG u AM h AA a AK ɡ AC s AH i AK ɡ AC w AI a AK s AH a AK n AF
buhagtigilan	b AG u AM h AA a AK ɡ AC t AC i AK ɡ AC i AK l AD a AK n AF
buhawi	b AG u AM h AA a AK w AI i AK ʔ AJ
buhok	b AG u AM h AA o AM k AC
bukambibig	b AG u AM k AC a AK m AE b AG i AK b AG i AK ɡ AC
bukas	b AG u AM k AC a AK s AH
bukbok	b AG u AM k AC b AG o AM k AC
buking	b AG u AM k AC i AK ŋ AF
bukot	b AG u AM k AC o AM t AC
bula	b AG u AM l AD a AK ʔ AJ
bulaan	b AG u AM l AD a AK ʔ AJ a AK n AF
bulahaw	b AG u AM l AD a AK h AA a AK u AM
bulalakaw	b AG u AM l AD a AK l AD a AK k AC a AK u AM
bulalay	b AG u AM l AD a AK l AD a AK j AB
bulanadi	b AG u AM l AD a AK n AF a AK d AC i AK
bulandal	b AG u AM l AD a AK n AF d AC a AK l AD
bulanhagui	b AG u AM l AD a AK n AF h AA a AK ɡ AC i AK
bulati	b AG u AM l AD a AK t AC i AK
bulatlat	b AG u AM l AD a AK t AC l AD a AK t AC
bulaw	b AG u AM l AD a AK u AM
bulbol	b AG u AM l AD b AG o AM l AD
bulig	b AG u AM l AD i AK ɡ AC
bulok	b AG u AM l AD o AM k AC
bulutong	b AG u AM l AD u AM t AC o AM ŋ AF
bulyaw	b AG u AM l AD j AB a AK u AM
bumaba	b AG u AM m AE a AK b AG a AK ʔ AJ
bumagsak	b AG u AM m AE a AK ɡ AC s AH a AK k AC
bumagyo	l AD u AM m AE i AK w AI a AK n AF a AK ɡ AC
bumaha	b AG u AM m AE a AK h AA a AK ʔ AJ
bumahin	b AG u AM m AE a AK h AA i AK n AF
bumahing	b AG u AM m AE a AK h AA i AK ŋ AF
bumalik	b AG u AM m AE a AK l AD i AK k AC
bumalintong	b AG u AM m AE a AK l AD i AK n AF t AC ɔ AM ŋ AF
bumbunan	b AG u AM m AE b AG u AM n AF a AK n AF
bumibili	b AG u AM m AE i AK b AG i AK l AD i AK
bumili	b AG u AM m AE i AK l AD i AK
bumilis	b AG u AM m AE i AK l AD i AK s AH
bumisita	b AG u AM m AE i AK s AH i AK t AC a AK
bumiyahe	b AG u AM m AE j AB a AK h AA ɛ AK
bumuo	b AG u AM m AE u AM ʔ AJ o AM ʔ AJ
bumuwelta	b AG u AM m AE u AM w AI ɛ AK l AD t AC a AK
bunag	b AG u AM n AF a AK ɡ AC
bunga	b AG u AM ŋ AF a AK
bungkos	b AG u AM ŋ AF k AC o AM s AH
bungo	b AG u AM ŋ AF o AM ʔ AJ
bungot	b AG u AM ŋ AF ɔ AM t AC
buno	b AG u AM n AF o AM ʔ AJ
bunso	b AG u AM ŋ AF s AH o AM ʔ AJ
bunto	b AG u AM n AF t AC o AM ʔ AJ
bunyi	b AG u AM n AF j AB i AK
buo	b AG u AM o AM ʔ AJ
buol	b AG u AM ʔ AJ o AM l AD
buquid	b AG u AM k AC i AK d AC
bura	b AG u AM ɾ BD aː AL
burahin	b AG u AM r BA a AK h AA i AK n AF
burgis	b AG u AM ɾ BD ɡ AC i AK s AH
buryong	b AG u AM ɾ BD j AB o AM ŋ AF
bus	b AG u AM s AH
buson	b AG u AM s AH o AM n AF
butac	b AG u AM t AC a AK k AC
butaka	b AG u AM t AC a AK k AC a AK
butang	b AG u AM t AC a AK ŋ AF
butas	b AG u AM t AC a AK s AH
buto	b AG u AM t AC ʔ AJ o AM
butod	b AG u AM t AC o AM d AC
butudkaphay	b AG u AM t AC o AM d AC k AC a AK p AG h AA a AK j AB
butudkilos	b AG u AM t AC o AM d AC k AC i AK l AD o AM s AH
buturan	b AG u AM t AC u AM ɾ BD a AK n AF
buuin	b AG u AM ʔ AJ u AM ʔ AJ i AK n AF
buwag	b AG u AM a AK ɡ AC
buwakaw	b AG w AI a AK k AC a AK u AM
buwanan	b AG u AM a AK n AF a AK n AF
buwaya	b AG u AM a AK j AB a AK
buwelta	b AG w AI ɛ AK l AD t AC a AK
buweltahan	b AG w AI ɛ AK l AD t AC a AK h AA a AK n AF
buwisit	b AG u AM i AK s AH i AK t AC
buyo	b AG u AM j AB o AM
cabahug	k AC a AK b AG a AK h AA u AM ɡ AC
cabanayan	k AC a AK b AG a AK n AF a AK j AB a AK n AF
cabanlit	k AC a AK b AG a AK n AF l AD i AK t AC
cabasag	k AC a AK b AG a AK s AH a AK ɡ AC
cabiling	k AC a AK b AG i AK l AD i AK ŋ AF
cabral	k AC a AK b AG ɾ BD a AK l AD
cabuhat	k AC a AK b AG u AM h AA a AK t AC
cabungcal	k AC a AK b AG u AM ŋ AF k AC a AK l AD
cacdac	k AC a AK k AC d AC a AK k AC
cadano	k AC a AK d AC a AK n AF o AM
cadapan	k AC a AK d AC a AK p AG a AK n AF
cadayona	k AC a AK d AC a AK j AB o AM n AF a AK
cagalingan	k AC a AK ɡ AC a AK l AD i AK ŋ AF a AK n AF
caguiat	k AC a AK ɡ AC j AB a AK t AC
caguioa	k AC a AK ɡ AC i AK w AI a AK
calalo	k AC a AK l AD a AK l AD o AM
calaunan	k AC a AK l AD a AK ʔ AJ u AM n AF a AK n AF
calaycay	k AC a AK l AD a AK i AK k AC a AK i AK
calinawan	k AC a AK l AD i AK n AF a AK w AI a AK n AF
calingasan	k AC a AK l AD i AK ŋ AF a AK s AH a AK n AF
calinisan	k AC a AK l AD i AK n AF i AK s AH a AK n AF
calma	k AC a AK l AD m AE a AK
campo	k AC a AK m AE p AG o AM
cancio	k AC a AK n AF s AH i AK o AM
canicosa	k AC a AK n AF i AK k AC o AM s AH a AK
canilao	k AC a AK n AF i AK l AD a AK u AM
cantiveros	k AC a AK n AF t AC i AK b AG ɛ AK ɾ BD o AM s AH
cantos	k AC a AK n AF t AC o AM s AH
caparas	k AC a AK p AG a AK ɾ BD a AK s AH
capinpin	k AC a AK p AG i AK n AF p AG i AK n AF
cardiño	k AC a AK ɾ BD d AC i AK ɲ AF o AM
cariaso	k AC a AK ɾ BD j AB a AK s AH o AM
carillo	k AC a AK ɾ BD i AK l AD l AD o AM
carlos	k AC ɐ AM ɾ BD l AD ɔ AM s AH
carrillo	k AC a AK ɾ BD ɾ BD i AK l AD l AD o AM
casal	k AC a AK s AH a AK l AD
casanova	k AC a AK s AH a AK n AF o AM b AG a AK
casao	k AC a AK s AH a AK o AM
caseda	k AC a AK s AH ɛ AK d AC a AK
castañeda	k AC a AK s AH t AC a AK ɲ AF ɛ AK d AC a AK
castrence	k AC a AK s AH t AC ɾ BD ɛ AK n AF s AH ɛ AK
catapang	k AC a AK t AC a AK p AG a AK ŋ AF
catibog	k AC a AK t AC i AK b AG o AM ɡ AC
catimbang	k AC a AK t AC i AK m AE b AG a AK ŋ AF
catipon	k AC a AK t AC i AK p AG o AM n AF
catral	k AC a AK t AC ɾ BD a AK l AD
cauilan	k AC a AK w AI i AK l AD a AK n AF
caw	k AC a AK w AI
cedeño	s AH ɛ AK d AC ɛ AK ɲ AF o AM
cenizal	s AH ɛ AK n AF i AK s AH a AK l AD
cereno	s AH ɛ AK ɾ BD ɛ AK n AF o AM
cerillo	s AH ɛ AK ɾ BD i AK l AD l AD o AM
chan	t AC ʃ AH a AK n AF
cheng	c AC h AA ɛ AK ŋ AF
chi	t AC ʃ AH i AK
ching	t AC ʃ AH i AK ŋ AF
chong	t AC ʃ AH o AM ŋ AF
chu	t AC ʃ AH ʊ AM
chua	t AC ʃ AH w AI a AK
chung	t AC ʃ AH ʊ AM ŋ AF
cinco	s AH i AK n AF k AC o AM
closa	k AC l AD o AM s AH a AK
co	k AC ɔ AM
collado	k AC o AM l AD l AD a AK d AC o AM
cometa	k AC o AM m AE ɛ AK t AC a AK
comia	k AC o AM m AE i AK a AK
condez	k AC o AM n AF d AC ɛ AK s AH
coo	k AC uː AN
coquia	k AC o AM k AC i AK a AK
corcuera	k AC o AM ɾ BD k AC w AI ɛ AK ɾ BD a AK
cornejo	k AC o AM ɾ BD n AF ɛ AK d AC ʒ AH o AM
coronel	k AC o AM ɾ BD o AM n AF ɛ AK l AD
corrales	k AC o AM ɾ BD ɾ BD a AK l AD ɛ AK s AH
correa	k AC o AM ɾ BD ɾ BD ɛ AK a AK
corro	k AC o AM ɾ BD ɾ BD o AM
cosico	k AC o AM s AH i AK k AC o AM
cruzat	k AC ɾ BD u AM s AH a AK t AC
cua	k AC w AI a AK
cuasay	k AC w AI a AK s AH a AK i AK
cubacub	k AC u AM b AG a AK k AC u AM b AG
cueto	k AC w AI ɛ AK t AC o AM
cuizon	k AC u AM i AK s AH o AM n AF
custodio	k AC u AM s AH t AC o AM d AC j AB o AM
daan	d AC a AK ʔ AJ a AK n AF
dabarkads	d AC a AK b AG a AK r BA k AC a AK d AC s AH
dacanay	d AC a AK k AC a AK n AF a AK i AK
dado	d AC a AK d AC o AM
daga	d AC a AK ɡ AC a AK ʔ AJ
dagadagaan	d AC a AK ɡ AC a AK d AC a AK ɡ AC a AK ʔ AJ a AK n AF
dagat	d AC a AK ɡ AC a AK t AC
dagipik	d AC a AK ɡ AC i AK p AG i AK k AC
dagisikan	d AC a AK ɡ AC i AK s AH i AK k AC a AK n AF
dagitban	d AC a AK ɡ AC i AK t AC b AG a AK n AF
dagitigilan	d AC a AK ɡ AC i AK t AC i AK ɡ AC i AK l AD a AK n AF
dagitsigan	d AC a AK ɡ AC i AK t AC s AH i AK ɡ AC a AK n AF
dagta	d AC a AK ɡ AC t AC a AK ʔ AJ
dahas	d AC a AK h AA a AK s AH
dahilan	d AC a AK h AA i AK l AD a AK n AF
dahilig	d AC a AK h AA i AK l AD i AK ɡ AC
dahon	d AC a AK h AA o AM n AF
dakip	d AC a AK k AC i AK p AG
daktao	d AC a AK k AC t AC a AK ʔ AJ ɔ AM
daktinig	d AC a AK k AC t AC i AK n AF i AK ɡ AC
dalagita	d AC a AK l AD a AK ɡ AC i AK t AC a AK
dalang	d AC a AK l AD a AK ŋ AF
dalaw	d AC a AK l AD a AK u AM
dalawa	d AC a AK l AD a AK w AI a AK
dalawampu	d AC a AK l AD a AK w AI a AK m AE p AG u AM ʔ AJ
dalawit	d AC a AK l AD a AK w AI i AK t AC
dalmasya	d AC ɑ AK l AD m AE ɑ AK ɕ AH ɑ AK
dalubhasa	d AC a AK l AD u AM b AG h AA a AK s AH a AK ʔ AJ
dalubituinan	d AC a AK l AD u AM b AG b AG i AK t AC u AM i AK n AF a AK n AF
dalubtalaan	d AC a AK l AD u AM b AG t AC a AK l AD a AK ʔ AJ a AK n AF
dalubtauhan	d AC a AK l AD u AM b AG t AC a AK ʔ AJ u AM h AA a AK n AF
dalubwikaan	d AC a AK l AD u AM b AG w AI i AK k AC a AK ʔ AJ a AK n AF
dalusong	d AC a AK l AD u AM s AH o AM ŋ AF
dama	d AC ɐ AM m AE a AK
damit	d AC a AK m AE i AK t AC
damo	d AC a AK m AE o AM
damot	d AC a AK m AE o AM t AC
damuhan	d AC ɐ AM m AE u AM h AA a AK n AF
damuho	d AC a AK m AE u AM h AA o AM ʔ AJ
dantay	d AC a AK n AF t AC a AK i AK
danum	d AC a AK n AF u AM m AE
danumsigwasan	d AC a AK n AF u AM m AE s AH i AK ɡ AC w AI a AK s AH a AK n AF
danumtigilan	d AC a AK n AF u AM m AE t AC i AK ɡ AC i AK l AD a AK n AF
dao	d AC a AK ʔ AJ o AM
dapat	d AC a AK p AG a AK t AC
dapdap	d AC a AK p AG d AC a AK p AG
datapwa	d AC a AK t AC a AK p AG w AI a AK ʔ AJ
dati	d AC a AK t AC i AK
dating	d AC ɐ AM t AC i AK ŋ AF
datinguinoo	d AC a AK t AC i AK ŋ AF i AK n AF o AM o AM
davao	d AC a AK b AG a AK u AM
daw	ɾ BD a AK u AM
daya	d AC a AK j AB a AK ʔ AJ
dayag	d AC a AK j AB a AK ɡ AC
dayami	d AC a AK j AB a AK m AE i AK
dayang	d AC a AK j AB a AK ŋ AF
dayanghirang	d AC a AK j AB a AK ŋ AF h AA i AK ɾ BD a AK ŋ AF
dayrit	d AC a AK i AK ɾ BD i AK t AC
dazo	d AC a AK s AH o AM
deang	d AC j AB a AK ŋ AF
deboto	d AC ɛ AK b AG o AM t AC o AM
decena	d AC ɛ AK s AH ɛ AK n AF a AK
dee	d AC i AK
dehado	d AC ɛ AK h AA a AK d AC o AM
dekada	d AC ɛ AK k AC a AK d AC a AK
dekorasyon	d AC ɛ AK k AC o AM ɾ BD a AK s AH j AB o AM n AF
dekreto	d AC ɛ AK k AC ɾ BD ɛ AK t AC o AM
delegasyon	d AC ɛ AK l AD ɛ AK ɡ AC a AK s AH j AB o AM n AF
demonyo	d AC ɛ AK m AE o AM n AF j AB o AM
dentista	d AC ɛ AK n AF t AC i AK s AH t AC a AK
depensahan	d AC ɛ AK p AG ɛ AK n AF s AH a AK h AA a AK n AF
desisyon	d AC ɛ AK s AH i AK s AH j AB o AM n AF
destino	d AC ɛ AK s AH t AC i AK n AF o AM
di	d AC ɛ AK
diamante	d AC i AK a AK m AE a AK n AF t AC ɛ AK
diigkasin	d AC i AK ʔ AJ i AK ɡ AC k AC a AK s AH i AK n AF
diin	d AC i AK ʔ AJ i AK n AF
dijamco	d AC i AK d AC ʒ AH a AK m AE k AC o AM
diklap	d AC i AK k AC l AD a AK p AG
dila	d AC i AK l AD a AK ʔ AJ
dilaan	d AC i AK l AD a AK a AK n AF
dilaw	d AC i AK l AD a AK u AM
dilikas	d AC i AK l AD i AK k AC a AK s AH
dilim	d AC i AK l AD i AK m AE
dimaala	d AC i AK m AE a AK a AK l AD a AK
dimaandal	d AC i AK m AE a AK a AK n AF d AC a AK l AD
dimaapi	d AC i AK m AE a AK a AK p AG i AK
dimacali	d AC i AK m AE a AK k AC a AK l AD i AK
dimagiba	d AC i AK m AE a AK ɡ AC i AK b AG a AK
dimailig	d AC i AK m AE a AK i AK l AD i AK ɡ AC
dimalaluan	d AC i AK m AE a AK l AD a AK l AD u AM a AK n AF
dimalanta	d AC i AK m AE a AK l AD a AK n AF t AC a AK
dimapilis	d AC i AK m AE a AK p AG i AK l AD i AK s AH
dimaranan	d AC i AK m AE a AK ɾ BD a AK n AF a AK n AF
dimatatac	d AC i AK m AE a AK t AC a AK t AC a AK k AC
din	d AC i AK n AF
dinagipik	d AC i AK n AF a AK ɡ AC i AK p AG i AK k AC
dinamita	d AC i AK n AF a AK m AE i AK t AC a AK
dinding	d AC i AK n AF d AC i AK ŋ AF
dine	d AC i AK n AF ɛ AK
dingding	d AC i AK n AF d AC i AK ŋ AF
diokno	d AC i AK o AM k AC n AF o AM
dipasupil	d AC i AK p AG a AK s AH u AM p AG i AK l AD
diplomasya	d AC i AK p AG l AD o AM m AE a AK s AH j AB a AK
disisais	d AC i AK s AH i AK s AH a AK ʔ AJ i AK s AH
diskumpiyado	d AC i AK s AH k AC u AM m AE p AG i AK a AK d AC o AM
dismayado	d AC i AK s AH m AE a AK j AB a AK d AC o AM
dito	d AC i AK t AC o AM
diyablo	d AC i AK a AK b AG l AD o AM
diyamante	d AC i AK a AK m AE a AK n AF t AC ɛ AK
diño	d AC i AK ɲ AF o AM
doctolero	d AC o AM k AC t AC o AM l AD ɛ AK ɾ BD o AM
dolores	d AC o AM l AD o AM ɾ BD ɛ AK s AH
domantay	d AC o AM m AE a AK n AF t AC a AK i AK
domingo	d AC o AM m AE i AK n AF ɡ AC o AM
doon	d AC o AM ʔ AJ o AM n AF
dos	d AC o AM s AH
dueñas	d AC u AM ɛ AK ɲ AF a AK s AH
duhansipat	d AC u AM h AA a AK n AF s AH i AK p AG a AK t AC
duhat	d AC u AM h AA a AK t AC
dukot	d AC u AM k AC o AM t AC
dukwang	d AC u AM k AC w AI a AK ŋ AF
dulay	d AC u AM l AD a AK i AK
duldol	d AC u AM l AD d AC o AM l AD
dulos	d AC u AM l AD o AM s AH
dumaan	d AC u AM m AE a AK a AK n AF
dumaguing	d AC u AM m AE a AK ɡ AC i AK ŋ AF
dumapa	d AC u AM m AE a AK p AG a AK
dumating	d AC u AM m AE a AK t AC i AK ŋ AF
dumi	d AC u AM m AE ɪː AL
dumighay	d AC u AM m AE i AK ɡ AC h AA a AK y AM
dumilim	d AC u AM m AE i AK l AD i AK m AE
dumlao	d AC u AM m AE l AD a AK o AM
dumpit	d AC u AM m AE p AG i AK t AC
dumulas	d AC u AM m AE u AM l AD a AK s AH
dumungaw	d AC u AM m AE u AM ŋ AF a AK u AM
dumura	d AC u AM m AE u AM ɾ BD a AK ʔ AJ
dungaw	d AC u AM ŋ AF a AK u AM
dunggot	d AC u AM ŋ AF ɡ AC o AM t AC
dupil	d AC u AM p AG i AK l AD
dura	d AC u AM ɾ BD a AK ʔ AJ
durante	d AC u AM ɾ BD a AK n AF t AC ɛ AK
durungawan	d AC u AM ɾ BD u AM ŋ AF a AK w AI a AK n AF
dutaan	d AC u AM t AC a AK ʔ AJ a AK n AF
duwag	d AC u AM a AK ɡ AC
duyan	d AC u AM j AB a AK n AF
dy	d AC iː AL
dyahe	d AC ʒ AH a AK h AA ɛ AK
dyaket	d AC ʒ AH a AK k AC ɛ AK t AC
dyanitor	d AC j AB a AK n AF i AK t AC o AM ɾ BD
dyaryo	ɟ AC ʝ AH ɑ AK rʲ BA ɔ AM
echano	ʔ AJ ɛ AK t AC ʃ AH a AK n AF o AM
echevarria	ʔ AJ ɛ AK t AC ʃ AH ɛ AK b AG a AK ɾ BD j AB a AK
edad	ɛ AK d AC a AK d AC
edisyon	ʔ AJ ɛ AK d AC i AK s AH j AB o AM n AF
ekis	ʔ AJ ɛ AK k AC i AK s AH
ekisan	ʔ AJ ɛ AK k AC i AK s AH a AK n AF
ekonomiya	ʔ AJ ɛ AK k AC o AM n AF o AM m AE i AK a AK
elamparo	ʔ AJ ɛ AK l AD a AK m AE p AG a AK ɾ BD o AM
elegansya	ɛ AK l AD ɛ AK ɡ AC a AK n AF ʃ AH a AK
elizaga	ʔ AJ ɛ AK t AC ʃ AH ɛ AK b AG a AK ɾ BD j AB a AK
encarnado	ʔ AJ ɛ AK n AF k AC a AK ɾ BD n AF a AK d AC o AM
encinas	ʔ AJ ɛ AK n AF s AH i AK n AF a AK s AH
endaya	ʔ AJ ɛ AK n AF d AC a AK j AB a AK
endozo	ʔ AJ ɛ AK n AF d AC o AM s AH o AM
enero	ɛ AK n AF ɛ AK ɾ BD o AM
engkanto	ʔ AJ ɛ AK ŋ AF k AC a AK n AF t AC o AM
entusyasmo	ɛ AK n AF t AC u AM s AH j AB a AK s AH m AE o AM
epal	ɛ AK p AG a AK l AD
epekto	ʔ AJ ɛ AK p AG ɛ AK k AC t AC o AM
epidemya	ʔ AJ ɛ AK p AG i AK d AC ɛ AK m AE j AB a AK
episyente	ɛ AK p AG i AK ʃ AH ɛ AK n AF t AC ɛ AK
erehe	ʔ AJ ɛ AK ɾ BD ɛ AK h AA ɛ AK
ermitanyo	ʔ AJ ɛ AK ɾ BD m AE i AK t AC a AK n AF j AB o AM
escalona	ʔ AJ ɛ AK s AH k AC a AK l AD o AM n AF a AK
escaño	ʔ AJ ɛ AK s AH k AC a AK ɲ AF o AM
esguerra	ʔ AJ ɛ AK s AH ɡ AC ɛ AK ɾ BD ɾ BD a AK
eskaparate	ʔ AJ ɛ AK s AH k AC a AK p AG a AK ɾ BD a AK t AC ɛ AK
espadahan	ʔ AJ ɛ AK s AH p AG a AK d AC a AK h AA a AK n AF
espasyo	ʔ AJ ɛ AK s AH p AG a AK s AH j AB o AM
espinoza	ʔ AJ ɛ AK s AH p AG i AK n AF o AM s AH a AK
esquivel	ʔ AJ ɛ AK s AH k AC i AK b AG ɛ AK l AD
estabillo	ʔ AJ ɛ AK s AH t AC a AK b AG i AK l AD l AD o AM
estrella	ʔ AJ ɛ AK s AH t AC ɾ BD ɛ AK l AD l AD a AK
eugenio	j AB u AM h AA ɛ AK n AF j AB o AM
exconde	ʔ AJ ɛ AK k AC s AH k AC o AM n AF d AC ɛ AK
fabregas	p AG a AK b AG ɾ BD ɛ AK ɡ AC a AK s AH
fabros	p AG a AK b AG ɾ BD o AM s AH
fajardo	p AG a AK d AC ʒ AH a AK ɾ BD d AC o AM
falcon	p AG a AK l AD k AC o AM n AF
faltado	p AG a AK l AD t AC a AK d AC o AM
fernandez	p AG ɛ AK ɾ BD n AF a AK n AF d AC ɛ AK s AH
ferriols	p AG ɛ AK ɾ BD ɾ BD i AK o AM l AD s AH
festejo	p AG ɛ AK s AH t AC ɛ AK d AC ʒ AH o AM
figueras	p AG i AK ɡ AC ɛ AK ɾ BD a AK s AH
figueroa	p AG i AK ɡ AC ɛ AK ɾ BD o AM a AK
filipino	p AG i AK l AD i AK p AG i AK n AF o AM
flojo	p AG l AD o AM d AC ʒ AH o AM
fojas	p AG o AM d AC ʒ AH a AK s AH
fonacier	p AG o AM n AF a AK s AH i AK ɛ AK ɾ BD
fontelera	p AG o AM n AF t AC ɛ AK l AD ɛ AK ɾ BD a AK
fontillas	p AG o AM n AF t AC i AK l AD l AD a AK s AH
forteza	p AG o AM ɾ BD t AC ɛ AK s AH a AK
fortich	p AG o AM ɾ BD t AC i AK t AC ʃ AH
frias	p AG ɾ BD i AK a AK s AH
fronda	p AG ɾ BD o AM n AF d AC a AK
fuentebella	p AG u AM ɛ AK n AF t AC ɛ AK b AG ɛ AK l AD l AD a AK
fung	p AG u AM ŋ AF
furagganan	p AG u AM ɾ BD a AK ɡ AC ɡ AC a AK n AF a AK n AF
gabi	ɡ AC a AK b AG i AK
gabiana	ɡ AC a AK b AG i AK a AK n AF a AK
gacula	ɡ AC a AK k AC u AM l AD a AK
gacusan	ɡ AC a AK k AC u AM s AH a AK n AF
gacutan	ɡ AC a AK k AC u AM t AC a AK n AF
gadgad	ɡ AC a AK d AC ɡ AC a AK d AC
galamay	ɡ AC a AK l AD a AK m AE a AK i AK
galapong	ɡ AC a AK l AD a AK p AG o AM ŋ AF
galauran	ɡ AC a AK l AD a AK ʔ AJ u AM ɾ BD a AK n AF
galawan	ɡ AC a AK l AD a AK w AI a AK n AF
galing	ɡ AC a AK l AD i AK ŋ AF
galis	ɡ AC a AK l AD i AK s AH
galit	ɡ AC a AK l AD i AK t AC
gallo	ɡ AC a AK l AD l AD o AM
galos	ɡ AC a AK l AD o AM s AH
gan	ɡ AC a AK n AF
ganap	ɡ AC a AK n AF a AK p AG
gancayco	ɡ AC a AK n AF k AC a AK i AK k AC o AM
ganda	ɡ AC a AK n AF d AC a AK
gangsal	ɡ AC a AK ŋ AF s AH a AK l AD
ganid	ɡ AC a AK n AF i AK d AC
gansa	ɡ AC a AK n AF s AH a AK
gansal	ɡ AC a AK n AF s AH a AK l AD
ganti	ɡ AC a AK n AF t AC i AK
ganzon	ɡ AC a AK n AF s AH o AM n AF
gao	ɡ AC a AK w AI
garalde	ɡ AC a AK ɾ BD a AK l AD d AC ɛ AK
garapata	ɡ AC a AK ɾ BD a AK p AG a AK t AC a AK
garay	ɡ AC a AK ɾ BD a AK i AK
garces	ɡ AC a AK ɾ BD s AH ɛ AK s AH
garchitorena	ɡ AC a AK ɾ BD t AC ʃ AH i AK t AC o AM ɾ BD ɛ AK n AF a AK
garciano	ɡ AC a AK ɾ BD s AH i AK a AK n AF o AM
gargaran	ɡ AC a AK ɾ BD ɡ AC a AK ɾ BD a AK n AF
gascon	ɡ AC a AK s AH k AC o AM n AF
gaslaw	ɡ AC a AK s AH l AD a AK u AM
gasolinahan	ɡ AC a AK s AH o AM l AD i AK n AF a AK h AA a AK n AF
gaspang	ɡ AC a AK s AH p AG a AK ŋ AF
gaston	ɡ AC a AK s AH t AC o AM n AF
gatbonton	ɡ AC a AK t AC b AG o AM n AF t AC o AM n AF
gatchalian	ɡ AC a AK t AC t AC ʃ AH a AK l AD j AB a AK n AF
gatong	ɡ AC aː AL t AC ɔ AM ŋ AF
gavilan	ɡ AC a AK b AG i AK l AD a AK n AF
gaviola	ɡ AC a AK b AG j AB o AM l AD a AK
gayuma	ɡ AC a AK j AB u AM m AE a AK
gerilya	ɡ AC ɛ AK ɾ BD i AK l AD j AB a AK
gerodias	d AC ʒ AH ɛ AK ɾ BD o AM d AC j AB a AK s AH
geron	ɡ AC ɛ AK ɾ BD o AM n AF
geronimo	h AA ɛ AK ɾ BD o AM n AF i AK m AE o AM
gigil	ɡ AC i AK ɡ AC i AK l AD
gilagid	ɡ AC i AK l AD a AK ɡ AC i AK d AC
ginhawa	ɡ AC i AK n AF h AA a AK w AI a AK
ginto	ɡ AC i AK n AF t AC o AM ʔ AJ
gipalpal	ɡ AC i AK p AG a AK l AD p AG a AK l AD
giron	h AA i AK ɾ BD o AM n AF
gisa	ɡ AC i AK s AH a AK
gising	ɡ AC i AK s AH i AK ŋ AF
gitara	ɡ AC i AK t AC a AK ɾ BD a AK
gitlawas	ɡ AC i AK t AC l AD a AK w AI a AK s AH
gitna	ɡ AC i AK t AC n AF a AK ʔ AJ
giwa	ɡ AC i AK w AI a AK ʔ AJ
go	ɡ AC ɔ AM
godoy	ɡ AC o AM d AC o AM i AK
goh	ɡ AC o AM
grabe	ɡ AC ɾ BD a AK b AG ɛ AK
gradweyt	ɡ AC ɾ BD a AK d AC w AI ɛ AK i AK t AC
grasa	ɡ AC ɾ BD a AK s AH a AK
grasya	ɡ AC ɾ BD a AK s AH j AB a AK
grumadweyt	ɡ AC ɾ BD u AM m AE a AK d AC w AI ɛ AK i AK t AC
guanzon	ɡ AC u AM a AK n AF s AH o AM n AF
gubat	ɡ AC u AM b AG a AK t AC
guerra	ɡ AC ɛ AK ɾ BD a AK
guinto	ɡ AC i AK n AF t AC o AM
gulang	ɡ AC u AM l AD a AK ŋ AF
gulay	ɡ AC u AM l AD a AK j AB
gulpi	ɡ AC u AM l AD p AG i AK
gumagad	ɡ AC u AM m AE a AK ɡ AC a AK d AC
gumala	ɡ AC u AM m AE a AK l AD a AK ʔ AJ
gumaling	ɡ AC u AM m AE a AK l AD i AK ŋ AF
gumapac	ɡ AC u AM m AE a AK p AG a AK k AC
gumawa	ɡ AC u AM m AE a AK w AI a AK ʔ AJ
gumilid	ɡ AC u AM m AE i AK l AD i AK d AC
gumiran	ɡ AC u AM m AE i AK ɾ BD a AK n AF
gumising	ɡ AC u AM m AE i AK s AH i AK ŋ AF
gumuho	ɡ AC u AM m AE u AM h AA ɔ AM ʔ AJ
gumulong	ɡ AC u AM m AE u AM l AD ɔ AM ŋ AF
guwantes	ɡ AC u AM a AK n AF t AC ɛ AK s AH
guwardiya	ɡ AC u AM a AK ɾ BD d AC j AB a AK
habagat	h AA a AK b AG a AK ɡ AC a AK t AC
hagikgik	h AA a AK ɡ AC ɪ AK k AC ɡ AC ɪ AK k AC
hagod	h AA a AK ɡ AC o AM d AC
hagok	h AA a AK ɡ AC o AM k AC
hagulgol	h AA a AK ɡ AC u AM l AD ɡ AC o AM l AD
hagulhol	h AA a AK ɡ AC u AM l AD h AA o AM l AD
hagupit	h AA a AK ɡ AC u AM p AG i AK t AC
halabos	h AA a AK l AD a AK b AG o AM s AH
halaga	h AA a AK l AD a AK ɡ AC a AK
halalan	h AA a AK l AD a AK l AD a AK n AF
halari	h AA a AK l AD a AK ɾ BD i AK ʔ AJ
halasan	h AA a AK l AD a AK s AH a AK n AF
haligi	h AA a AK l AD i AK ɡ AC i AK
halik	h AA a AK l AD i AK k AC
halimaw	h AA a AK l AD i AK m AE a AK u AM
hambalang	h AA a AK m AE b AG a AK l AD a AK ŋ AF
hamog	h AA a AK m AE o AM ɡ AC
hamon	h AA a AK m AE o AM n AF
hangal	h AA a AK ŋ AF a AK l AD
hangin	h AA a AK ŋ AF i AK n AF
hanginsigan	h AA a AK ŋ AF i AK n AF s AH i AK ɡ AC a AK n AF
hangintigilan	h AA a AK ŋ AF i AK n AF t AC i AK ɡ AC i AK l AD a AK n AF
hapdi	h AA a AK p AG d AC i AK ʔ AJ
hapit	h AA a AK p AG i AK t AC
hapo	h AA a AK p AG o AM ʔ AJ
hapones	h AA a AK p AG o AM n AF ɛ AK s AH
hapunan	h AA a AK p AG u AM n AF a AK n AF
harana	h AA a AK ɾ BD a AK n AF a AK
harang	h AA a AK ɾ BD a AK ŋ AF
harap	h AA a AK ɾ BD a AK p AG
hardin	h AA ɐ AM r BA d AC i AK n AF
hardinera	h AA ɐ AM r BA d AC ɪ AK n AF e AK r BA a AK
hardinero	h AA ɐ AM r BA d AC ɪ AK n AF e AK r BA o AM
hasik	h AA a AK s AH i AK k AC
hati	h AA a AK t AC i AK ʔ AJ
hatinig	h AA a AK t AC i AK n AF i AK ɡ AC
hatol	h AA a AK t AC o AM l AD
hau	h AA a AK w AI
haw	h AA a AK w AI
hawa	h AA a AK w AI a AK
hawak	h AA a AK w AI a AK k AC
hawakan	h AA a AK w AI a AK k AC a AK n AF
hawla	h AA a AK u AM l AD a AK
hayag	h AA a AK j AB a AK ɡ AC
haynayan	h AA a AK j AB n AF a AK j AB a AK n AF
hayop	h AA a AK j AB o AM p AG
hene	h AA e AK n AF e AK
henetika	h AA e AK n AF e AK t AC i AK k AC ɐ AM
heng	h AA e AK ŋ AF
herradura	ʔ AJ ɛ AK ɾ BD a AK d AC u AM ɾ BD a AK
hesusmaryosep	h AA ɛ AK s AH u AM s AH m AE a AK ɾ BD i AK ɔː AN s AH e AK p AG
hibi	h AA i AK b AG i AK
higanti	h AA i AK ɡ AC a AK n AF t AC i AK ʔ AJ
higlikas	h AA i AK ɡ AC l AD i AK k AC a AK s AH
higliknayan	h AA i AK ɡ AC l AD i AK k AC n AF a AK j AB a AK n AF
higop	h AA i AK ɡ AC o AM p AG
higsipnayan	h AA i AK ɡ AC s AH i AK p AG n AF a AK j AB a AK n AF
higtao	h AA i AK ɡ AC t AC a AK ʔ AJ ɔ AM
hikaw	h AA i AK k AC a AK w AI
hilab	h AA i AK l AD a AK b AG
hilaga	h AA i AK l AD a AK ɡ AC a AK ʔ AJ
hilaw	h AA i AK l AD a AK u AM
hilera	h AA i AK l AD ɛ AK ɾ BD a AK
himagas	h AA i AK m AE a AK ɡ AC a AK s AH
himala	h AA i AK m AE a AK l AD a AK ʔ AJ
himanting	h AA i AK m AE a AK n AF t AC i AK ŋ AF
himasok	h AA i AK m AE a AK s AH o AM k AC
himatayin	h AA i AK m AE a AK t AC a AK j AB i AK n AF
himbabahay	h AA i AK m AE b AG a AK b AG a AK h AA a AK j AB
hina	h AA i AK n AF a AK ʔ AJ
hinagpis	h AA i AK n AF a AK ɡ AC p AG i AK s AH
hinala	h AA i AK n AF a AK l AD a AK ʔ AJ
hindi	h AA ɛ AK n AF d AC ɛ AK
hinga	h AA i AK ŋ AF a AK
hinlalaki	h AA i AK n AF l AD a AK l AD a AK k AC i AK
hinog	h AA i AK n AF o AM ɡ AC
hintuturo	h AA i AK n AF t AC u AM t AC u AM ɾ BD o AM ʔ AJ
hipolito	h AA i AK p AG o AM l AD i AK t AC o AM
hipon	h AA i AK p AG o AM n AF
hira	h AA i AK ɾ BD a AK ʔ AJ
hirap	h AA i AK ɾ BD a AK p AG
hita	h AA i AK t AC a AK ʔ AJ
hithit	h AA i AK t AC h AA i AK t AC
hito	h AA i AK t AC o AM ʔ AJ
hitso	h AA i AK t AC s AH o AM
hitsura	h AA i AK t AC ʃ AH u AM ɾ BD a AK
hiwalay	h AA i AK w AI a AK l AD a AK i AK
hiya	h AA i AK j AB a AK ʔ AJ
hiyaw	h AA i AK a AK u AM
hizon	h AA i AK s AH o AM n AF
ho	h AA ɔ AM
homiliya	h AA o AM m AE i AK l AD i AK a AK
hong	h AA o AM ŋ AF
hopya	h AA o AM p AG j AB a AK ʔ AJ
hortaleza	h AA o AM ɾ BD t AC a AK l AD ɛ AK s AH a AK
hoy	h AA o AM j AB
huli	h AA u AM l AD i AK ʔ AJ
hulog	h AA u AM l AD o AM ɡ AC
humadlang	h AA u AM m AE a AK d AC l AD a AK ŋ AF
humagulgol	h AA u AM m AE a AK ɡ AC u AM l AD ɡ AC o AM l AD
humalik	h AA u AM m AE a AK l AD i AK k AC
humanda	h AA u AM m AE a AK n AF d AC a AK ʔ AJ
humandusay	h AA u AM m AE a AK n AF d AC u AM s AH a AK i AK
humiga	h AA u AM m AE i AK ɡ AC a AK ʔ AJ
humingi	h AA u AM m AE i AK ŋ AF i AK ʔ AJ
huminto	h AA u AM m AE i AK n AF t AC o AM ʔ AJ
humiram	h AA u AM m AE i AK ɾ BD a AK m AE
humirap	h AA u AM m AE i AK r BA a AK p AG
hung	h AA u AM ŋ AF
huni	h AA u AM n AF i AK
huramentado	h AA u AM ɾ BD a AK m AE e AK n AF t AC a AK d AC o AM
huron	h AA u AM r BA o AM n AF
husga	h AA u AM s AH ɡ AC a AK
husgado	h AA u AM s AH ɡ AC a AK d AC o AM
husgahan	h AA u AM s AH ɡ AC a AK h AA a AK n AF
huwebes	h AA u AM w AI ɛ AK b AG e AK s AH
huweteng	h AA u AM ɛ AK t AC ɛ AK ŋ AF
huy	h AA u AM j AB
huyad	h AA u AM j AB a AK d AC
huyong	h AA u AM j AB o AM ŋ AF
hwan	h AA w AI ɐ AM n AF
ibagsak	i AK b AG a AK ɡ AC s AH a AK k AC
ibahaw	i AK b AG a AK h AA a AK w AI
ibalik	i AK b AG a AK l AD i AK k AC
ibasco	ʔ AJ i AK b AG a AK s AH k AC o AM
ibay	ʔ AJ i AK b AG a AK j AB
ibili	i AK b AG i AK l AD i AK
ibutod	i AK b AG u AM t AC o AM d AC
idalum	ʔ AJ i AK d AC a AK l AD u AM m AE
igib	ʔ AJ i AK ɡ AC i AK b AG
igkasin	ʔ AJ i AK ɡ AC k AC a AK s AH i AK n AF
ignacio	ʔ AJ i AK ɡ AC n AF a AK s AH j AB o AM
ignoransiya	ʔ AJ i AK ɡ AC n AF o AM ɾ BD a AK n AF s AH j AB a AK
ignorante	ʔ AJ i AK ɡ AC n AF o AM ɾ BD a AK n AF t AC ɛ AK
ihi	ʔ AJ i AK h AA i AK ʔ AJ
ikabilanggo	ʔ AJ i AK k AC a AK b AG i AK l AD a AK ŋ AF ɡ AC o AM ʔ AJ
ikagalit	ʔ AJ i AK k AC a AK ɡ AC a AK l AD i AK t AC
ikaw	i AK k AC a AK w AI
ikmo	i AK k AC m AE o AM
ikuha	i AK k AC u AM h AA a AK
ilag	ʔ AJ i AK l AD a AK ɡ AC
ilao	ʔ AJ i AK l AD a AK u AM
iling	ʔ AJ i AK l AD i AK ŋ AF
ilog	ʔ AJ i AK l AD o AM ɡ AC
ilong	ʔ AJ i AK l AD o AM ŋ AF
ilustre	ʔ AJ i AK l AD u AM s AH t AC ɾ BD ɛ AK
imahen	ʔ AJ i AK m AE a AK h AA ɛ AK n AF
imbentaryo	ʔ AJ i AK m AE b AG ɛ AK n AF t AC a AK ɾ BD j AB o AM
imperial	ʔ AJ i AK m AE p AG ɛ AK ɾ BD j AB a AK l AD
impluwensiya	ʔ AJ i AK m AE p AG l AD u AM ɛ AK n AF s AH j AB a AK
importansiya	ʔ AJ i AK m AE p AG o AM ɾ BD t AC a AK n AF s AH j AB a AK
importante	ʔ AJ i AK m AE p AG o AM ɾ BD t AC a AK n AF t AC ɛ AK
ina	ʔ AJ i AK n AF a AK
inahin	ʔ AJ i AK n AF a AK h AA i AK n AF
infante	ʔ AJ i AK n AF p AG a AK n AF t AC ɛ AK
ingay	ʔ AJ i AK ŋ AF a AK i AK
inggit	ʔ AJ i AK ŋ AF ɡ AC i AK t AC
inggitero	ʔ AJ i AK ŋ AF ɡ AC i AK t AC ɛ AK ɾ BD o AM
inggles	i AK ŋ AF ɡ AC l AD ɛ AK s AH
inggo	ʔ AJ i AK ŋ AF ɡ AC o AM ʔ AJ
inglesero	i AK ŋ AF ɡ AC l AD ɛ AK s AH ɛː AL ɾ BD ɔ AM
ingrato	ʔ AJ i AK ŋ AF ɡ AC ɾ BD a AK t AC o AM
inip	ʔ AJ i AK n AF i AK p AG
init	ʔ AJ i AK n AF i AK t AC
initan	ʔ AJ i AK n AF i AK t AC a AK n AF
initbutod	ʔ AJ i AK n AF i AK t AC b AG u AM t AC ɔ AM d AC
initdagitban	ʔ AJ i AK n AF i AK t AC d AC a AK ɡ AC i AK t AC b AG a AK n AF
initkapnayan	ʔ AJ i AK n AF i AK t AC k AC a AK p AG n AF a AK j AB a AK n AF
initsigan	ʔ AJ i AK n AF i AK t AC s AH i AK ɡ AC a AK n AF
inosente	ʔ AJ i AK n AF o AM s AH ɛ AK n AF t AC ɛ AK
insulto	ʔ AJ i AK n AF s AH u AM l AD t AC o AM
interbiyu	ʔ AJ i AK n AF t AC ɛ AK ɾ BD b AG i AK u AM
interes	ʔ AJ i AK n AF t AC ɛ AK ɾ BD ɛ AK s AH
intindi	ʔ AJ i AK n AF t AC i AK n AF d AC i AK
intsik	ʔ AJ i AK n AF t AC ʃ AH i AK k AC
inumin	ʔ AJ i AK n AF u AM m AE i AK n AF
inutil	ʔ AJ i AK n AF u AM t AC i AK l AD
inyo	i AK n AF j AB o AM
ip	ɪ AK p AG
ipagbilin	ʔ AJ i AK p AG a AK ɡ AC b AG i AK l AD i AK n AF
ipakausap	i AK p AG a AK k AC a AK u AM s AH a AK p AG
ipakuha	i AK p AG a AK k AC u AM h AA a AK
ipamigay	ʔ AJ i AK p AG a AK m AE i AK ɡ AC a AK i AK
ipatapon	i AK p AG a AK t AC a AK p AG o AM n AF
ipis	ʔ AJ i AK p AG i AK s AH
ipo	ʔ AJ i AK p AG o AM
iprint	i AK p AG r BA i AK n AF t AC
irebisa	ʔ AJ i AK ɾ BD ɛ AK b AG i AK s AH a AK
isa	ʔ AJ i AK s AH a AK
isagani	ʔ AJ i AK s AH a AK ɡ AC a AK n AF i AK
isangkot	ʔ AJ i AK s AH a AK ŋ AF k AC o AM t AC
isauli	i AK s AH a AK u AM l AD i AK
iscan	i AK s AH k AC a AK n AF
iset	i AK s AH ɛ AK t AC
ishinare	ʔ AJ i AK s AH h AA i AK n AF ɛ AK ɾ BD
isidro	ʔ AJ i AK s AH i AK d AC ɾ BD o AM
isigan	i AK s AH i AK ɡ AC a AK n AF
isipin	ʔ AJ i AK s AH i AK p AG i AK n AF
isisi	ʔ AJ i AK s AH i AK s AH i AK
iskedyul	ʔ AJ i AK s AH k AC ɛ AK d AC j AB u AM l AD
iskolar	ʔ AJ i AK s AH k AC o AM l AD a AK ɾ BD
iskrip	ʔ AJ i AK s AH k AC ɾ BD i AK p AG
isoli	i AK s AH o AM l AD i AK
istorya	ʔ AJ i AK s AH t AC o AM ɾ BD j AB a AK
isuot	ʔ AJ i AK s AH u AM ʔ AJ ɔ AM t AC
itago	i AK t AC a AK ɡ AC o AM
itim	ɪ AK t AC i AK m AE
itlog	ʔ AJ i AK t AC l AD o AM ɡ AC
itmo	i AK t AC m AE o AM
ito	ʔ AJ i AK t AC o AM
ixerox	i AK s AH ɛ AK r BA o AM k AC s AH
iyan	j AB a AK n AF
iyo	i AK j AB o AM
iyon	j AB o AM n AF
jalandoni	d AC ʒ AH a AK l AD a AK n AF d AC o AM n AF i AK
jamisola	d AC ʒ AH a AK m AE i AK s AH o AM l AD a AK
jara	d AC ʒ AH a AK ɾ BD a AK
jaramillo	d AC ʒ AH a AK ɾ BD a AK m AE i AK l AD l AD o AM
jaranilla	d AC ʒ AH a AK ɾ BD a AK n AF i AK l AD l AD a AK
jologs	d AC ʒ AH o AM l AD o AM ɡ AC z AH
jontis	d AC ʒ AH ɔ AM n AF t AC i AK s AH
juan	h AA w AI ɐ AM n AF
juarez	d AC ʒ AH u AM a AK ɾ BD ɛ AK s AH
julalay	d AC ʒ AH u AM l AD a AK l AD a AK j AB
jumarang	d AC ʒ AH u AM m AE a AK ɾ BD a AK ŋ AF
juntilla	d AC ʒ AH u AM n AF t AC i AK l AD l AD a AK
jurado	d AC ʒ AH u AM ɾ BD a AK d AC o AM
jusi	d AC ʒ AH u AM s AH i AK
justiniano	d AC ʒ AH u AM s AH t AC i AK n AF i AK a AK n AF o AM
kaagulo	k AC a AK a AK ɡ AC u AM l AD ɔ AM ʔ AJ
kaalit	k AC a AK ʔ AJ a AK l AD i AK t AC
kaanak	k AC a AK ʔ AJ a AK n AF a AK k AC
kaanib	k AC a AK ʔ AJ a AK n AF i AK b AG
kababaihan	k AC a AK b AG a AK b AG a AK ʔ AJ i AK h AA a AK n AF
kabaligtaran	k AC a AK b AG a AK l AD i AK ɡ AC t AC a AK ɾ BD a AK n AF
kabalintunaan	k AC a AK b AG a AK l AD i AK n AF t AC u AM n AF a AK ʔ AJ a AK n AF
kabaong	k AC a AK b AG a AK o AM ŋ AF
kabarkada	k AC a AK b AG a AK r BA k AC a AK d AC a AK
kabasangal	k AC a AK b AG a AK s AH a AK ŋ AF a AK l AD
kabastusan	k AC a AK b AG a AK s AH t AC u AM s AH a AK n AF
kabayo	k AC a AK b AG a AK j AB o AM
kaberdehan	k AC a AK b AG ɛ AK ɾ BD d AC ɛ AK h AA a AK n AF
kabig	k AC a AK b AG i AK ɡ AC
kabiling	k AC a AK b AG i AK l AD i AK ŋ AF
kabuwanan	k AC a AK b AG u AM a AK n AF a AK n AF
kadena	k AC a AK d AC ɛ AK n AF a AK
kadugo	k AC a AK d AC u AM ɡ AC o AM ʔ AJ
kadyos	k AC a AK d AC j AB o AM s AH
kadyot	k AC ɑ AK d AC ʑ AH ɔ AM t̚
kagalingan	k AC a AK ɡ AC a AK l AD i AK ŋ AF a AK n AF
kagaw	k AC a AK ɡ AC a AK u AM
kaha	k AC a AK h AA a AK
kahabagan	k AC a AK h AA a AK b AG a AK ɡ AC a AK n AF
kahandaan	k AC a AK h AA a AK n AF d AC a AK ʔ AJ a AK n AF
kaharian	k AC a AK h AA a AK ɾ BD i AK a AK n AF
kahel	k AC ɐ AM h AA ɛ AK l AD
kahero	k AC a AK h AA ɛ AK ɾ BD o AM
kahihiyan	k AC a AK h AA i AK h AA i AK a AK n AF
kahoy	k AC a AK h AA o AM i AK
kaibigan	k AC a AK ʔ AJ i AK b AG i AK ɡ AC a AK n AF
kailan	k AC ɛ AK l AD a AK n AF
kain	k AC a AK ʔ AJ i AK n AF
kakainin	k AC a AK k AC a AK ʔ AJ i AK n AF i AK n AF
kakaphay	k AC a AK k AC a AK p AG h AA a AK j AB
kakarampot	k AC a AK k AC a AK ɾ BD a AK m AE p AG o AM t AC
kakayahan	k AC a AK k AC ɐ AM y AM ɐ AM h AA a AK n AF
kakulangan	k AC a AK k AC u AM l AD a AK ŋ AF a AK n AF
kakulawas	k AC a AK k AC u AM l AD a AK w AI a AK s AH
kalaguyo	k AC a AK l AD a AK ɡ AC u AM j AB o AM ʔ AJ
kalakpan	k AC a AK l AD a AK k AC p AG a AK n AF
kalaliman	k AC a AK l AD a AK l AD i AK m AE a AK n AF
kalan	k AC a AK l AD a AK n AF
kalansay	k AC a AK l AD a AK n AF s AH a AK j AB
kalantas	k AC a AK l AD a AK n AF t AC a AK s AH
kalaswaan	k AC a AK l AD a AK s AH w AI a AK ʔ AJ a AK n AF
kalat	k AC a AK l AD a AK t AC
kalatas	k AC a AK l AD a AK t AC a AK s AH
kalatsutsi	k AC a AK l AD a AK t AC ʃ AH u AM t AC ʃ AH i AK ʔ AJ
kalawang	k AC a AK l AD a AK w AI a AK ŋ AF
kalawangin	k AC a AK l AD a AK w AI a AK ŋ AF i AK n AF
kalayaan	k AC a AK l AD ɐ AM i AK ɪ AK a AK ʔ AJ ɐ AM n AF
kalbaryo	k AC a AK l AD b AG a AK ɾ BD j AB o AM
kaldero	k AC a AK l AD d AC ɛ AK ɾ BD o AM
kalendaryo	k AC a AK l AD ɛ AK n AF d AC a AK ɾ BD j AB o AM
kalesa	k AC ɐ AM l AD ɛː AL s AH a AK
kalibre	k AC a AK l AD i AK b AG ɾ BD ɛ AK
kalibugan	k AC a AK l AD i AK b AG u AM ɡ AC a AK n AF
kalidad	k AC a AK l AD i AK d AC a AK d AC
kaligayahan	k AC a AK l AD i AK ɡ AC a AK j AB a AK h AA a AK n AF
kaligkig	k AC a AK l AD i AK ɡ AC k AC i AK ɡ AC
kalihim	k AC a AK l AD i AK h AA i AK m AE
kalima	k AC a AK l AD i AK m AE a AK
kalis	k AC a AK l AD i AK s AH
kaliskis	k AC a AK l AD i AK s AH k AC i AK s AH
kaliwanagan	k AC a AK l AD i AK w AI a AK n AF a AK ɡ AC a AK n AF
kaliwete	k AC a AK l AD i AK w AI ɛ AK t AC ɛ AK
kalso	k AC a AK l AD s AH o AM
kaluban	k AC ɐ AM l AD u AM b AG ɐ AM n AF
kalungsuran	k AC a AK l AD u AM ŋ AF s AH u AM ɾ BD a AK n AF
kaluwalhatian	k AC a AK l AD u AM l AD u AM a AK l AD h AA a AK t AC i AK ʔ AJ a AK n AF
kalyo	k AC a AK l AD j AB o AM
kamanahan	k AC a AK m AE a AK n AF a AK h AA a AK n AF
kamandag	k AC a AK m AE a AK n AF d AC a AK ɡ AC
kamangmangan	k AC a AK m AE a AK ŋ AF m AE a AK ŋ AF a AK n AF
kamatayan	k AC a AK m AE a AK t AC a AK j AB a AK n AF
kambal	k AC a AK m AE b AG a AK l AD
kambyo	k AC a AK m AE b AG j AB o AM
kami	k AC a AK m AE ɪ AK
kamihasnan	k AC a AK m AE i AK h AA a AK s AH n AF a AK n AF
kampana	k AC a AK m AE p AG a AK n AF a AK ʔ AJ
kampante	k AC a AK m AE p AG a AK n AF t AC ɛ AK
kampanya	k AC a AK m AE p AG a AK n AF j AB a AK
kampyon	k AC a AK m AE p AG j AB o AM n AF
kamukha	k AC a AK m AE u AM k AC h AA a AK ʔ AJ
kamunduhan	k AC a AK m AE u AM n AF d AC u AM h AA a AK n AF
kandidato	k AC a AK n AF d AC i AK d AC a AK t AC o AM
kandila	k AC a AK n AF d AC i AK l AD a AK ʔ AJ
kanduli	k AC a AK n AF d AC u AM l AD i AK ʔ AJ
kang	k AC a AK ŋ AF
kangkungan	k AC a AK ŋ AF k AC u AM ŋ AF a AK n AF
kanina	k AC a AK n AF i AK n AF a AK
kanino	k AC a AK n AF i AK n AF o AM
kaniyugan	k AC a AK n AF j AB u AM ɡ AC a AK n AF
kanlong	k AC a AK n AF l AD o AM ŋ AF
kanlungan	k AC a AK n AF l AD u AM ŋ AF a AK n AF
kanselasyon	k AC a AK n AF s AH ɛ AK l AD a AK s AH j AB o AM n AF
kanser	k AC a AK n AF s AH ɛ AK ɾ BD
kanta	k AC a AK n AF t AC a AK
kantahin	k AC a AK n AF t AC a AK h AA i AK n AF
kantutin	k AC a AK n AF t AC u AM t AC i AK n AF
kanyon	k AC a AK ɲ AF o AM n AF
kaopisina	k AC a AK o AM p AG i AK s AH i AK n AF a AK
kapabayaan	k AC a AK p AG a AK b AG a AK j AB a AK a AK n AF
kapakanan	k AC a AK p AG a AK k AC a AK n AF ʔ AJ a AK n AF
kapalit	k AC a AK p AG a AK l AD i AK t AC
kapanahunan	k AC a AK p AG a AK n AF a AK h AA u AM n AF a AK n AF
kapatawaran	k AC a AK p AG a AK t AC a AK w AI a AK ɾ BD a AK n AF
kaphay	k AC a AK p AG h AA a AK j AB
kapid	k AC a AK p AG i AK d AC
kapiraso	k AC a AK p AG i AK ɾ BD a AK s AH o AM
kapitan	k AC a AK p AG i AK t AC a AK n AF
kaplastikan	k AC a AK p AG l AD a AK s AH t AC i AK k AC a AK n AF
kapon	k AC a AK p AG o AM n AF
kapotgayong	k AC a AK p AG o AM t AC ɡ AC a AK j AB o AM ŋ AF
kapre	k AC a AK p AG ɾ BD ɛ AK
kapuluan	k AC a AK p AG u AM l AD u AM a AK n AF
kaputsino	k AC a AK p AG u AM t AC ʃ AH i AK n AF o AM
karakter	k AC a AK ɾ BD a AK k AC t AC ɛ AK ɾ BD
karambola	k AC a AK ɾ BD a AK m AE b AG o AM l AD a AK
karamihan	k AC a AK ɾ BD a AK m AE i AK h AA a AK n AF
karampatan	k AC a AK ɾ BD a AK m AE p AG a AK t AC a AK n AF
karapatan	k AC a AK ɾ BD a AK p AG a AK t AC a AK n AF
karayom	k AC a AK ɾ BD a AK j AB o AM m AE
karbon	k AC a AK ɾ BD b AG o AM n AF
karelyebo	k AC a AK r BA ɛ AK ʎ AD ɛ AK b AG o AM
karerahan	k AC a AK ɾ BD ɛ AK ɾ BD a AK h AA a AK n AF
karibal	k AC a AK ɾ BD i AK b AG a AK l AD
karitela	k AC a AK ɾ BD i AK t AC ɛ AK l AD a AK
kariton	k AC a AK ɾ BD i AK t AC o AM n AF
karo	k AC a AK ɾ BD o AM
karpintero	k AC a AK ɾ BD p AG i AK n AF t AC ɛ AK ɾ BD o AM
karton	k AC a AK ɾ BD t AC o AM n AF
karunungan	k AC a AK ɾ BD u AM n AF u AM ŋ AF a AK n AF
karupukan	k AC a AK ɾ BD u AM p AG u AM k AC a AK n AF
karuwagan	k AC a AK ɾ BD u AM a AK ɡ AC a AK n AF
kasalanan	k AC a AK s AH a AK l AD a AK n AF a AK n AF
kasambahay	k AC a AK s AH a AK m AE b AG a AK h AA a AK i AK
kasera	k AC a AK s AH ɛ AK ɾ BD a AK
kasero	k AC a AK s AH ɛ AK ɾ BD o AM
kaserola	k AC a AK s AH ɛ AK ɾ BD o AM l AD a AK
kasiguraduhan	k AC a AK s AH i AK ɡ AC u AM ɾ BD a AK d AC u AM h AA a AK n AF
kasintahan	k AC a AK s AH i AK n AF t AC a AK h AA a AK n AF
kasinungalingan	k AC a AK s AH i AK n AF u AM ŋ AF a AK l AD i AK ŋ AF a AK n AF
kaso	k AC a AK s AH ɔ AM
kasoy	k AC a AK s AH o AM i AK
kastigo	k AC a AK s AH t AC i AK ɡ AC o AM
kastiguhin	k AC a AK s AH t AC i AK ɡ AC u AM h AA i AK n AF
kasubha	k AC a AK s AH u AM b AG h AA a AK ʔ AJ
kata	k AC a AK t AC a AK ʔ AJ
kataga	k AC a AK t AC a AK ɡ AC a AK ʔ AJ
katagalugan	k AC a AK t AC a AK ɡ AC a AK l AD u AM ɡ AC a AK n AF
katakawan	k AC a AK t AC a AK k AC a AK w AI a AK n AF
katang	k AC a AK t AC a AK ŋ AF
katangahan	k AC a AK t AC a AK ŋ AF a AK h AA a AK n AF
katarata	k AC a AK t AC a AK ɾ BD a AK t AC a AK
katawan	k AC a AK t AC a AK w AI a AK n AF
katedral	k AC a AK t AC ɛ AK d AC ɾ BD a AK l AD
kati	k AC ɐ AM t AC i AK ʔ AJ
katigbak	k AC a AK t AC i AK ɡ AC b AG a AK k AC
katiwalian	k AC a AK t AC i AK w AI a AK l AD i AK a AK n AF
kato	k AC a AK t AC o AM ʔ AJ
katolisismo	k AC a AK t AC o AM l AD i AK s AH i AK s AH m AE o AM
katropa	k AC a AK t AC r BA o AM p AG a AK
katungkulan	k AC a AK t AC u AM ŋ AF k AC u AM l AD a AK n AF
katuruan	k AC a AK t AC u AM r BA u AM ʔ AJ a AK n AF
katuwang	k AC a AK t AC u AM a AK ŋ AF
kaunti	k AC ɔ AM n AF t AC ɛ AK ʔ AJ
kausap	k AC a AK u AM s AH a AK p AG
kausapin	k AC a AK u AM s AH a AK p AG i AK n AF
kawad	k AC a AK w AI a AK d AC
kay	k AC a AK i AK
kaya	k AC aː AL ɪ AK a AK
kayumanggi	k AC a AK j AB u AM m AE a AK ŋ AF ɡ AC i AK
kelot	k AC ɛ AK l AD ɔ AM t AC
kendi	k AC ɛ AK n AF d AC i AK
keri	k AC ɛ AK ɾ BD i AK
ketongin	k AC ɛ AK t AC o AM ŋ AF i AK n AF
khoo	k AC uː AN
kiamzon	k AC i AK a AK m AE s AH o AM n AF
kidsulid	k AC i AK d AC s AH u AM l AD i AK d AC
kikil	k AC i AK k AC i AK l AD
kiko	k AC i AK k AC o AM ʔ AJ
kilay	k AC i AK l AD a AK j AB
kilikili	k AC i AK l AD i AK k AC i AK l AD i AK
kilo	k AC i AK l AD o AM ʔ AJ
kilos	k AC i AK l AD o AM s AH
kilusan	k AC i AK l AD u AM s AH a AK n AF
kimika	k AC i AK m AE ɪ AK k AC ɐ AM
kindat	k AC i AK n AF ʔ AJ d AC a AK t AC
king	k AC i AK ŋ AF
kintsay	k AC i AK n AF t AC ʃ AH a AK i AK
kita	k AC i AK t AC a AK
kitikiti	k AC i AK t AC i AK k AC i AK t AC i AK
kiyo	k AC i AK j AB o AM ʔ AJ
klima	k AC l AD i AK m AE a AK
klinika	k AC l AD i AK n AF i AK k AC a AK
kloropila	k AC l AD o AM r BA o AM p AG i AK l AD ɐ AM
ko	k AC ɔ AM
kolera	k AC o AM l AD ɛ AK ɾ BD a AK
komander	k AC o AM m AE a AK n AF d AC ɛ AK ɾ BD
kombinasyon	k AC o AM m AE b AG i AK n AF a AK s AH j AB o AM n AF
komedya	k AC o AM m AE ɛ AK d AC j AB a AK
komento	k AC o AM m AE ɛ AK n AF t AC o AM
kometa	k AC o AM m AE ɛ AK t AC a AK
kompleto	k AC o AM m AE p AG l AD ɛ AK t AC o AM
komplikasyon	k AC o AM m AE p AG l AD i AK k AC a AK s AH j AB o AM n AF
komunidad	k AC o AM m AE u AM n AF i AK d AC a AK d AC
komunikasyon	k AC o AM m AE u AM n AF i AK k AC a AK s AH j AB o AM n AF
komunista	k AC o AM m AE u AM n AF i AK s AH t AC ɐ AM
kondenahin	k AC o AM n AF d AC ɛ AK n AF a AK h AA i AK n AF
kondisyon	k AC o AM n AF d AC i AK s AH j AB o AM n AF
kong	k AC ɔ AM ŋ AF
konstitusyon	k AC o AM n AF s AH t AC i AK t AC u AM s AH j AB o AM n AF
konsumisyon	k AC o AM n AF s AH u AM m AE i AK s AH j AB o AM n AF
kontak	k AC o AM n AF t AC a AK k AC
kontakin	k AC o AM n AF t AC a AK k AC i AK n AF
kontrobersiya	k AC o AM n AF t AC ɾ BD o AM b AG ɛ AK ɾ BD s AH j AB a AK
koral	k AC o AM ɾ BD a AK l AD
korona	k AC o AM ɾ BD o AM n AF a AK
koronahan	k AC o AM ɾ BD o AM n AF a AK h AA a AK n AF
koronel	k AC o AM ɾ BD o AM n AF ɛ AK l AD
kotse	k AC o AM t AC ʃ AH ɛ AK
krimen	k AC ɾ BD i AK m AE ɛ AK n AF
kriminal	k AC ɾ BD i AK m AE i AK n AF a AK l AD
kritiko	k AC ɾ BD i AK t AC i AK k AC o AM
kromatina	k AC r BA o AM m AE ɐ AM t AC i AK n AF ɐ AM
kromosoma	k AC r BA o AM m AE o AM s AH o AM m AE ɐ AM
kroni	k AC ɾ BD o AM n AF i AK
kroniyismo	k AC ɾ BD o AM n AF i AK j AB i AK s AH m AE o AM
kua	k AC w AI a AK
kuba	k AC u AM b AG a AK ʔ AJ
kubeta	k AC u AM b AG ɛ AK t AC a AK
kubo	k AC u AM b AG o AM
kudkurin	k AC u AM d AC k AC u AM ɾ BD i AK n AF
kuha	k AC u AM h AA a AK
kulambo	k AC u AM l AD a AK m AE b AG o AM ʔ AJ
kulangi	k AC u AM l AD a AK ŋ AF i AK ʔ AJ
kulangot	k AC u AM l AD a AK ŋ AF o AM t AC
kulasim	k AC u AM l AD a AK s AH i AK m AE
kulay	k AC u AM l AD a AK j AB
kulayin	k AC u AM l AD a AK j AB i AK n AF
kulaylawas	k AC u AM l AD a AK j AB l AD a AK w AI a AK s AH
kulayputol	k AC u AM l AD a AK j AB p AG u AM t AC o AM l AD
kulig	k AC u AM l AD i AK ɡ AC
kulimlim	k AC u AM l AD i AK m AE l AD i AK m AE
kuliti	k AC u AM l AD i AK t AC i AK ʔ AJ
kulos	k AC u AM l AD o AM s AH
kulugo	k AC u AM l AD u AM ɡ AC o AM
kumabig	k AC u AM m AE a AK b AG i AK ɡ AC
kumain	k AC u AM m AE a AK ʔ AJ i AK n AF
kumanta	k AC u AM m AE a AK n AF t AC a AK
kumbensiyon	k AC u AM m AE b AG ɛ AK n AF s AH i AK o AM n AF
kumbento	k AC u AM m AE b AG ɛ AK n AF t AC o AM
kumbinsihin	k AC u AM m AE b AG i AK n AF s AH i AK h AA i AK n AF
kumbulsiyon	k AC u AM m AE b AG u AM l AD s AH i AK o AM n AF
kumintab	k AC u AM m AE i AK n AF t AC a AK b AG
kumot	k AC u AM m AE o AM t AC
kumpas	k AC u AM m AE p AG a AK s AH
kumpederasyon	k AC u AM m AE p AG ɛ AK d AC ɛ AK ɾ BD a AK s AH j AB o AM n AF
kumpisal	k AC u AM m AE p AG i AK s AH a AK l AD
kumpyansa	k AC u AM m AE p AG j AB a AK n AF s AH a AK
kumuha	k AC u AM m AE u AM h AA a AK
kumulimlim	k AC u AM m AE u AM l AD i AK m AE l AD i AK m AE
kumunoy	k AC u AM m AE u AM n AF o AM i AK
kumupas	k AC u AM m AE u AM p AG a AK s AH
kumusta	k AC u AM m AE u AM s AH t AC a AK
kumuyakoy	k AC u AM m AE u AM j AB a AK k AC o AM i AK
kunan	k AC u AM n AF a AK n AF
kunin	k AC u AM n AF i AK n AF
kupal	k AC uː AN p AG a AK l AD
kupas	k AC u AM p AG a AK s AH
kurag	k AC u AM ɾ BD a AK ɡ AC
kurarap	k AC u AM ɾ BD a AK ɾ BD a AK p AG
kurba	k AC u AM ɾ BD b AG a AK
kurbata	k AC u AM ɾ BD b AG a AK t AC a AK
kurot	k AC u AM ɾ BD o AM t AC
kurse	k AC u AM ɾ BD s AH e AK
kursonada	k AC u AM ɾ BD s AH o AM n AF a AK d AC a AK
kurtina	k AC u AM ɾ BD t AC i AK n AF a AK
kuryusidad	k AC u AM r BA j AB u AM s AH i AK d AC a AK d AC
kusi	k AC u AM s AH i AK
kusina	k AC u AM s AH i AK n AF a AK
kuskos	k AC u AM s AH k AC o AM s AH
kustodiya	k AC u AM s AH t AC o AM d AC i AK a AK
kuting	k AC u AM t AC i AK ŋ AF
kutis	k AC u AM t AC i AK s AH
kuto	k AC u AM t AC o AM ʔ AJ
kutsara	k AC u AM t AC ʃ AH a AK ɾ BD a AK
kutsarita	k AC u AM t AC ʃ AH a AK r BA i AK t AC a AK
kutson	k AC u AM t AC ʃ AH o AM n AF
kutya	k AC u AM t AC j AB a AK ʔ AJ
kuwan	k AC u AM a AK n AF
kwok	k AC w AI ɔ AM k AC
kyut	k AC j AB u AM t AC
laba	l AD a AK b AG a AK
labada	l AD a AK b AG a AK d AC a AK
labag	l AD a AK b AG a AK ɡ AC
labas	l AD a AK b AG a AK s AH
labaskaphay	l AD a AK b AG a AK s AH k AC a AK p AG h AA a AK j AB
labastida	l AD a AK b AG a AK s AH t AC i AK d AC a AK
labawsugnayan	l AD a AK b AG a AK u AM s AH u AM ɡ AC n AF a AK j AB a AK n AF
labhan	l AD a AK b AG h AA a AK n AF
labi	l AD a AK b AG i AK ʔ AJ
labimpito	l AD a AK b AG i AK m AE p AG i AK t AC o AM
labindalawa	l AD a AK b AG i AK n AF d AC a AK l AD a AK w AI a AK
labingwalo	l AD a AK b AG i AK ŋ AF w AI a AK l AD o AM
labinlima	l AD a AK b AG i AK n AF l AD i AK m AE a AK
labinsiyam	l AD a AK b AG i AK n AF s AH i AK j AB a AK m AE
labintatlo	l AD a AK b AG i AK n AF t AC a AK t AC l AD o AM
labnot	l AD a AK b AG n AF o AM t AC
labong	l AD a AK b AG o AM ŋ AF
lacambra	l AD a AK k AC a AK m AE b AG ɾ BD a AK
lacap	l AD a AK k AC a AK p AG
laganap	l AD a AK ɡ AC a AK n AF a AK p AG
lagay	l AD a AK ɡ AC a AK i AK
lagaylay	l AD a AK ɡ AC a AK j AB l AD a AK j AB
lagda	l AD a AK ɡ AC d AC a AK ʔ AJ
lagdameo	l AD a AK ɡ AC d AC a AK m AE ɛ AK o AM
lagkit	l AD a AK ɡ AC k AC i AK t AC
lagmak	l AD a AK ɡ AC m AE a AK k AC
lagmay	l AD a AK ɡ AC m AE a AK i AK
lagnat	l AD a AK ɡ AC n AF a AK t AC
lagumlalangin	l AD a AK ɡ AC u AM m AE l AD a AK l AD a AK ŋ AF i AK n AF
lagundi	l AD a AK ɡ AC u AM n AF d AC i AK
lahat	l AD a AK h AA a AK t AC
laitin	l AD a AK i AK t AC i AK n AF
lakan	l AD a AK k AC a AK n AF
lakdawkaphay	l AD a AK k AC d AC a AK w AI k AC a AK p AG h AA a AK j AB
lakdawyugto	l AD a AK k AC d AC a AK w AI j AB u AM ɡ AC t AC o AM ʔ AJ
laktaw	l AD a AK k AC t AC a AK w AI
lalagyan	l AD a AK l AD a AK ɡ AC j AB a AK n AF
lalamunan	l AD a AK l AD a AK m AE u AM n AF a AK n AF
lalanghutan	l AD a AK l AD a AK ŋ AF h AA u AM t AC a AK n AF
lamad	l AD a AK m AE a AK d AC
lamang	l AD a AK m AE a AK ŋ AF
lamig	l AD a AK m AE ʔ AJ i AK ɡ AC
lampara	l AD a AK m AE p AG a AK ɾ BD a AK
lampin	l AD a AK m AE p AG i AK n AF
lana	l AD a AK n AF a AK
landa	l AD a AK n AF d AC a AK
landrito	l AD a AK n AF d AC ɾ BD i AK t AC o AM
lang	l AD a AK ŋ AF
langkaan	l AD a AK ŋ AF k AC a AK ʔ AJ a AK n AF
lansangan	l AD a AK n AF s AH a AK ŋ AF a AK n AF
lanting	l AD a AK n AF t AC i AK ŋ AF
lantsa	l AD a AK n AF t AC ʃ AH a AK
lanunab	l AD a AK n AF u AM n AF a AK b AG
lanuza	l AD a AK n AF u AM s AH a AK
lao	l AD a AK ʊ AM
lapis	l AD a AK p AG i AK s AH
lapnos	l AD a AK p AG n AF o AM s AH
lapuz	l AD a AK p AG u AM s AH
laquindanum	l AD a AK k AC i AK n AF d AC a AK n AF u AM m AE
larawan	l AD a AK ɾ BD a AK w AI a AK n AF
lascano	l AD a AK s AH k AC a AK n AF o AM
lasing	l AD a AK s AH i AK ŋ AF
laspag	l AD a AK s AH p AG a AK ɡ AC
lastiko	l AD a AK s AH t AC i AK k AC o AM
laswa	l AD a AK s AH w AI a AK ʔ AJ
latayan	l AD a AK t AC a AK j AB a AK n AF
lawa	l AD a AK w AI a AK ʔ AJ
lawaan	l AD a AK w AI a AK ʔ AJ a AK n AF
laway	l AD a AK w AI a AK i AK
lawlaw	l AD a AK u AM l AD a AK u AM
laxamana	l AD a AK k AC s AH a AK m AE a AK n AF a AK
layag	l AD a AK j AB a AK ɡ AC
layas	l AD a AK j AB a AK s AH
layaw	l AD ɐ AM j AB a AK w AI
laygo	l AD a AK i AK ɡ AC o AM
laylayan	l AD a AK i AK l AD a AK j AB a AK n AF
laylo	l AD a AK i AK l AD o AM
layno	l AD a AK i AK n AF o AM
lazarte	l AD a AK s AH a AK ɾ BD t AC ɛ AK
lazatin	l AD a AK s AH a AK t AC i AK n AF
lebadura	l AD e AK b AG a AK d AC u AM r BA ɐ AM
lehitimo	l AD ɛ AK h AA i AK t AC i AK m AE o AM
lengguwahe	l AD ɛ AK ŋ AF ɡ AC w AI a AK h AA ɛ AK
leong	l AD j AB o AM ŋ AF
leung	l AD j AB u AM ŋ AF
lew	l AD ʊ AM
leynes	l AD ɛ AK i AK n AF ɛ AK s AH
libak	l AD i AK b AG a AK k AC
libradilla	l AD i AK b AG ɾ BD a AK d AC i AK l AD l AD a AK
libre	l AD i AK b AG ɾ BD ɛ AK
libro	l AD i AK b AG r BA o AM
libuntaon	l AD i AK b AG u AM n AF t AC a AK ʔ AJ ɔ AM n AF
lichauco	l AD i AK t AC ʃ AH a AK u AM k AC o AM
licup	l AD i AK k AC u AM p AG
ligpit	l AD i AK ɡ AC p AG i AK t AC
liha	l AD i AK h AA a AK
liham	l AD i AK h AA a AK m AE
lihim	l AD i AK h AA i AK m AE
lihukan	l AD i AK h AA u AM k AC a AK n AF
likas	l AD i AK k AC a AK s AH
likha	l AD i AK k AC h AA a AK ʔ AJ
liknayan	l AD i AK k AC n AF a AK j AB a AK n AF
liko	l AD i AK k AC o AM ʔ AJ
lila	l AD ɪː AL l AD ɐ AM
lilom	l AD i AK l AD o AM m AE
lim	l AD i AK m AE
lima	l AD i AK m AE a AK
limahi	l AD i AK m AE a AK h AA i AK ʔ AJ
limahid	l AD i AK m AE a AK h AA i AK d AC
limampu	l AD i AK m AE a AK m AE p AG u AM ʔ AJ
limandaan	l AD i AK m AE a AK n AF d AC a AK a AK n AF
limanlaksa	l AD i AK m AE a AK n AF l AD a AK k AC s AH a AK ʔ AJ
limay	l AD i AK m AE a AK j AB
limbaga	l AD i AK m AE b AG a AK ɡ AC a AK
limit	l AD i AK m AE i AK t AC
limjoco	l AD i AK m AE d AC ʒ AH o AM k AC o AM
limos	l AD i AK m AE o AM s AH
linatoc	l AD i AK n AF a AK t AC o AM k AC
lindol	l AD i AK n AF d AC ɔ AM l AD
lingad	l AD i AK ŋ AF a AK d AC
linggo	l AD i AK ŋ AF ɡ AC ɔ AM
lingon	l AD i AK ŋ AF o AM n AF
linisan	l AD i AK n AF i AK s AH a AK n AF
linisin	l AD i AK n AF i AK s AH i AK n AF
linta	l AD i AK n AF t AC a AK ʔ AJ
liong	l AD j AB o AM ŋ AF
lipon	l AD i AK p AG o AM n AF
lipunan	l AD i AK p AG u AM n AF a AK n AF
liquigan	l AD i AK k AC i AK ɡ AC a AK n AF
lising	l AD i AK s AH i AK ŋ AF
lislis	l AD i AK s AH l AD i AK s AH
liso	l AD i AK s AH o AM
literasiya	l AD i AK t AC ɛ AK ɾ BD a AK s AH i AK a AK
litrato	l AD i AK t AC ɾ BD a AK t AC o AM
liwag	l AD i AK w AI a AK ɡ AC
lizada	l AD i AK s AH a AK d AC a AK
llanera	l AD l AD a AK n AF ɛ AK ɾ BD a AK
llanto	l AD l AD a AK n AF t AC o AM
lo	l AD o AM
lodi	l AD o AM d AC i AK
logarta	l AD o AM ɡ AC a AK ɾ BD t AC a AK
lojo	l AD o AM d AC ʒ AH o AM
loka	l AD o AM k AC a AK
loko	l AD o AM k AC o AM
lola	l AD o AM l AD a AK
lomibao	l AD o AM m AE i AK b AG a AK u AM
lomocso	l AD o AM m AE o AM k AC s AH o AM
lona	l AD o AM n AF a AK
longganisa	l AD o AM ŋ AF ɡ AC a AK n AF i AK s AH a AK
longhitud	l AD o AM ŋ AF h AA i AK t AC u AM d AC
loo	l AD u AM
loob	l AD ɔ AM ʔ AJ ɔ AM b AG
loobkaphay	l AD o AM ʔ AJ o AM b AG k AC a AK p AG h AA a AK j AB
look	l AD o AM ʔ AJ o AM k AC
lorenzana	l AD o AM ɾ BD ɛ AK n AF s AH a AK n AF a AK
loterya	l AD o AM t AC ɛ AK ɾ BD j AB a AK
lozada	l AD o AM s AH a AK d AC a AK
lu	l AD u AM
lubak	l AD u AM b AG a AK k AC
lubha	l AD u AM b AG h AA a AK ʔ AJ
lubiano	l AD u AM b AG j AB a AK n AF o AM
lugami	l AD u AM ɡ AC a AK m AE i AK ʔ AJ
luho	l AD u AM h AA o AM ʔ AJ
lukban	l AD u AM k AC b AG a AK n AF
lula	l AD u AM l AD a AK ʔ AJ
luma	l AD u AM m AE a AK ʔ AJ
lumabas	l AD u AM m AE a AK b AG a AK s AH
lumabo	l AD u AM m AE a AK b AG o AM ʔ AJ
lumad	l AD u AM m AE a AK d AC
lumagui	l AD u AM m AE a AK ɡ AC i AK
lumakdang	l AD u AM m AE a AK k AC d AC a AK ŋ AF
lumamig	l AD u AM m AE a AK m AE i AK ɡ AC
lumanglas	l AD u AM m AE a AK ŋ AF l AD a AK s AH
lumangoy	l AD u AM m AE a AK ŋ AF o AM j AB
lumapit	l AD u AM m AE a AK p AG i AK t AC
lumayo	l AD u AM m AE a AK j AB o AM ʔ AJ
lumbang	l AD u AM m AE b AG a AK ŋ AF
lumbao	l AD u AM m AE b AG a AK u AM
lumbo	l AD u AM m AE b AG ɔ AM ʔ AJ
lumboy	l AD u AM m AE b AG ɔ AM j AB
lumibao	l AD u AM m AE i AK b AG a AK u AM
lumikha	l AD u AM m AE i AK k AC h AA a AK ʔ AJ
luminaw	l AD u AM m AE i AK n AF a AK w AI
lumindol	l AD u AM m AE i AK n AF d AC o AM l AD
lumipad	l AD u AM m AE i AK p AG a AK d AC
lumiwanag	l AD u AM m AE i AK w AI a AK n AF a AK ɡ AC
lumot	l AD u AM m AE o AM t AC
lumutang	l AD u AM m AE u AM t AC a AK ŋ AF
lumuwag	l AD u AM m AE u AM w AI a AK ɡ AC
lunes	l AD u AM n AF ɛ AK s AH
lungkag	l AD u AM ŋ AF k AC a AK ɡ AC
luntian	l AD u AM nː BC t AC i AK ɐ AM n AF
lupa	l AD u AM p AG a AK ʔ AJ
lupain	l AD u AM p AG a AK ʔ AJ i AK n AF
lusaw	l AD u AM s AH a AK w AI
luto	l AD u AM t AC o AM ʔ AJ
luwag	l AD u AM a AK ɡ AC
luwalhati	l AD u AM w AI a AK l AD h AA a AK t AC i AK ʔ AJ
luwat	l AD u AM w AI a AK t AC
luy	l AD ʊ AM j AB
luyos	l AD u AM j AB o AM s AH
luzano	l AD u AM s AH a AK n AF o AM
luzon	l AD u AM s AH o AM n AF
luzuriaga	l AD u AM s AH u AM ɾ BD j AB a AK ɡ AC a AK
maagrabyado	m AE a AK ʔ AJ a AK ʔ AJ ɡ AC ɾ BD a AK b AG j AB a AK d AC o AM
maambunan	m AE a AK ʕ AH a AK m AE b AG u AM n AF a AK n AF
maanak	m AE a AK ʔ AJ a AK n AF a AK k AC
maangas	m AE a AK ʔ AJ a AK ŋ AF a AK s AH
maanta	m AE a AK ʔ AJ a AK n AF t AC a AK
mababa	m AE a AK b AG a AK b AG a AK ʔ AJ
mabagal	m AE a AK b AG a AK ɡ AC a AK l AD
mabalot	m AE a AK b AG a AK l AD o AM t AC
mabato	m AE a AK b AG a AK t AC o AM
mabigat	m AE a AK b AG i AK ɡ AC a AK t AC
mabigo	m AE a AK b AG i AK ɡ AC o AM ʔ AJ
mabilis	m AE a AK b AG i AK l AD i AK s AH
mabini	m AE a AK b AG i AK n AF i AK
mabuhay	m AE a AK b AG u AM h AA a AK y AM
mabulaklak	m AE a AK b AG u AM l AD a AK k AC l AD a AK k AC
maburyong	m AE a AK b AG u AM ɾ BD j AB o AM ŋ AF
mabuti	m AE a AK b AG u AM t AC i AK
mabuwisit	m AE a AK b AG u AM i AK s AH i AK t AC
macababbad	m AE a AK k AC a AK b AG a AK b AG b AG a AK d AC
macadangdang	m AE a AK k AC a AK d AC a AK ŋ AF d AC a AK ŋ AF
macalalad	m AE a AK k AC a AK l AD a AK l AD a AK d AC
macalindong	m AE a AK k AC a AK l AD i AK n AF d AC o AM ŋ AF
macapagal	m AE a AK k AC a AK p AG a AK ɡ AC a AK l AD
macapinlac	m AE a AK k AC a AK p AG i AK n AF l AD a AK k AC
macapugay	m AE a AK k AC a AK p AG u AM ɡ AC a AK i AK
macaranas	m AE a AK k AC a AK ɾ BD a AK n AF a AK s AH
macasaet	m AE a AK k AC a AK s AH a AK ɛ AK t AC
macasieb	m AE a AK k AC a AK s AH i AK ɛ AK b AG
macaspac	m AE a AK k AC a AK s AH p AG a AK k AC
macatulad	m AE a AK k AC a AK t AC u AM l AD a AK d AC
maceda	m AE a AK s AH ɛ AK d AC a AK
macuha	m AE a AK k AC u AM h AA a AK
madalas	m AE a AK d AC a AK l AD a AK s AH
madali	m AE a AK d AC a AK l AD i AK ʔ AJ
madilim	m AE a AK d AC i AK l AD i AK m AE
madlangbayan	m AE a AK d AC l AD a AK ŋ AF b AG a AK j AB a AK n AF
madriaga	m AE a AK d AC ɾ BD i AK a AK ɡ AC a AK
madulas	m AE a AK d AC u AM l AD a AK s AH
magalang	m AE a AK ɡ AC a AK l AD a AK ŋ AF
magaling	m AE a AK ɡ AC a AK l AD i AK ŋ AF
magallanes	m AE a AK ɡ AC a AK l AD l AD a AK n AF ɛ AK s AH
magalona	m AE a AK ɡ AC a AK l AD o AM n AF a AK
maganda	m AE a AK ɡ AC a AK n AF d AC a AK
magandahan	m AE a AK ɡ AC a AK n AF d AC a AK h AA a AK n AF
magaso	m AE a AK ɡ AC a AK s AH o AM
magbabaon	n AF a AK ɡ AC b AG a AK ʔ AJ o AM n AF
magbalik	m AE a AK ɡ AC b AG a AK l AD i AK k AC
magbanua	m AE a AK ɡ AC b AG a AK n AF u AM a AK
magbaon	m AE a AK ɡ AC b AG a AK ʔ AJ o AM n AF
magbarena	m AE a AK ɡ AC b AG a AK ɾ BD ɛ AK n AF a AK
magbasanlot	m AE a AK ɡ AC b AG a AK s AH a AK n AF l AD ɔ AM t AC
magbayad	m AE a AK ɡ AC b AG a AK j AB a AK d AC
magbenta	m AE a AK ɡ AC b AG e AK n AF t AC a AK
magbihis	m AE a AK ɡ AC b AG i AK h AA i AK s AH
magbili	m AE a AK ɡ AC b AG i AK l AD i AK
magbinata	m AE a AK ɡ AC b AG i AK n AF a AK t AC a AK ʔ AJ
magbiro	m AE a AK ɡ AC b AG i AK ɾ BD o AM ʔ AJ
magbisikleta	m AE a AK ɡ AC b AG i AK s AH i AK k AC l AD ɛ AK t AC a AK
magbiyahe	m AE a AK ɡ AC b AG i AK j AB a AK h AA e AK
magboo	m AE a AK ɡ AC b AG o AM o AM
magbubukid	m AE a AK ɡ AC b AG u AM b AG u AM k AC i AK d AC
magbuhat	m AE a AK ɡ AC b AG u AM h AA a AK t AC
magbulakbol	m AE a AK ɡ AC b AG u AM l AD a AK k AC b AG o AM l AD
magdalaga	m AE a AK ɡ AC d AC a AK l AD a AK ɡ AC a AK
magdasal	m AE a AK ɡ AC d AC a AK s AH a AK l AD
magdayao	m AE a AK ɡ AC d AC a AK j AB a AK u AM
magdeliryo	m AE a AK ɡ AC d AC ɛ AK l AD i AK ɾ BD j AB o AM
magdemanda	m AE a AK ɡ AC d AC ɛ AK m AE a AK n AF d AC a AK
maggayat	m AE a AK ɡ AC ɡ AC a AK j AB a AK t AC
maghabilin	m AE a AK ɡ AC h AA a AK b AG i AK l AD i AK n AF
maghabla	m AE a AK ɡ AC h AA a AK b AG l AD a AK
maghanap	m AE a AK ɡ AC h AA a AK n AF a AK p AG
maghanapbuhay	m AE a AK ɡ AC h AA a AK n AF a AK p AG b AG u AM h AA a AK i AK
maghanda	m AE a AK ɡ AC h AA a AK n AF d AC a AK ʔ AJ
maghangad	m AE a AK ɡ AC h AA a AK ŋ AF a AK d AC
maghari	m AE a AK ɡ AC h AA a AK ɾ BD i AK ʔ AJ
maghasik	m AE a AK ɡ AC h AA a AK s AH i AK k AC
maghati	m AE a AK ɡ AC h AA a AK t AC i AK ʔ AJ
maghiganti	m AE a AK ɡ AC h AA i AK ɡ AC a AK n AF t AC i AK
maghikab	m AE a AK ɡ AC h AA i AK k AC a AK b AG
maghikaw	m AE a AK ɡ AC h AA i AK k AC a AK u AM
maghilamos	m AE a AK ɡ AC h AA i AK l AD a AK m AE o AM s AH
maghilik	m AE a AK ɡ AC h AA i AK l AD i AK k AC
maghimagsik	m AE a AK ɡ AC h AA i AK m AE a AK ɡ AC s AH i AK k AC
maghimutok	m AE a AK ɡ AC h AA i AK m AE u AM t AC o AM k AC
maghinala	m AE a AK ɡ AC h AA i AK n AF a AK l AD a AK ʔ AJ
maghingalo	m AE a AK ɡ AC h AA i AK ŋ AF a AK l AD o AM
maghintay	m AE a AK ɡ AC h AA i AK n AF t AC a AK j AB
maghinto	m AE a AK ɡ AC h AA i AK n AF t AC o AM ʔ AJ
maghinuha	m AE a AK ɡ AC h AA i AK n AF u AM h AA a AK ʔ AJ
maghirang	m AE a AK ɡ AC h AA i AK ɾ BD a AK ŋ AF
maghirap	m AE a AK ɡ AC h AA i AK ɾ BD a AK p AG
maghiyas	m AE a AK ɡ AC h AA i AK a AK s AH
maghugas	m AE a AK ɡ AC h AA u AM ɡ AC a AK s AH
maghumpay	m AE a AK ɡ AC h AA u AM m AE p AG a AK i AK
maghuramentado	m AE a AK ɡ AC h AA u AM ɾ BD a AK m AE ɛ AK n AF t AC a AK d AC o AM
magigi	m AE a AK ɡ AC i AK ɡ AC i AK ʔ AJ
magiting	m AE a AK ɡ AC i AK t AC i AK ŋ AF
magjeep	m AE a AK ɡ AC d AC ʒ AH i AK p AG
magkanlong	m AE a AK ɡ AC k AC a AK n AF l AD o AM ŋ AF
magkaroon	m AE a AK ɡ AC k AC a AK r BA o AM ʔ AJ o AM n AF
magkasakit	m AE a AK ɡ AC k AC a AK s AH a AK k AC i AK t AC
magkataon	m AE a AK ɡ AC k AC a AK t AC a AK ʔ AJ o AM n AF
magkausap	m AE a AK ɡ AC k AC a AK u AM s AH a AK p AG
maglaba	m AE a AK ɡ AC l AD a AK b AG a AK
maglabas	m AE a AK ɡ AC l AD a AK b AG a AK s AH
maglakbay	m AE a AK ɡ AC l AD a AK k AC b AG a AK j AB
maglalang	m AE a AK ɡ AC l AD a AK l AD a AK ŋ AF
maglanggas	m AE a AK ɡ AC l AD a AK ŋ AF ɡ AC a AK s AH
maglangib	m AE a AK ɡ AC l AD a AK ŋ AF i AK b AG
maglango	m AE a AK ɡ AC l AD a AK ŋ AF o AM
maglantod	m AE a AK ɡ AC l AD a AK n AF t AC o AM d AC
maglapa	m AE a AK ɡ AC l AD a AK p AG a AK ʔ AJ
maglarawan	m AE a AK ɡ AC l AD a AK ɾ BD a AK w AI a AK n AF
maglaro	m AE a AK ɡ AC l AD a AK ɾ BD o AM ʔ AJ
maglaso	m AE a AK ɡ AC l AD a AK s AH o AM
maglaway	m AE a AK ɡ AC l AD a AK w AI a AK i AK
maglingid	m AE a AK ɡ AC l AD i AK ŋ AF i AK d AC
maglingkod	m AE a AK ɡ AC l AD i AK ŋ AF k AC o AM d AC
maglola	m AE a AK ɡ AC l AD o AM l AD a AK
maglolo	m AE a AK ɡ AC l AD o AM l AD o AM
magmadali	m AE a AK ɡ AC m AE a AK d AC a AK l AD i AK ʔ AJ
magmahal	m AE a AK ɡ AC m AE a AK h AA a AK l AD
magmaliw	m AE a AK ɡ AC m AE a AK l AD i AK u AM
magmartsa	m AE a AK ɡ AC m AE a AK ɾ BD t AC ʃ AH a AK
magmasahe	m AE a AK ɡ AC m AE a AK s AH a AK h AA e AK
magmayabang	m AE a AK ɡ AC m AE a AK j AB a AK b AG a AK ŋ AF
magnakaw	m AE a AK ɡ AC n AF a AK k AC a AK u AM
magno	m AE a AK ɡ AC n AF o AM
magpalaganap	m AE a AK ɡ AC p AG a AK l AD a AK ɡ AC a AK n AF a AK p AG
magpanatili	m AE a AK ɡ AC p AG a AK n AF a AK t AC i AK l AD i AK
magparaya	m AE a AK ɡ AC p AG a AK ɾ BD a AK j AB a AK ʔ AJ
magpasubasta	m AE a AK ɡ AC p AG a AK s AH u AM b AG a AK s AH t AC a AK
magpaubaya	m AE a AK ɡ AC p AG a AK ʔ AJ u AM b AG a AK j AB a AK ʔ AJ
magpraktis	m AE a AK ɡ AC p AG ɾ BD a AK k AC t AC i AK s AH
magpunas	m AE a AK ɡ AC p AG u AM n AF a AK s AH
magrenta	m AE a AK ɡ AC ɾ BD ɛ AK n AF t AC a AK
magresign	m AE a AK ɡ AC ɾ BD e AK s AH a AK ɪ AK n AF
magsahig	m AE a AK ɡ AC s AH a AK h AA i AK ɡ AC
magsalang	m AE a AK ɡ AC s AH a AK l AD a AK ŋ AF
magsaliksik	m AE a AK ɡ AC s AH a AK l AD i AK k AC s AH i AK k AC
magsapatos	m AE a AK ɡ AC s AH a AK p AG a AK t AC o AM s AH
magsimba	m AE a AK ɡ AC s AH i AK m AE b AG a AK
magsinungaling	m AE a AK ɡ AC s AH i AK n AF u AM ŋ AF a AK l AD i AK ŋ AF
magsiwalat	m AE a AK ɡ AC s AH i AK w AI a AK l AD a AK t AC
magstay	m AE a AK ɡ AC s AH t AC ɛ AK ɪ AK
magsubscribe	m AE a AK ɡ AC s AH u AM b AG s AH k AC ɾ BD a AK ɪ AK b AG
magsugal	m AE a AK ɡ AC s AH u AM ɡ AC a AK l AD
magsuntukan	m AE a AK ɡ AC s AH u AM n AF t AC u AM k AC a AK n AF
magtaas	m AE a AK ɡ AC t AC a AK a AK s AH
magtaban	m AE a AK ɡ AC t AC a AK b AG a AK n AF
magtalas	m AE a AK ɡ AC t AC a AK l AD a AK s AH
magtalo	m AE a AK ɡ AC t AC a AK l AD o AM
magtapon	m AE a AK ɡ AC t AC a AK p AG o AM n AF
magtinda	m AE a AK ɡ AC t AC i AK n AF d AC a AK
magtipid	m AE a AK ɡ AC t AC i AK p AG i AK d AC
magtrabaho	m AE a AK ɡ AC t AC ɾ BD a AK b AG a AK h AA o AM
magtrycicle	m AE a AK ɡ AC t AC ɾ BD a AK ɪ AK s AH i AK k AC ɛ AK l AD
magturo	m AE a AK ɡ AC t AC u AM ɾ BD o AM ʔ AJ
magugol	m AE a AK ɡ AC u AM ɡ AC o AM l AD
magulo	m AE a AK ɡ AC u AM l AD o AM
magusot	m AE a AK ɡ AC u AM s AH o AM t AC
magustuhan	m AE a AK ɡ AC u AM s AH t AC u AM h AA a AK n AF
magwagi	m AE a AK ɡ AC w AI a AK ɡ AC i AK
magwahil	m AE a AK ɡ AC w AI a AK h AA i AK l AD
magwisik	m AE a AK ɡ AC w AI i AK s AH i AK k AC
magyabang	m AE a AK ɡ AC j AB a AK b AG a AK ŋ AF
magyangyang	m AE a AK ɡ AC j AB a AK ŋ AF j AB a AK ŋ AF
magyasyas	m AE a AK ɡ AC j AB a AK s AH j AB a AK s AH
magyaya	m AE a AK ɡ AC j AB a AK j AB a AK
magyibok	m AE a AK ɡ AC j AB i AK b AG o AM k AC
mahal	m AE a AK h AA a AK l AD
mahalaga	m AE a AK h AA a AK l AD a AK ɡ AC a AK
mahiman	m AE a AK h AA i AK m AE a AK n AF
mahinay	m AE a AK h AA i AK n AF a AK i AK
mahirap	m AE a AK h AA i AK ɾ BD a AK p AG
mahuli	m AE aː AL h AA u AM l AD i AK
maikli	m AE a AK ʔ AJ i AK k AC l AD i AK ʔ AJ
maingay	m AE a AK ʔ AJ i AK ŋ AF a AK i AK
mainis	m AE a AK ʔ AJ i AK n AF i AK s AH
makaitlo	m AE a AK k AC a AK i AK t AC l AD o AM
makakita	m AE a AK k AC a AK k AC i AK t AC a AK
makakuha	m AE a AK k AC a AK k AC u AM h AA a AK
makalat	m AE a AK k AC a AK l AD a AK t AC
makalima	m AE a AK k AC a AK l AD i AK m AE a AK
makaluma	m AE a AK k AC a AK l AD u AM m AE a AK ʔ AJ
makapuno	m AE a AK k AC a AK p AG u AM n AF o AM ʔ AJ
makati	m AE ɐ AM k AC ɐ AM t AC i AK ʔ AJ
makatotohanan	m AE a AK k AC a AK t AC o AM t AC o AM h AA a AK n AF a AK n AF
makatulog	m AE a AK k AC a AK t AC u AM l AD o AM ɡ AC
makiapid	m AE a AK k AC i AK ʔ AJ a AK p AG i AK d AC
makibahagi	m AE a AK k AC i AK b AG a AK h AA a AK ɡ AC i AK ʔ AJ
makina	m AE a AK k AC i AK n AF a AK
makinis	m AE a AK k AC i AK n AF i AK s AH
makipagbati	m AE a AK k AC i AK p AG a AK ɡ AC b AG a AK t AC i AK ʔ AJ
makipagkaibigan	m AE a AK k AC i AK p AG a AK ɡ AC k AC a AK i AK b AG i AK ɡ AC a AK n AF
makipagsuntukan	m AE a AK k AC i AK p AG a AK ɡ AC s AH u AM n AF t AC u AM k AC a AK n AF
makipagtalik	m AE a AK k AC i AK p AG a AK ɡ AC t AC a AK l AD i AK k AC
makontento	m AE a AK k AC o AM n AF t AC ɛ AK n AF t AC o AM
makuha	m AE a AK k AC u AM h AA a AK
makulimlim	m AE a AK k AC u AM l AD i AK m AE l AD i AK m AE
makunan	m AE a AK k AC u AM n AF a AK n AF
malabuyoc	m AE a AK l AD a AK b AG u AM j AB o AM k AC
malagata	m AE a AK l AD a AK ɡ AC a AK t AC a AK ʔ AJ
malagatas	m AE a AK l AD a AK ɡ AC a AK t AC a AK s AH
malagkit	m AE a AK l AD a AK ɡ AC k AC i AK t AC
malakanyang	m AE a AK l AD a AK k AC a AK n AF j AB a AK ŋ AF
malalim	m AE a AK l AD a AK l AD i AK m AE
malaluan	m AE a AK l AD a AK l AD u AM a AK n AF
malaman	m AE a AK l AD a AK m AE a AK n AF
malambot	m AE a AK l AD a AK m AE b AG o AM t AC
malanasi	m AE a AK l AD a AK n AF a AK s AH i AK ʔ AJ
malanya	m AE a AK l AD a AK n AF j AB a AK ʔ AJ
malaon	m AE a AK l AD a AK ʔ AJ o AM n AF
malapad	m AE a AK l AD a AK p AG a AK d AC
malapit	m AE a AK l AD a AK p AG i AK t AC
malapot	m AE a AK l AD a AK p AG o AM t AC
malas	m AE a AK l AD a AK s AH
malaswa	m AE a AK l AD a AK s AH w AI a AK ʔ AJ
malaya	m AE ɐ AM l AD aː AL ɪ AK a AK
malibag	m AE a AK l AD i AK b AG a AK ɡ AC
malibiran	m AE a AK l AD i AK b AG i AK ɾ BD a AK n AF
malicsi	m AE a AK l AD i AK k AC s AH i AK
maligaw	m AE a AK l AD i AK ɡ AC a AK u AM
malihan	m AE a AK l AD i AK h AA a AK n AF
malikhain	m AE a AK l AD i AK k AC h AA a AK ʔ AJ i AK n AF
maliksi	m AE a AK l AD i AK k AC s AH i AK
malilom	m AE a AK l AD i AK l AD o AM m AE
malimit	m AE a AK l AD i AK m AE i AK t AC
mallare	m AE a AK l AD l AD a AK ɾ BD ɛ AK
mallorca	m AE a AK l AD l AD o AM ɾ BD k AC a AK
malubak	m AE a AK l AD u AM b AG a AK k AC
malusog	m AE a AK l AD u AM s AH o AM ɡ AC
maluwat	m AE a AK l AD u AM w AI a AK t AC
mama	m AE a AK m AE a AK ʔ AJ
mamagitan	m AE a AK m AE a AK ɡ AC i AK t AC a AK n AF
mamahagi	m AE a AK m AE a AK h AA a AK ɡ AC i AK ʔ AJ
mamakyaw	m AE a AK m AE a AK k AC j AB a AK u AM
mamanhikan	m AE a AK m AE a AK n AF h AA i AK k AC a AK n AF
mamaril	m AE a AK m AE a AK ɾ BD i AK l AD
mamasada	m AE a AK m AE a AK s AH a AK d AC a AK
mamasura	m AE a AK m AE a AK s AH u AM ɾ BD a AK
mamatay	m AE a AK m AE a AK t AC a AK j AB
mambabae	m AE a AK m AE b AG a AK b AG a AK ʔ AJ ɛ AK
mambola	m AE a AK m AE b AG o AM l AD a AK
mamboso	m AE a AK m AE b AG o AM s AH o AM
mambugaw	m AE a AK m AE b AG u AM ɡ AC a AK u AM
mambuwisit	m AE a AK m AE b AG u AM i AK s AH i AK t AC
mamigay	m AE a AK m AE i AK ɡ AC a AK i AK
mamihasa	m AE a AK m AE i AK h AA a AK s AH a AK ʔ AJ
mamilis	m AE a AK m AE i AK l AD i AK s AH
mamimili	m AE a AK m AE i AK m AE i AK l AD i AK
mamintog	m AE a AK m AE i AK n AF t AC o AM ɡ AC
mamuhunan	m AE a AK m AE u AM h AA u AM n AF a AK n AF
mamulaklak	m AE a AK m AE u AM l AD a AK k AC l AD a AK k AC
mamuti	m AE a AK m AE u AM t AC i AK ʔ AJ
mamuyac	m AE a AK m AE u AM j AB a AK k AC
man	m AE a AK n AF
mana	m AE a AK n AF a AK
manabat	m AE a AK n AF a AK b AG a AK t AC
manabunot	m AE a AK n AF a AK b AG u AM n AF o AM t AC
managinip	m AE a AK n AF a AK ɡ AC i AK n AF i AK p AG
manakit	m AE a AK n AF a AK k AC i AK t AC
manalad	m AE a AK n AF a AK l AD a AK d AC
manalo	m AE a AK n AF a AK l AD o AM
manaloto	m AE a AK n AF a AK l AD o AM t AC o AM
manamantala	m AE a AK n AF a AK m AE a AK n AF t AC a AK l AD a AK
mananahi	m AE a AK n AF a AK n AF a AK h AA i AK ʔ AJ
manananggal	m AE a AK n AF a AK n AF a AK ŋ AF ɡ AC a AK l AD
manangan	m AE a AK n AF a AK ŋ AF a AK n AF
mananghalian	m AE a AK n AF a AK ŋ AF h AA a AK l AD i AK ʔ AJ a AK n AF
mananquil	m AE a AK n AF a AK n AF k AC i AK l AD
manantan	m AE a AK n AF a AK n AF t AC a AK n AF
manaog	m AE a AK n AF a AK o AM ɡ AC
manaois	m AE a AK n AF a AK o AM i AK s AH
manarang	m AE a AK n AF a AK ɾ BD a AK ŋ AF
manatad	m AE a AK n AF a AK t AC a AK d AC
mancao	m AE a AK ŋ AF k AC a AK u AM
mandaragat	m AE a AK n AF d AC a AK ɾ BD a AK ɡ AC a AK t AC
mandirigma	m AE a AK n AF d AC i AK ɾ BD i AK ɡ AC m AE a AK ʔ AJ
mandocdoc	m AE a AK n AF d AC o AM k AC d AC o AM k AC
mandukot	m AE a AK n AF d AC u AM k AC o AM t AC
mandurukot	m AE a AK n AF d AC u AM ɾ BD u AM k AC o AM t AC
mangagat	m AE a AK ŋ AF a AK ɡ AC a AK t AC
mangailangan	m AE a AK ŋ AF a AK ʔ AJ i AK l AD a AK ŋ AF a AK n AF
mangalunya	m AE a AK ŋ AF a AK l AD u AM n AF j AB a AK ʔ AJ
mangamba	m AE a AK ŋ AF a AK m AE b AG a AK
mangamote	m AE a AK ŋ AF a AK m AE o AM t AC ɛ AK
manganak	m AE a AK ŋ AF a AK n AF a AK k AC
mangaoang	m AE a AK ŋ AF a AK w AI a AK ŋ AF
mangaway	m AE a AK ŋ AF a AK w AI a AK i AK
manggagantso	m AE a AK ŋ AF ɡ AC a AK ɡ AC a AK n AF t AC ʃ AH o AM
manggantso	m AE a AK ŋ AF ɡ AC a AK n AF t AC ʃ AH o AM
manggas	m AE a AK ŋ AF ɡ AC a AK s AH
manggulo	m AE a AK ŋ AF ɡ AC u AM l AD o AM
manghawa	m AE a AK ŋ AF h AA a AK w AI a AK
manghimasok	m AE a AK ŋ AF h AA i AK m AE a AK s AH o AM k AC
manghuhula	m AE a AK ŋ AF h AA u AM h AA u AM l AD a AK ʔ AJ
manghula	m AE a AK ŋ AF h AA u AM l AD a AK ʔ AJ
manghusga	m AE a AK ŋ AF h AA u AM s AH ɡ AC a AK
mangikil	m AE a AK ŋ AF i AK k AC i AK l AD
mangilit	m AE a AK ŋ AF i AK l AD i AK t AC
mangingisda	m AE a AK ŋ AF i AK ŋ AF i AK s AH d AC a AK ʔ AJ
mangisay	m AE a AK ŋ AF i AK s AH a AK i AK
mangisda	m AE a AK ŋ AF i AK s AH d AC a AK ʔ AJ
mangitlog	m AE a AK ŋ AF i AK t AC l AD o AM ɡ AC
mangkok	m AE a AK ŋ AF k AC o AM k AC
manglicmot	m AE a AK ŋ AF l AD i AK k AC m AE o AM t AC
mangoba	m AE a AK ŋ AF o AM b AG a AK
mangopya	m AE a AK ŋ AF o AM p AG j AB a AK
mangubra	m AE a AK ŋ AF u AM b AG ɾ BD a AK
manguha	m AE a AK ŋ AF u AM h AA a AK
manguiat	m AE a AK ŋ AF i AK a AK t AC
mangulabnan	m AE a AK ŋ AF u AM l AD a AK b AG n AF a AK n AF
mangulangot	m AE a AK ŋ AF u AM l AD a AK ŋ AF o AM t AC
mangupit	m AE a AK ŋ AF u AM p AG i AK t AC
mangwika	m AE a AK ŋ AF w AI i AK k AC a AK ʔ AJ
mangyari	m AE a AK ŋ AF j AB a AK ɾ BD i AK
manhid	m AE a AK n AF h AA i AK d AC
maniago	m AE a AK n AF i AK a AK ɡ AC o AM
maniego	m AE a AK n AF j AB ɛ AK ɡ AC o AM
manilaw	m AE a AK n AF i AK l AD a AK u AM
manilip	m AE a AK n AF i AK l AD i AK p AG
manindigan	m AE a AK n AF i AK n AF d AC i AK ɡ AC a AK n AF
maniquiz	m AE a AK n AF i AK k AC i AK s AH
manlaban	m AE a AK n AF l AD a AK b AG a AK n AF
manlait	m AE a AK n AF l AD a AK ʔ AJ i AK t AC
manlangit	m AE a AK n AF l AD a AK ŋ AF i AK t AC
manlapaz	m AE a AK n AF l AD a AK p AG a AK s AH
manlapig	m AE a AK n AF l AD a AK p AG i AK ɡ AC
manlililok	m AE a AK n AF l AD i AK l AD i AK l AD o AM k AC
manloko	m AE a AK n AF l AD o AM k AC o AM
manlutac	m AE a AK n AF l AD u AM t AC a AK k AC
manood	m AE a AK n AF o AM o AM d AC
manoy	m AE a AK n AF o AM j AB
manrique	m AE a AK n AF ɾ BD i AK k AC ɛ AK
mansiyon	m AE a AK n AF s AH j AB o AM n AF
mansusugnay	m AE a AK n AF s AH u AM s AH u AM ɡ AC n AF a AK j AB
mantika	m AE a AK n AF t AC i AK k AC a AK ʔ AJ
manuhol	m AE a AK n AF u AM h AA o AM l AD
manuntok	m AE a AK n AF u AM n AF t AC o AM k AC
mapagkawanggawa	m AE a AK p AG a AK ɡ AC k AC a AK w AI a AK ŋ AF ɡ AC a AK w AI a AK ʔ AJ
mapagmatyag	m AE a AK p AG a AK ɡ AC m AE a AK t AC j AB a AK ɡ AC
mapagsamantala	m AE a AK p AG a AK ɡ AC s AH a AK m AE a AK n AF t AC a AK l AD a AK
mapahiya	m AE a AK p AG a AK h AA i AK j AB a AK ʔ AJ
mapalad	m AE a AK p AG a AK l AD a AK d AC
mapanghusga	m AE a AK p AG a AK ŋ AF h AA u AM s AH ɡ AC a AK
mapangutya	m AE a AK p AG a AK ŋ AF u AM t AC j AB a AK ʔ AJ
mapaniil	m AE a AK p AG a AK n AF i AK i AK l AD
mapatay	m AE a AK p AG a AK t AC a AK j AB
mapua	m AE ɐ AM p AG ʊ AM w AI a AK
mapusyaw	m AE ɐ AM p AG ʊ AM s AH j AB ɐ AM u AM
maputik	m AE a AK p AG u AM t AC i AK k AC
maralit	m AE a AK ɾ BD a AK l AD i AK t AC
marapao	m AE a AK ɾ BD a AK p AG a AK o AM
maravilla	m AE a AK ɾ BD a AK b AG i AK l AD l AD a AK
marbella	m AE a AK ɾ BD b AG ɛ AK l AD l AD a AK
marcial	m AE a AK ɾ BD s AH j AB a AK l AD
marikit	m AE a AK ɾ BD i AK k AC i AK t AC
maristela	m AE a AK ɾ BD i AK s AH t AC ɛ AK l AD a AK
mariñas	m AE a AK ɾ BD i AK ɲ AF a AK s AH
marquez	m AE a AK ɾ BD k AC ɛ AK s AH
marquinez	m AE a AK ɾ BD k AC i AK n AF ɛ AK s AH
marso	m AE a AK ɾ BD s AH o AM
marupok	m AE a AK ɾ BD u AM p AG o AM k AC
masabon	m AE a AK s AH a AK b AG o AM n AF
masaker	m AE a AK s AH a AK k AC ɛ AK ɾ BD
masakit	m AE a AK s AH a AK k AC i AK t AC
masaktan	m AE a AK s AH a AK k AC t AC a AK n AF
masamain	m AE a AK s AH a AK m AE a AK i AK n AF
masamid	m AE a AK s AH a AK m AE i AK d AC
masangcay	m AE a AK s AH a AK ŋ AF k AC a AK i AK
masangkay	m AE a AK s AH a AK ŋ AF k AC a AK i AK
masaya	m AE a AK s AH a AK j AB a AK
maselan	m AE a AK s AH ɛ AK l AD a AK n AF
masikhay	m AE a AK s AH i AK k AC h AA a AK j AB
masikip	m AE a AK s AH i AK k AC i AK p AG
masipag	m AE a AK s AH i AK p AG a AK ɡ AC
maski	m AE a AK s AH k AC i AK
masukal	m AE a AK s AH u AM k AC a AK l AD
masurot	m AE a AK s AH u AM ɾ BD o AM t AC
mataasnakahoy	m AE a AK t AC a AK ʔ AJ a AK s AH n AF a AK k AC a AK h AA o AM i AK
matae	m AE a AK t AC a AK ʔ AJ ɛ AK
matalino	m AE a AK t AC a AK l AD i AK n AF o AM
matalo	m AE a AK t AC a AK l AD o AM
matapang	m AE a AK t AC a AK p AG a AK ŋ AF
matapon	m AE a AK t AC a AK p AG o AM n AF
matatakutin	m AE a AK t AC a AK t AC a AK k AC u AM t AC i AK n AF
matauhan	m AE a AK t AC a AK ʔ AJ u AM h AA a AK n AF
matibag	m AE a AK t AC i AK b AG a AK ɡ AC
matigas	m AE a AK t AC i AK ɡ AC a AK s AH
matisod	m AE a AK t AC i AK s AH o AM d AC
matrapik	m AE a AK t AC ɾ BD a AK p AG i AK k AC
matris	m AE a AK t AC ɾ BD i AK s AH
matso	m AE ɑ AK t AC ʃ AH o AM
matulin	m AE a AK t AC u AM l AD i AK n AF
matulog	m AE a AK t AC u AM l AD o AM ɡ AC
matwiran	m AE a AK t AC w AI i AK ɾ BD a AK n AF
maulanan	m AE a AK u AM l AD a AK n AF a AK n AF
mauleon	m AE a AK u AM l AD ɛ AK o AM n AF
maunahan	m AE a AK u AM n AF a AK h AA a AK n AF
mawo	m AE a AK w AI o AM ʔ AJ
maya	m AE a AK j AB a AK
maybahay	m AE a AK i AK b AG a AK h AA a AK i AK
maynila	m AE a AK j AB n AF i AK l AD a AK ʔ AJ
mayuga	m AE a AK j AB u AM ɡ AC a AK
mañago	m AE a AK ɲ AF a AK ɡ AC o AM
mañalac	m AE a AK ɲ AF a AK l AD a AK k AC
medalya	m AE ɛ AK d AC a AK l AD j AB a AK
medrano	m AE ɛ AK d AC ɾ BD a AK n AF o AM
medyor	m AE ɛ AK d AC ʒ AH o AM ɾ BD
melegrito	m AE ɛ AK l AD ɛ AK ɡ AC ɾ BD i AK t AC o AM
menchavez	m AE ɛ AK n AF t AC ʃ AH a AK b AG ɛ AK s AH
menorca	m AE ɛ AK n AF o AM ɾ BD k AC a AK
mensahe	m AE ɛ AK n AF s AH a AK h AA ɛ AK
merienda	m AE ɛ AK ɾ BD j AB ɛ AK n AF d AC a AK
meryenda	m AE ɛ AK ɾ BD j AB ɛ AK n AF d AC a AK
mesa	m AE ɛ AK s AH a AK
mga	m AE ɐ AM ŋ AF a AK
michelena	m AE i AK t AC ʃ AH ɛ AK l AD ɛ AK n AF a AK
mijares	m AE i AK d AC ʒ AH a AK ɾ BD ɛ AK s AH
miksipat	m AE i AK k AC s AH i AK p AG a AK t AC
militante	m AE i AK l AD i AK t AC a AK n AF t AC ɛ AK
minviluz	m AE i AK n AF b AG i AK l AD u AM s AH
miranda	m AE i AK ɾ BD a AK n AF d AC a AK
misay	m AE i AK s AH a AK j AB
mismo	m AE ɪ AK s AH m AE ɔ AM
misteryo	m AE i AK s AH t AC ɛ AK ɾ BD j AB o AM
mitsa	m AE i AK t AC ʃ AH a AK
miyentras	m AE i AK j AB e AK n AF t AC r BA a AK s AH
mo	m AE o AM
mohon	m AE o AM h AA o AM n AF
mondragon	m AE o AM n AF d AC ɾ BD a AK ɡ AC o AM n AF
mongol	m AE o AM ŋ AF ɡ AC o AM l AD
monte	m AE o AM n AF t AC ɛ AK
montealegre	m AE o AM n AF t AC ɛ AK a AK l AD ɛ AK ɡ AC ɾ BD ɛ AK
montecalvo	m AE o AM n AF t AC ɛ AK k AC a AK l AD b AG o AM
montejo	ʔ AJ a AK l AD k AC a AK i AK d AC ɛ AK
montillano	m AE o AM n AF t AC i AK l AD l AD a AK n AF o AM
montinola	m AE o AM n AF t AC i AK n AF o AM l AD a AK
montojo	m AE o AM n AF t AC o AM d AC ʒ AH o AM
montoya	m AE o AM n AF t AC o AM j AB a AK
morato	m AE o AM ɾ BD a AK t AC o AM
motorsiklo	m AE o AM t AC o AM ɾ BD s AH i AK k AC l AD o AM
mukha	m AE u AM k AC h AA a AK ʔ AJ
mulasik	m AE u AM l AD a AK s AH i AK k AC
mulinsigla	m AE u AM l AD i AK n AF s AH i AK ɡ AC l AD a AK
mulinyari	m AE u AM l AD i AK n AF j AB a AK ɾ BD i AK ʔ AJ
mulkaphay	m AE u AM l AD k AC a AK p AG h AA a AK j AB
mulpikan	m AE u AM l AD p AG i AK k AC a AK n AF
multa	m AE u AM l AD t AC a AK
mumshie	m AE a AK m AE ʃ AH i AK
munggo	m AE u AM ŋ AF ɡ AC o AM
mura	m AE u AM ɾ BD a AK
musika	m AE u AM s AH i AK k AC a AK
musoleyo	m AE u AM s AH o AM l AD ɛ AK j AB o AM
musta	m AE u AM s AH t AC a AK
muta	m AE u AM t AC a AK ʔ AJ
mutha	m AE u AM t AC h AA a AK ʔ AJ
mutuc	m AE u AM t AC u AM k AC
muwebles	m AE w AI ɛ AK b AG l AD ɛ AK s AH
na	n AF a AK
na'ng	n AF ɐ AM ŋ AF
nacpil	n AF a AK k AC p AG i AK l AD
nagbabaon	n AF a AK ɡ AC b AG a AK b AG a AK ʔ AJ o AM n AF
nagbaon	n AF a AK ɡ AC b AG a AK ʔ AJ o AM n AF
nagwas	n AF a AK ɡ AC w AI ɐ AM s AH
nakakaalarma	n AF a AK k AC a AK k AC a AK a AK l AD a AK ɾ BD m AE a AK
nakakabingi	n AF a AK k AC a AK k AC a AK b AG i AK ŋ AF i AK
nakakabobo	n AF ɐ AM k AC a AK k AC ɐ AM b AG ɔ AM b AG ɔ AM
nakakabuwisit	n AF a AK k AC a AK k AC a AK b AG w AI i AK s AH i AK t AC
nakakabwisit	n AF a AK k AC a AK k AC a AK b AG w AI i AK s AH i AK t AC
nakakahawa	n AF a AK k AC a AK k AC a AK h AA a AK w AI a AK
nakakaintriga	n AF a AK k AC a AK k AC a AK ʔ AJ i AK n AF t AC ɾ BD i AK ɡ AC a AK
nakakaloko	n AF a AK k AC a AK k AC a AK l AD o AM k AC o AM
nakakapagpabagabag	n AF a AK k AC a AK k AC a AK p AG a AK ɡ AC p AG a AK b AG a AK ɡ AC a AK b AG a AK ɡ AC
nakakatakot	n AF a AK k AC a AK k AC a AK t AC a AK k AC o AM t AC
nakamulaga	n AF a AK k AC a AK m AE u AM l AD a AK ɡ AC a AK ʔ AJ
nakawin	n AF a AK k AC a AK w AI i AK n AF
nakayukyok	n AF a AK k AC a AK j AB u AM k AC j AB o AM k AC
nakpil	n AF a AK k AC p AG i AK l AD
naman	n AF a AK m AE a AK n AF
namin	n AF aː AL m AE ɪ AK n AF
nang	n AF ɐ AM ŋ AF
nanlilimahid	n AF a AK n AF l AD i AK l AD i AK m AE a AK h AA i AK d AC
napnap	n AF a AK p AG n AF a AK p AG
narvaez	n AF a AK ɾ BD b AG a AK ɛ AK s AH
natae	n AF a AK t AC a AK ʔ AJ ɛ AK
natin	n AF a AK t AC ɛ AK n AF
navoa	n AF a AK b AG o AM a AK
nene	n AF ɛ AK n AF ɛ AK ʔ AJ
ng	n AF ɐ AM ŋ AF
nga	ŋ AF a AK ʔ AJ
ngalan	ŋ AF a AK l AD a AK n AF
nganga	ŋ AF a AK ŋ AF a AK ʔ AJ
ngayon	ŋ AF a AK j AB o AM n AF
ngimay	ŋ AF i AK m AE a AK i AK
ngo	ŋ AF o AM
ngumiti	ŋ AF u AM m AE i AK t AC i AK ʔ AJ
ngumuya	ŋ AF u AM m AE u AM j AB a AK ʔ AJ
nguso	ŋ AF u AM s AH o AM ʔ AJ
nguya	ŋ AF u AM j AB a AK ʔ AJ
ni	n AF iː AL
nicdao	n AF i AK k AC d AC a AK o AM
nietes	n AF j AB ɛ AK t AC ɛ AK s AH
niknik	n AF i AK k AC n AF i AK k AC
nila	n AF i AK l AD a AK
nilabhan	n AF i AK l AD a AK b AG h AA a AK n AF
ninang	n AF i AK n AF a AK ŋ AF
nino	n AF i AK n AF o AM
ninyo	n AF i AK n AF j AB o AM
nito	n AF i AK t AC o AM
nitroheno	n AF i AK t AC r BA o AM h AA e AK n AF o AM
niya	ɲ AF a AK
niyo	n AF i AK o AM
niyon	n AF u AM n AF
nobela	n AF o AM b AG ɛ AK l AD a AK
nobleza	n AF o AM b AG l AD ɛ AK s AH a AK
nolasco	n AF o AM l AD a AK s AH k AC o AM
noriega	n AF o AM ɾ BD j AB ɛ AK ɡ AC a AK
notarte	n AF o AM t AC a AK ɾ BD t AC ɛ AK
novero	n AF o AM b AG ɛ AK ɾ BD o AM
nuevo	n AF u AM ɛ AK b AG o AM
numero	n AF u AM m AE ɛ AK ɾ BD ɔ AM
o	ɔː AN
obligacion	ʔ AJ o AM b AG l AD i AK ɡ AC a AK s AH j AB o AM n AF
obrero	ʔ AJ o AM b AG ɾ BD ɛ AK ɾ BD o AM
ocampo	ʔ AJ o AM k AC a AK m AE p AG o AM
oksiheno	o AM k AC s AH i AK h AA e AK n AF o AM
olaguer	ʔ AJ o AM l AD a AK ɡ AC ɛ AK ɾ BD
olaivar	ʔ AJ o AM l AD a AK i AK b AG a AK ɾ BD
olalia	ʔ AJ o AM l AD a AK l AD i AK a AK
olayvar	ʔ AJ o AM l AD a AK i AK b AG a AK ɾ BD
oliva	ʔ AJ o AM l AD i AK b AG a AK
olivares	ʔ AJ o AM l AD i AK b AG a AK ɾ BD ɛ AK s AH
oliveros	ʔ AJ o AM l AD i AK b AG ɛ AK ɾ BD o AM s AH
olmedo	ʔ AJ o AM l AD m AE ɛ AK d AC o AM
ong	ɔ AM ŋ AF
ongkiko	ʔ AJ o AM ŋ AF k AC i AK k AC o AM
oo	oː AN ʔ AJ o AM
opeña	ʔ AJ o AM p AG ɛ AK ɲ AF a AK
opisyales	ʔ AJ o AM p AG i AK s AH j AB a AK l AD ɛ AK s AH
opyum	ʔ AJ o AM p AG j AB u AM m AE
oracion	ʔ AJ o AM ɾ BD a AK s AH j AB o AM n AF
orasan	o AM r BA a AK s AH a AK n AF
orendain	ʔ AJ o AM ɾ BD ɛ AK n AF d AC a AK i AK n AF
orense	ʔ AJ o AM ɾ BD ɛ AK n AF s AH ɛ AK
oribello	ʔ AJ o AM ɾ BD i AK b AG ɛ AK l AD l AD o AM
paalam	p AG ɐ AM ʔ AJ ɐ AM l AD a AK m AE
paano	p AG a AK ʔ AJ a AK n AF o AM
paaralan	p AG a AK a AK ɾ BD ɐ AM l AD a AK n AF
pabalikin	p AG a AK b AG a AK l AD i AK k AC i AK n AF
pabebe	p AG a AK b AG ɛ AK b AG ɛ AK
pabiyay	p AG a AK b AG i AK j AB a AK j AB
pabor	p AG a AK b AG o AM ɾ BD
paborito	p AG a AK b AG o AM ɾ BD a AK b AG l AD ɛ AK
pabuksan	p AG a AK b AG u AM k AC s AH a AK n AF
pabuya	p AG a AK b AG u AM j AB a AK ʔ AJ
pacana	p AG a AK k AC a AK n AF a AK
pacaña	p AG a AK k AC a AK ɲ AF a AK
padaanin	p AG a AK d AC a AK a AK n AF i AK n AF
padaliin	p AG a AK d AC a AK l AD i AK i AK n AF
pader	p AG a AK d AC ɛ AK ɾ BD
pagala	p AG a AK ɡ AC a AK l AD a AK ʔ AJ
pagalingin	p AG a AK ɡ AC a AK l AD i AK ŋ AF i AK n AF
pagbabalik	p AG a AK ɡ AC b AG a AK b AG a AK l AD i AK k AC
pagbasehan	p AG a AK ɡ AC b AG a AK s AH ɛ AK h AA a AK n AF
pagbati	p AG a AK ɡ AC b AG a AK t AC i AK ʔ AJ
pagbubuntis	p AG a AK ɡ AC b AG u AM b AG u AM n AF t AC i AK s AH
pagcaliwagan	p AG a AK ɡ AC k AC a AK l AD i AK w AI a AK ɡ AC a AK n AF
pagdaan	p AG a AK ɡ AC d AC a AK a AK n AF
pagdila	p AG a AK ɡ AC d AC i AK l AD a AK ʔ AJ
pagdilao	p AG a AK ɡ AC d AC i AK l AD a AK u AM
paggiba	p AG a AK ɡ AC ɡ AC i AK b AG a AK ʔ AJ
paghigantihan	p AG a AK ɡ AC h AA i AK ɡ AC a AK n AF t AC i AK h AA a AK n AF
paghuyad	p AG a AK ɡ AC h AA u AM j AB a AK d AC
pagi	p AG a AK ɡ AC i AK
pagitan	p AG a AK ɡ AC i AK t AC a AK n AF
pagkaigkasin	p AG a AK ɡ AC k AC a AK ʔ AJ i AK ɡ AC k AC a AK s AH i AK n AF
pagkakaibigan	p AG a AK ɡ AC k AC a AK k AC a AK i AK b AG i AK ɡ AC a AK n AF
pagkakasakit	p AG a AK ɡ AC k AC a AK k AC a AK s AH a AK k AC i AK t AC
pagkakataon	p AG a AK ɡ AC k AC a AK k AC a AK t AC a AK ʔ AJ o AM n AF
pagkamakabagunsakupin	p AG a AK ɡ AC k AC a AK m AE a AK k AC a AK b AG a AK ɡ AC u AM n AF s AH a AK k AC u AM p AG i AK n AF
pagkamakagahum	p AG a AK ɡ AC k AC a AK m AE a AK k AC a AK ɡ AC a AK h AA u AM m AE
pagkawakaak	p AG a AK ɡ AC k AC a AK w AI a AK k AC a AK ʔ AJ a AK k AC
pagmamadali	p AG a AK ɡ AC m AE a AK m AE a AK d AC a AK l AD i AK ʔ AJ
pagnanakaw	p AG a AK ɡ AC n AF a AK n AF a AK k AC a AK u AM
pagsamantalahan	p AG a AK ɡ AC s AH a AK m AE a AK n AF t AC a AK l AD a AK h AA a AK n AF
pagsanjan	p AG a AK ɡ AC s AH a AK n AF h AA a AK n AF
pagsuway	p AG a AK ɡ AC s AH u AM a AK i AK
pagtaban	p AG a AK ɡ AC t AC a AK b AG a AK n AF
pagtakhan	p AG a AK ɡ AC t AC a AK k AC h AA a AK n AF
pagtripan	p AG a AK ɡ AC t AC ɾ BD i AK p AG a AK n AF
pagtutulungan	p AG a AK ɡ AC t AC u AM t AC u AM l AD u AM ŋ AF a AK n AF
paguia	p AG a AK ɡ AC j AB a AK
paguio	p AG a AK ɡ AC j AB o AM
pagwawaliwali	p AG a AK ɡ AC w AI a AK l AD i AK w AI a AK l AD i AK
pagwawasak	p AG a AK ɡ AC w AI a AK w AI a AK s AH a AK k AC
pagwitwit	p AG a AK ɡ AC w AI i AK t AC w AI i AK t AC
pagwiwisik	p AG a AK ɡ AC w AI i AK w AI i AK s AH i AK k AC
pagyukyok	p AG a AK ɡ AC j AB u AM k AC j AB o AM k AC
pahayagan	p AG aː AL h AA a AK i AK a AK ɡ AC a AK n AF
pahilaga	p AG a AK h AA i AK l AD a AK ɡ AC a AK ʔ AJ
pahina	p AG a AK h AA i AK n AF a AK
pahinarya	p AG ɐ AM h AA i AK n AF a AK r BA j AB ɐ AM
pahintulot	p AG a AK h AA i AK n AF t AC u AM l AD o AM t AC
pahiyain	p AG a AK h AA i AK a AK ʔ AJ i AK n AF
painitin	p AG a AK ʔ AJ i AK n AF i AK t AC i AK n AF
pajares	p AG a AK d AC ʒ AH a AK ɾ BD ɛ AK s AH
pakialam	p AG a AK k AC ɛ AK ɐ AM l AD a AK m AE
pakialamero	p AG a AK k AC i AK ʔ AJ a AK l AD a AK m AE e AK ɾ BD o AM
pakid	p AG a AK k AC i AK d AC
pakikipagtalik	p AG a AK k AC i AK k AC i AK p AG a AK ɡ AC t AC a AK l AD i AK k AC
pakiwani	p AG a AK k AC i AK w AI a AK n AF i AK
pakla	p AG a AK k AC l AD a AK
pakulo	p AG a AK k AC u AM l AD o AM ʔ AJ
pakwan	p AG a AK k AC w AI a AK n AF
palacol	p AG a AK l AD a AK k AC o AM l AD
paladutaan	p AG a AK l AD a AK d AC u AM t AC a AK ʔ AJ a AK n AF
palafox	p AG a AK l AD a AK p AG o AM k AC s AH
palagyan	p AG a AK l AD a AK ɡ AC j AB a AK n AF
palahaw	p AG a AK l AD a AK h AA a AK u AM
palakol	p AG a AK l AD a AK k AC o AM l AD
palamakatauhan	p AG a AK l AD a AK m AE a AK k AC a AK t AC a AK ʔ AJ u AM h AA a AK n AF
palamigin	p AG a AK l AD a AK m AE i AK ɡ AC i AK n AF
palamuhayan	p AG a AK l AD a AK m AE u AM h AA a AK j AB a AK n AF
palamuti	p AG a AK l AD a AK m AE u AM t AC i AK ʔ AJ
palasihayan	p AG a AK l AD a AK s AH i AK h AA a AK j AB a AK n AF
palasihayanan	p AG a AK l AD a AK s AH i AK h AA a AK j AB a AK n AF a AK n AF
palaspas	p AG a AK l AD a AK s AH p AG a AK s AH
palatatagnan	p AG a AK l AD a AK t AC a AK t AC a AK ɡ AC n AF a AK n AF
palatumbasan	p AG a AK l AD a AK t AC u AM m AE b AG a AK s AH a AK n AF
palaulatan	p AG a AK l AD ɐ AM ʔ AJ u AM l AD ɐ AM t AC a AK n AF
palay	p AG a AK l AD a AK j AB
palayan	p AG a AK l AD a AK j AB a AK n AF
palayasin	p AG a AK l AD a AK j AB a AK s AH i AK n AF
palima	p AG a AK l AD i AK m AE a AK
paliparan	p AG ɐ AM l AD ɪ AK p AG ɐ AM ɾ BD a AK n AF
palisoc	p AG a AK l AD i AK s AH o AM k AC
palit	p AG a AK l AD i AK t AC
palitada	p AG a AK l AD i AK t AC a AK d AC a AK
palitadahan	p AG a AK l AD i AK t AC a AK d AC a AK h AA a AK n AF
palitan	p AG a AK l AD i AK t AC a AK n AF
palo	p AG a AK l AD o AM ʔ AJ
palomares	p AG a AK l AD o AM m AE a AK ɾ BD ɛ AK s AH
palos	p AG a AK l AD ɔ AM s AH
pamabat	p AG a AK m AE a AK b AG a AK t AC
pamahalaan	p AG a AK m AE a AK h AA a AK l AD a AK ʔ AJ a AK n AF
pamalo	p AG a AK m AE a AK l AD o AM ʔ AJ
pamamanhikan	p AG a AK m AE a AK m AE a AK n AF h AA i AK k AC a AK n AF
pamamaril	p AG a AK m AE a AK m AE a AK ɾ BD i AK l AD
pamaypay	p AG a AK m AE a AK i AK p AG a AK i AK
pamimilosopo	p AG a AK m AE i AK m AE i AK l AD o AM s AH o AM p AG o AM
paminta	p AG a AK m AE i AK n AF t AC a AK
pamintuan	p AG a AK m AE i AK n AF t AC u AM a AK n AF
pan	p AG a AK n AF
panahon	p AG a AK n AF a AK h AA o AM n AF
panalangin	p AG a AK n AF a AK l AD a AK ŋ AF i AK n AF
panalo	p AG a AK n AF a AK l AD o AM
pananabotahe	p AG a AK n AF a AK n AF a AK b AG o AM t AC a AK h AA ɛ AK
pananagutan	p AG a AK n AF a AK n AF a AK ɡ AC u AM t AC a AK n AF
pandemya	p AG a AK n AF d AC ɛ AK m AE j AB a AK
pandiwa	p AG a AK n AF d AC i AK w AI a AK ʔ AJ
panelo	p AG a AK n AF ɛ AK l AD o AM
pang	p AG a AK ŋ AF
pangalan	p AG a AK ŋ AF a AK l AD a AK n AF
panghimasukan	p AG a AK ŋ AF h AA i AK m AE a AK s AH u AM k AC a AK n AF
pangit	p AG a AK ŋ AF i AK t AC
pangngalan	p AG a AK ŋ AF ŋ AF a AK l AD a AK n AF
pangungusap	p AG a AK ŋ AF u AM ŋ AF u AM s AH a AK p AG
pangwilig	p AG a AK ŋ AF w AI i AK l AD i AK ɡ AC
panibughuin	p AG a AK n AF i AK b AG u AM ɡ AC h AA u AM ʔ AJ i AK n AF
panilan	p AG a AK n AF i AK l AD a AK n AF
paninigarilyo	p AG a AK n AF i AK n AF i AK ɡ AC a AK ɾ BD i AK l AD j AB o AM
panitikan	p AG a AK n AF i AK t AC i AK k AC a AK n AF
panlaqui	p AG a AK n AF l AD a AK k AC i AK
pansamantala	p AG a AK n AF s AH a AK m AE a AK n AF t AC a AK l AD a AK
pantas	p AG a AK n AF t AC a AK s AH
pantig	p AG a AK n AF t AC i AK ɡ AC
panukala	p AG a AK n AF u AM k AC a AK l AD a AK ʔ AJ
paos	p AG a AK ʔ AJ o AM s AH
papel	p AG a AK p AG e AK l AD
para	p AG aː AL ɾ BD a AK
paraan	p AG a AK ɾ BD a AK ʔ AJ a AK n AF
parada	p AG a AK ɾ BD a AK d AC a AK
paragas	p AG a AK ɾ BD a AK ɡ AC a AK s AH
parayno	p AG a AK ɾ BD a AK i AK n AF o AM
pareño	p AG a AK ɾ BD ɛ AK ɲ AF o AM
pari	p AG a AK ɾ BD i AK ʔ AJ
parihaba	p AG ɐ AM r BA i AK h AA a AK b AG a AK ʔ AJ
parilla	p AG a AK ɾ BD i AK l AD l AD a AK
pariugat	p AG ɐ AM ɾ BD ɪ AK ʔ AJ u AM ɡ AC a AK t AC
parreño	p AG a AK ɾ BD ɛ AK ɲ AF o AM
parusa	p AG a AK ɾ BD u AM s AH a AK
pasabugin	p AG a AK s AH a AK b AG u AM ɡ AC i AK n AF
pasaway	p AG a AK s AH a AK w AI a AK i AK
pasensya	p AG a AK s AH ɛ AK n AF ɕ AH a AK
pasiya	p AG a AK s AH j AB a AK
paskil	p AG ɐ AM s AH k AC i AK l AD
pasko	p AG a AK s AH k AC o AM
paskuwa	p AG a AK s AH k AC u AM a AK
pasok	p AG aː AL s AH ɔ AM k AC
pasugalan	p AG a AK s AH u AM ɡ AC a AK l AD a AK n AF
pasukan	p AG a AK s AH u AM k AC a AK n AF
pasukin	p AG a AK s AH u AM k AC i AK n AF
pasulo	p AG a AK s AH u AM l AD o AM
patahian	p AG a AK t AC a AK h AA i AK ʔ AJ a AK n AF
patakbuhin	p AG a AK t AC a AK k AC b AG u AM h AA i AK n AF
patalastas	p AG a AK t AC a AK l AD a AK s AH t AC a AK s AH
patawanin	p AG a AK t AC a AK w AI a AK n AF i AK n AF
patay	p AG a AK t AC a AK ɪ AK
patda	p AG a AK t AC d AC a AK
patiag	p AG a AK t AC j AB a AK ɡ AC
patidyugto	p AG a AK t AC i AK d AC j AB u AM ɡ AC t AC o AM ʔ AJ
patimog	p AG a AK t AC i AK m AE o AM ɡ AC
patiño	p AG a AK t AC i AK ɲ AF o AM
patnubay	p AG a AK t AC n AF u AM b AG a AK i AK
pato	p AG aː AL t AC ɔ AM
patron	p AG a AK t AC ɾ BD o AM n AF
patupat	p AG a AK t AC u AM p AG a AK t AC
patutsada	p AG a AK t AC u AM t AC s AH a AK d AC a AK
patuusan	p AG a AK t AC u AM ʔ AJ ɔ AM s AH a AK n AF
paupahan	p AG a AK u AM p AG a AK h AA a AK n AF
pausukan	p AG a AK u AM s AH u AM k AC a AK n AF
pauwiin	p AG a AK u AM w AI i AK i AK n AF
pawis	p AG a AK w AI i AK s AH
payak	p AG a AK j AB a AK k AC
payamanin	p AG a AK j AB a AK m AE a AK n AF i AK n AF
payumo	p AG a AK j AB u AM m AE o AM
paz	p AG a AK s AH
pebrero	p AG ɛ AK b AG ɾ BD ɛ AK ɾ BD o AM
pecson	p AG ɛ AK k AC s AH o AM n AF
peke	p AG ɛ AK k AC ɛ AK ʔ AJ
peklat	p AG ɛ AK k AC l AD a AK t AC
peste	p AG ɛ AK s AH t AC ɛ AK
pestisidyo	p AG ɛ AK s AH t AC i AK s AH i AK d AC j AB o AM
petmalu	p AG e AK t AC m AE a AK l AD u AM
petsay	p AG e AK t AC t AC ʃ AH a AK j AB
peñaflor	p AG ɛ AK ɲ AF a AK p AG l AD o AM ɾ BD
peñaflorida	p AG ɛ AK ɲ AF a AK p AG l AD o AM ɾ BD i AK d AC a AK
peñaranda	p AG ɛ AK ɲ AF a AK ɾ BD a AK n AF d AC a AK
piga	p AG i AK ɡ AC a AK ʔ AJ
pigain	p AG i AK ɡ AC a AK ʔ AJ i AK n AF
pigsa	p AG i AK ɡ AC s AH a AK ʔ AJ
pihikan	p AG i AK h AA i AK k AC a AK n AF
piho	p AG i AK h AA o AM
pila	p AG i AK l AD a AK
pilantik	p AG i AK l AD a AK n AF t AC i AK k AC
pilantropo	p AG i AK l AD a AK n AF t AC ɾ BD o AM p AG o AM
pilapil	p AG i AK l AD a AK p AG i AK l AD
pilat	p AG i AK l AD a AK t AC
pilay	p AG i AK l AD a AK j AB
pilipinas	p AG i AK l AD i AK p AG i AK n AF a AK s AH
pilosopiya	p AG i AK l AD o AM s AH o AM p AG i AK a AK
pilosopo	p AG i AK l AD o AM s AH o AM p AG o AM
pilyo	p AG i AK l AD j AB o AM
pinaghihinalaan	p AG i AK n AF a AK ɡ AC h AA i AK h AA i AK n AF a AK l AD a AK a AK n AF
pinagsamantalahan	p AG i AK n AF a AK ɡ AC s AH a AK m AE a AK n AF t AC a AK l AD a AK h AA a AK n AF
pindot	p AG i AK n AF d AC o AM t AC
pinggan	p AG i AK ŋ AF ɡ AC a AK n AF
pinlac	p AG i AK n AF l AD a AK k AC
pino	p AG i AK n AF o AM
pintakasi	p AG i AK n AF t AC a AK k AC a AK s AH i AK
piraso	p AG i AK ɾ BD a AK s AH o AM
pirmahan	p AG i AK ɾ BD m AE a AK h AA a AK n AF
pisika	p AG i AK s AH ɪ AK k AC ɐ AM
piskal	p AG i AK s AH k AC a AK l AD
piskalya	p AG i AK s AH k AC a AK l AD j AB a AK
pista	p AG i AK s AH t AC a AK
pitis	p AG i AK t AC i AK s AH
pito	p AG i AK t AC ɔ AM
pitumpu	p AG i AK t AC u AM m AE p AG u AM ʔ AJ
pitundaan	p AG i AK t AC u AM n AF d AC a AK a AK n AF
piyo	p AG i AK j AB o AM ʔ AJ
pizarro	p AG i AK s AH a AK ɾ BD ɾ BD o AM
piñon	p AG i AK ɲ AF o AM n AF
planas	p AG l AD a AK n AF a AK s AH
plastik	p AG l AD a AK s AH t AC i AK k AC
plebisito	p AG l AD e AK b AG i AK s AH i AK t AC o AM
po	p AG ɔ AM
pobre	p AG ɔː AN b AG r BA ɛ AK
pokpok	p AG ɔ AM k AC p AG ɔ AM k AC
policarpio	p AG o AM l AD i AK k AC a AK ɾ BD p AG j AB o AM
polintan	p AG o AM l AD i AK n AF t AC a AK n AF
polo	p AG o AM l AD o AM
pondo	p AG o AM n AF d AC o AM
pondohan	p AG o AM n AF d AC o AM h AA a AK n AF
ponkan	p AG o AM ŋ AF k AC a AK n AF
poon	p AG u AM n AF
portuges	p AG o AM ɾ BD t AC u AM ɡ AC ɛ AK s AH
posas	p AG o AM s AH a AK s AH
post	p AG o AM u AM s AH t AC
prado	p AG ɾ BD a AK d AC o AM
praning	p AG ɾ BD a AK n AF i AK ŋ AF
prayoridad	p AG ɾ BD a AK j AB o AM ɾ BD i AK d AC a AK d AC
premyo	p AG ɾ BD ɛ AK m AE j AB o AM
preso	p AG ɾ BD ɛ AK s AH o AM
proklamasyon	p AG ɾ BD o AM k AC l AD a AK m AE a AK s AH j AB o AM n AF
promdi	p AG r BA o AM m AE d AC i AK
prudente	p AG ɾ BD u AM d AC ɛ AK n AF t AC ɛ AK
pua	p AG u AM w AI a AK
pudpod	p AG u AM d AC p AG o AM d AC
pugad	p AG u AM ɡ AC a AK d AC
pugo	p AG u AM ɡ AC o AM ʔ AJ
pugot	p AG u AM ɡ AC o AM t AC
pugutan	p AG u AM ɡ AC u AM t AC a AK n AF
puhunan	p AG u AM h AA u AM n AF a AK n AF
pukyutan	p AG u AM k AC j AB u AM t AC a AK n AF
pula	p AG ʊ AM l AD a AK
pulahan	p AG u AM l AD a AK h AA a AK n AF
pulgada	p AG u AM l AD ɡ AC a AK d AC a AK
pulgas	p AG u AM l AD ɡ AC a AK s AH
pulikat	p AG u AM l AD i AK k AC a AK t AC
pulmonya	p AG u AM l AD m AE o AM n AF j AB a AK
pulo	p AG u AM l AD o AM ʔ AJ
pulot	p AG u AM l AD o AM t AC
pultaon	p AG u AM l AD t AC a AK ʔ AJ ɔ AM n AF
pulubi	p AG u AM l AD u AM b AG i AK
pulutan	p AG u AM l AD u AM t AC a AK n AF
pumalakpak	p AG u AM m AE a AK l AD a AK k AC p AG a AK k AC
pumasok	p AG u AM m AE a AK s AH o AM k AC
pumatay	p AG u AM m AE a AK t AC a AK j AB
pumayag	p AG u AM m AE a AK j AB a AK ɡ AC
pumila	p AG u AM m AE i AK l AD a AK
pumisik	p AG u AM m AE i AK s AH i AK k AC
pumula	p AG u AM m AE u AM l AD a AK
pumunta	p AG u AM m AE u AM n AF t AC a AK
pumuti	p AG u AM m AE u AM t AC i AK ʔ AJ
pumutok	p AG u AM m AE u AM t AC o AM k AC
pundido	p AG u AM n AF d AC i AK d AC o AM
puno	p AG u AM n AF o AM ʔ AJ
punongbayan	p AG u AM n AF o AM ŋ AF b AG a AK j AB a AK n AF
punsalang	p AG u AM n AF s AH a AK l AD a AK ŋ AF
punta	p AG u AM n AF t AC a AK ʔ AJ
puntahan	p AG u AM n AF t AC a AK h AA a AK n AF
puntirya	p AG u AM n AF t AC i AK ɾ BD j AB a AK
punzalan	p AG u AM n AF s AH a AK l AD a AK n AF
pusit	p AG u AM s AH i AK t AC
puson	p AG u AM s AH o AM n AF
pusta	p AG u AM s AH t AC a AK
pustiso	p AG u AM s AH t AC i AK s AH o AM
pusyaw	p AG ʊ AM s AH j AB a AK u AM
putakti	p AG u AM t AC a AK k AC t AC i AK
puti	p AG u AM t AC ɪ AK
putik	p AG u AM t AC i AK k AC
putol	p AG u AM t AC o AM l AD
putulin	p AG u AM t AC u AM l AD i AK n AF
puyod	p AG u AM j AB o AM d AC
que	k AC ɛ AK
quezon	k AC ɛ AK s AH o AM n AF
quiambao	k AC j AB a AK m AE b AG a AK u AM
quimpo	k AC i AK m AE p AG o AM
quintos	k AC i AK n AF t AC o AM s AH
quirante	k AC i AK ɾ BD a AK n AF t AC ɛ AK
quisumbing	k AC i AK s AH u AM m AE b AG i AK ŋ AF
quitain	k AC i AK t AC a AK i AK n AF
quiñones	k AC i AK ɲ AF o AM n AF ɛ AK s AH
racelis	ɾ BD a AK s AH ɛ AK l AD i AK s AH
ragas	ɾ BD a AK ɡ AC a AK s AH
ragudo	ɾ BD a AK ɡ AC u AM d AC o AM
rajah	r BA a AK h AA a AK
rali	ɾ BD a AK l AD i AK
raliyista	ɾ BD a AK l AD i AK j AB i AK s AH t AC a AK
rambol	ɾ BD a AK m AE b AG o AM l AD
rambulan	ɾ BD a AK m AE b AG u AM l AD a AK n AF
rantso	ɾ BD a AK n AF t AC ʃ AH o AM
rason	ɾ BD a AK s AH o AM n AF
rayos	ɾ BD a AK j AB o AM s AH
razon	ɾ BD a AK s AH o AM n AF
reaño	ɾ BD ɛ AK a AK ɲ AF o AM
rebelde	ɾ BD e AK b AG e AK l AD d AC e AK
rebelyon	r BA ɛ AK b AG ɛ AK l AD j AB o AM n AF
redondo	ɾ BD ɛ AK d AC o AM n AF d AC o AM
regala	ɾ BD ɛ AK ɡ AC a AK l AD a AK
regidor	ɾ BD ɛ AK h AA i AK d AC o AM ɾ BD
rehas	ɾ BD ɛ AK h AA a AK s AH
rehistro	ɾ BD ɛ AK h AA i AK s AH t AC ɾ BD o AM
rekisito	ɾ BD ɛ AK k AC i AK s AH i AK t AC o AM
rekisitos	ɾ BD ɛ AK k AC i AK s AH i AK t AC o AM s AH
relo	ɾ BD ɛ AK l AD o AM
remigio	ɾ BD ɛ AK m AE i AK h AA j AB o AM
remulla	ɾ BD ɛ AK m AE u AM l AD l AD a AK
reodica	ɾ BD ɛ AK o AM d AC i AK k AC a AK
reperendum	ɾ BD ɛ AK p AG ɛ AK ɾ BD ɛ AK n AF d AC u AM m AE
resistensya	ɾ BD ɛ AK s AH i AK s AH t AC ɛ AK n AF s AH j AB a AK
responsable	ɾ BD ɛ AK s AH p AG o AM n AF s AH a AK b AG l AD ɛ AK
resurreccion	ɾ BD ɛ AK s AH u AM ɾ BD ɛ AK k AC s AH j AB o AM n AF
ricafort	ɾ BD i AK k AC a AK p AG o AM ɾ BD t AC
ricarte	ɾ BD i AK k AC a AK ɾ BD t AC ɛ AK
riles	ɾ BD i AK l AD ɛ AK s AH
rin	ɾ BD i AK n AF
rivero	ɾ BD i AK b AG ɛ AK ɾ BD o AM
riñon	ɾ BD i AK ɲ AF o AM n AF
rombaoa	ɾ BD o AM m AE b AG a AK w AI a AK
romualdez	ɾ BD o AM m AE w AI a AK l AD d AC ɛ AK s AH
romualdo	ɾ BD o AM m AE w AI a AK l AD d AC o AM
rosete	ɾ BD o AM s AH ɛ AK t AC ɛ AK
roxas	ɾ BD o AM d AC ʒ AH a AK s AH
rulloda	ɾ BD u AM l AD l AD o AM d AC a AK
rumupok	ɾ BD u AM m AE u AM p AG o AM k AC
ruta	r BA u AM t AC a AK
sa	s AH a AK
saan	s AH a AK a AK n AF
sabado	s AH a AK b AG a AK d AC o AM
sabana	s AH a AK b AG a AK n AF a AK
sabangan	s AH a AK b AG a AK ŋ AF a AK n AF
sabi	s AH a AK b AG i AK
sabon	s AH a AK b AG o AM n AF
saboy	s AH a AK b AG o AM i AK
sabunin	s AH a AK b AG u AM n AF i AK n AF
sabunot	s AH a AK b AG u AM n AF o AM t AC
sabunutan	s AH a AK b AG u AM n AF u AM t AC a AK n AF
sacdalan	s AH a AK k AC d AC a AK l AD a AK n AF
sadya	s AH a AK d AC j AB a AK ʔ AJ
sagay	s AH a AK ɡ AC a AK j AB
sagilap	s AH ɐ AM ɡ AC i AK l AD a AK p AG
sagimuymoy	s AH a AK ɡ AC i AK m AE u AM j AB m AE o AM j AB
saglit	s AH a AK ɡ AC l AD i AK t AC
saguinsin	s AH a AK ɡ AC i AK n AF s AH i AK n AF
sagun	s AH a AK ɡ AC u AM n AF
saha	s AH a AK h AA a AK ʔ AJ
sahagun	s AH a AK h AA a AK ɡ AC u AM n AF
sahog	s AH a AK h AA o AM ɡ AC
sais	s AH a AK ʔ AJ i AK s AH
saka	s AH a AK k AC a AK
sakal	s AH a AK k AC a AK l AD
sakit	s AH a AK k AC i AK t AC
sakitin	s AH a AK k AC i AK t AC i AK n AF
saksi	s AH a AK k AC s AH i AK
saksihan	s AH a AK k AC s AH i AK h AA a AK n AF
saktan	s AH a AK k AC t AC a AK n AF
sakuna	s AH a AK k AC u AM n AF a AK
sakupbayan	s AH a AK k AC u AM p AG b AG a AK j AB a AK n AF
sakwa	s AH a AK k AC w AI a AK
sala	s AH a AK l AD a AK
salagubang	s AH a AK l AD a AK ɡ AC u AM b AG a AK ŋ AF
salarin	s AH a AK l AD a AK ɾ BD i AK n AF
salaula	s AH a AK l AD a AK ʔ AJ u AM l AD a AK ʔ AJ
salawal	s AH a AK l AD a AK w AI a AK l AD
saldaña	s AH a AK l AD d AC a AK ɲ AF a AK
sales	s AH a AK l AD ɛ AK s AH
salipawpaw	s AH a AK l AD i AK p AG a AK u AM p AG a AK u AM
salitre	s AH a AK l AD i AK t AC ɾ BD ɛ AK
salog	s AH a AK l AD o AM ɡ AC
salonga	s AH a AK l AD o AM ŋ AF ɡ AC a AK
salot	s AH a AK l AD o AM t AC
salud	s AH a AK l AD u AM d AC
salumbides	s AH a AK l AD u AM m AE b AG i AK d AC ɛ AK s AH
salvacion	s AH a AK l AD b AG a AK s AH i AK o AM n AF
salvatierra	s AH a AK l AD b AG a AK t AC i AK ɛ AK ɾ BD ɾ BD a AK
samaniego	s AH a AK m AE a AK n AF j AB ɛ AK ɡ AC o AM
samantala	s AH a AK m AE a AK n AF t AC a AK l AD a AK ʔ AJ
samantha	s AH a AK m AE a AK n AF t AC a AK
samat	s AH a AK m AE a AK t AC
sambasamba	s AH a AK m AE b AG a AK s AH a AK m AE b AG a AK
samid	s AH a AK m AE i AK d AC
samonte	s AH a AK m AE o AM n AF t AC ɛ AK
sampaloc	s AH a AK m AE p AG a AK l AD o AM k AC
sampalok	s AH a AK m AE p AG a AK l AD o AM k AC
sampo	s AH a AK m AE p AG ɔ AM ʔ AJ
sampu	s AH a AK m AE p AG u AM ʔ AJ
sandali	s AH a AK n AF d AC ɐ AM l AD i AK ʔ AJ
sangalang	s AH a AK ŋ AF ɡ AC a AK l AD a AK ŋ AF
sangat	s AH a AK ŋ AF a AK t AC
sangco	s AH a AK ŋ AF k AC o AM
sanggol	s AH a AK ŋ AF ɡ AC o AM l AD
sangkot	s AH a AK ŋ AF k AC o AM t AC
santo	s AH a AK n AF t AC o AM
sapa	s AH a AK p AG a AK ʔ AJ
sapak	s AH a AK p AG a AK k AC
sapok	s AH a AK p AG o AM k AC
sapot	s AH a AK p AG o AM t AC
saquing	s AH a AK k AC i AK ŋ AF
sara	s AH ɐ AM ɾ BD a AK
sarabia	s AH a AK r BA a AK b AG j AB a AK
sarhento	s AH a AK ɾ BD h AA ɛ AK n AF t AC o AM
sawa	s AH a AK w AI a AK ʔ AJ
saway	s AH a AK w AI a AK i AK
sawayin	s AH a AK w AI a AK j AB i AK n AF
saya	s AH a AK j AB a AK
sayari	s AH a AK j AB a AK ɾ BD i AK ʔ AJ
sayson	s AH a AK i AK s AH o AM n AF
see	s AH iː AL
segismundo	s AH ɛ AK ɡ AC i AK s AH m AE u AM n AF d AC o AM
segui	s AH ɛ AK ɡ AC i AK
sekreto	s AH ɛ AK k AC ɾ BD ɛ AK t AC o AM
selepono	s AH e AK l AD e AK p AG o AM n AF o AM
selula	s AH ɛ AK l AD ʊ AM l AD ɐ AM
semantika	s AH ɛ AK m AE a AK n AF t AC i AK k AC a AK
semaña	s AH ɛ AK m AE a AK ɲ AF a AK
semilla	s AH e AK m AE i AK l AD j AB a AK
sentenaryo	s AH ɛ AK n AF t AC ɛ AK n AF a AK ɾ BD j AB o AM
sentensiya	s AH ɛ AK n AF t AC ɛ AK n AF s AH j AB a AK
sentensiyahan	s AH ɛ AK n AF t AC ɛ AK n AF s AH j AB a AK h AA a AK n AF
sentido	s AH ɛ AK n AF t AC i AK d AC o AM
seremonya	s AH ɛ AK ɾ BD ɛ AK m AE o AM n AF j AB a AK
serna	s AH ɛ AK ɾ BD n AF a AK
shabu	s AH j AB a AK b AG u AM
shao	ʃ AH a AK ʊ AM
shau	ʃ AH a AK ʊ AM
shaw	ʃ AH a AK ʊ AM
sia	s AH j AB a AK
siao	ʃ AH a AK ʊ AM
siason	s AH j AB a AK s AH o AM n AF
sibayan	s AH i AK b AG a AK j AB a AK n AF
sibog	s AH i AK b AG o AM ɡ AC
sibug	s AH i AK b AG u AM ɡ AC
sibuyas	s AH i AK b AG u AM j AB a AK s AH
siga	s AH i AK ɡ AC a AK ʔ AJ
sigarilyas	s AH i AK ɡ AC a AK ɾ BD i AK l AD j AB a AK s AH
sige	s AH i AK ɡ AC ɛ AK
siglo	s AH i AK ɡ AC l AD o AM
sigmuan	s AH i AK ɡ AC m AE u AM a AK n AF
siguraduhin	s AH i AK ɡ AC u AM ɾ BD a AK d AC u AM h AA i AK n AF
sihay	s AH i AK h AA a AK j AB
sihayan	s AH i AK h AA a AK j AB a AK n AF
sikatsikat	s AH i AK k AC a AK t AC s AH i AK k AC a AK t AC
sikhay	s AH i AK k AC h AA a AK j AB
siko	s AH i AK k AC o AM
siksin	s AH i AK k AC s AH i AK n AF
silang	s AH i AK l AD a AK ŋ AF
silangan	s AH i AK l AD a AK ŋ AF a AK n AF
silayan	s AH i AK l AD a AK j AB a AK n AF
silid	s AH ɪ AK l AD ɪ AK d AC
silidkaphay	s AH i AK l AD i AK d AC k AC a AK p AG h AA a AK j AB
silidkapnayan	s AH i AK l AD i AK d AC k AC a AK p AG n AF a AK j AB a AK n AF
silidkatwan	s AH i AK l AD i AK d AC k AC a AK t AC w AI a AK n AF
silidkilos	s AH i AK l AD i AK d AC k AC i AK l AD o AM s AH
silidkulay	s AH i AK l AD i AK d AC k AC u AM l AD a AK j AB
silidlawas	s AH i AK l AD i AK d AC l AD a AK w AI a AK s AH
silidmanahan	s AH i AK l AD i AK d AC m AE a AK n AF a AK h AA a AK n AF
silindro	s AH i AK l AD i AK n AF d AC ɾ BD o AM
simbulan	s AH i AK m AE b AG u AM l AD a AK n AF
simoy	s AH i AK m AE o AM j AB
simple	s AH i AK m AE p AG l AD ɛ AK
sinapupunan	s AH i AK n AF a AK p AG u AM p AG u AM n AF a AK n AF
sinat	s AH i AK n AF a AK t AC
sinauna	s AH i AK n AF a AK u AM n AF a AK
sinco	s AH i AK n AF k AC o AM
singil	s AH i AK ŋ AF i AK l AD
singkal	s AH i AK ŋ AF k AC a AK l AD
singkamasan	o AM r BA a AK s AH a AK n AF
sioson	s AH j AB o AM s AH o AM n AF
siping	s AH i AK p AG i AK ŋ AF
sipnayan	s AH ɪ AK p AG n AF a AK i AK ɐ AM n AF
sipon	s AH i AK p AG ʔ AJ o AM n AF
sipsip	s AH i AK p AG s AH i AK p AG
sira	s AH i AK ɾ BD a AK ʔ AJ
sirain	s AH i AK ɾ BD a AK ʔ AJ i AK n AF
sisi	s AH i AK s AH i AK
sisid	s AH i AK s AH i AK d AC
sisihan	s AH i AK s AH i AK h AA a AK n AF
sitwasyon	s AH i AK t AC w AI a AK s AH j AB o AM n AF
siya	s AH i AK j AB a AK
siyam	ʃ AH j AB a AK m AE
siyamnapu	s AH i AK j AB a AK m AE n AF a AK p AG u AM ʔ AJ
siyamnaraan	s AH i AK j AB a AK m AE n AF a AK r BA a AK a AK n AF
so	s AH ɔ AM
sobrepeña	s AH o AM b AG ɾ BD ɛ AK p AG ɛ AK ɲ AF a AK
soledad	s AH o AM l AD ɛ AK d AC a AK d AC
solis	s AH o AM l AD i AK s AH
son	s AH o AM n AF
songco	s AH o AM ŋ AF k AC o AM
sosa	s AH o AM s AH a AK
sosyal	s AH o AM ʃ AH a AK l AD
suan	s AH w AI a AK n AF
suazo	s AH w AI a AK s AH o AM
subok	s AH u AM b AG ɔ AM k AC
sucgang	s AH u AM k AC ɡ AC a AK ŋ AF
sugaan	s AH u AM ɡ AC a AK ʔ AJ a AK n AF
sugal	s AH u AM ɡ AC a AK l AD
suglaguman	s AH u AM ɡ AC l AD a AK ɡ AC u AM m AE a AK n AF
sugnay	s AH u AM ɡ AC n AF a AK j AB
sugnayan	s AH u AM ɡ AC n AF a AK j AB a AK n AF
sugnayanin	s AH u AM ɡ AC n AF a AK j AB a AK n AF i AK n AF
sugnayanon	s AH u AM ɡ AC n AF a AK j AB a AK n AF o AM n AF
sugnayin	s AH u AM ɡ AC n AF a AK j AB i AK n AF
suhi	s AH u AM h AA i AK ʔ AJ
suhol	s AH u AM h AA o AM l AD
suico	s AH u AM i AK k AC o AM
suka	s AH u AM k AC a AK ʔ AJ
sukal	s AH u AM k AC a AK l AD
sulidlawas	s AH u AM l AD i AK d AC l AD a AK w AI a AK s AH
sulsol	s AH u AM l AD s AH o AM l AD
sultan	s AH u AM l AD t AC a AK n AF
sultana	s AH u AM l AD t AC a AK n AF a AK
sultanato	s AH u AM l AD t AC a AK n AF a AK t AC o AM
sumabog	s AH u AM m AE a AK b AG o AM ɡ AC
sumadsad	s AH u AM m AE a AK d AC s AH a AK d AC
sumagot	s AH u AM m AE a AK ɡ AC o AM t AC
sumakit	s AH u AM m AE a AK k AC i AK t AC
sumalapang	s AH u AM m AE a AK l AD a AK p AG a AK ŋ AF
sumalapaw	s AH u AM m AE a AK l AD a AK p AG a AK u AM
sumama	s AH u AM m AE a AK m AE a AK ʔ AJ
sumeksi	s AH u AM m AE ɛ AK k AC s AH i AK
sumemplang	s AH u AM m AE ɛ AK m AE p AG l AD a AK ŋ AF
sumikat	s AH u AM m AE i AK k AC a AK t AC
sumikip	s AH u AM m AE i AK k AC i AK p AG
sumimangot	s AH u AM m AE i AK m AE a AK ŋ AF o AM t AC
suminga	s AH u AM m AE i AK ŋ AF a AK
sumuka	s AH u AM m AE u AM k AC a AK
sumulat	s AH u AM m AE u AM l AD a AK t AC
suntok	s AH u AM n AF t AC o AM k AC
suntukan	s AH u AM n AF t AC u AM k AC a AK n AF
suntukin	s AH u AM n AF t AC u AM k AC i AK n AF
suplete	s AH u AM p AG l AD ɛ AK t AC ɛ AK
supling	s AH u AM p AG l AD i AK ŋ AF
surot	s AH u AM ɾ BD o AM t AC
susmaryosep	s AH u AM s AH m AE a AK ɾ BD i AK ɔː AN s AH e AK p AG
sustento	s AH u AM s AH t AC ɛ AK n AF t AC o AM
suweldo	s AH w AI ɛ AK l AD d AC o AM
suya	s AH u AM j AB a AK ʔ AJ
swerte	s AH w AI e AK r BA t AC e AK
sy	s AH iː AL
syaw	ʃ AH a AK ʊ AM
sze	t AC ʃ AH e AK
tabigi	t AC a AK b AG i AK ɡ AC i AK ʔ AJ
tablaw	t AC a AK b AG l AD a AK w AI
tabon	t AC a AK b AG o AM n AF
taduran	t AC a AK d AC u AM ɾ BD a AK n AF
tae	t AC aː AL ʔ AJ eː AL
tagalog	t AC ɐ AM ɡ AC aː AL l AD o AM ɡ AC
tagapagmana	t AC a AK ɡ AC a AK p AG a AK ɡ AC m AE a AK n AF a AK
tagas	t AC a AK ɡ AC a AK s AH
tagiktik	t AC a AK ɡ AC i AK k AC t AC i AK k AC
taglagas	t AC a AK ɡ AC l AD a AK ɡ AC a AK s AH
tagtuyot	t AC a AK ɡ AC t AC u AM j AB o AM t AC
taguba	t AC a AK ɡ AC u AM b AG a AK
tagubilin	t AC a AK ɡ AC u AM b AG i AK l AD i AK n AF
taguinod	t AC a AK ɡ AC i AK n AF o AM d AC
tagupa	t AC a AK ɡ AC u AM p AG a AK
tahasik	t AC a AK h AA a AK s AH i AK k AC
taib	t AC a AK ʔ AJ i AK b AG
taihan	t AC a AK i AK h AA a AK n AF
takahashi	t AC a AK k AC a AK h AA a AK s AH j AB i AK
takbo	t AC a AK k AC b AG ɔ AM
takilya	t AC a AK k AC i AK l AD j AB a AK
talag	t AC a AK l AD a AK ɡ AC
talampas	t AC a AK l AD a AK m AE p AG a AK s AH
talavera	t AC a AK l AD a AK b AG ɛ AK ɾ BD a AK
talento	t AC a AK l AD ɛ AK n AF t AC o AM
talo	t AC a AK l AD o AM
talon	t AC a AK l AD o AM n AF
talong	t AC a AK l AD o AM ŋ AF
talukbong	t AC a AK l AD u AM k AC b AG o AM ŋ AF
talulot	t AC a AK l AD u AM l AD o AM t AC
talunan	t AC a AK l AD u AM n AF a AK n AF
tam	t AC a AK m AE
tambakol	t AC a AK m AE b AG a AK k AC o AM l AD
tamban	t AC a AK m AE b AG a AK n AF
tambayan	t AC a AK m AE b AG a AK j AB a AK n AF
tamis	t AC a AK m AE i AK s AH
tampal	t AC a AK m AE p AG a AK l AD
tan	t AC a AK n AF
tanauan	t AC a AK n AF ʔ AJ a AK w AI a AK n AF
tancinco	t AC a AK n AF s AH i AK n AF k AC o AM
tang	t AC a AK ŋ AF
tanga	t AC a AK ŋ AF a AK
tangco	t AC a AK ŋ AF k AC o AM
tanggal	t AC a AK ŋ AF ɡ AC a AK l AD
tanghalian	t AC a AK ŋ AF h AA a AK l AD i AK ʔ AJ a AK n AF
tanghas	t AC a AK ŋ AF h AA a AK s AH
tanikala	t AC a AK n AF i AK k AC a AK l AD a AK ʔ AJ
tanso	t AC a AK n AF s AH o AM ʔ AJ
tantiya	t AC a AK n AF t AC ʃ AH a AK
tao	t AC a AK ʔ AJ o AM
taog	t AC a AK ʔ AJ o AM ɡ AC
taon	t AC a AK ʔ AJ o AM n AF
tapales	t AC a AK p AG a AK l AD ɛ AK s AH
tapat	t AC a AK p AG a AK t AC
tapay	t AC a AK p AG a AK j AB
tapilok	t AC a AK p AG i AK l AD o AM k AC
tapos	t AC a AK p AG o AM s AH
tapunan	t AC a AK p AG u AM n AF a AK n AF
tapusin	t AC a AK p AG u AM s AH i AK n AF
tarik	t AC a AK ɾ BD i AK k AC
taruc	t AC a AK ɾ BD u AM k AC
tasa	t AC a AK s AH a AK
tataw	t AC a AK t AC a AK w AI
tatlo	t AC a AK t AC l AD ɔ AM
tatlonghari	t AC a AK t AC l AD o AM ŋ AF h AA a AK ɾ BD i AK
tatlumpu	t AC a AK t AC l AD u AM m AE p AG u AM ʔ AJ
tatlundaan	t AC a AK t AC l AD u AM n AF d AC a AK a AK n AF
tato	t AC a AK t AC o AM ʔ AJ
tatsulok	t AC ɐ AM t AC s AH u AM l AD ɔ AM k AC
tawag	t AC a AK w AI a AK ɡ AC
tayahan	t AC a AK j AB a AK h AA a AK n AF
tayo	t AC aː AL j AB ɔ AM
tañada	t AC a AK ɲ AF a AK d AC a AK
tecson	t AC ɛ AK k AC s AH o AM n AF
tee	t AC iː AL
teklado	t AC e AK k AC l AD a AK d AC o AM
telepono	t AC ɛ AK l AD ɛ AK p AG o AM n AF o AM
tenga	t AC ɛː AL ŋ AF a AK
tenorio	t AC ɛ AK n AF o AM ɾ BD j AB o AM
tenyente	t AC ɛ AK n AF j AB ɛ AK n AF t AC ɛ AK
teoriya	t AC ɛ AK o AM ɾ BD i AK a AK
teritoryo	t AC ɛ AK ɾ BD i AK t AC o AM ɾ BD j AB o AM
tiamson	t AC j AB a AK m AE s AH o AM n AF
tian	t AC j AB a AK n AF
tiangco	t AC j AB a AK ŋ AF k AC o AM
tibay	t AC i AK b AG a AK i AK
tibo	t AC ɪ AK b AG ɔ AM ʔ AJ
tiburcio	t AC i AK b AG u AM ɾ BD s AH j AB o AM
ticzon	t AC i AK k AC s AH o AM n AF
tien	t AC j AB e AK n AF
tigang	t AC i AK ɡ AC a AK ŋ AF
tigas	t AC i AK ɡ AC a AK s AH
tigilan	t AC i AK ɡ AC i AK l AD a AK n AF
tiis	t AC i AK ʔ AJ i AK s AH
tikbalang	t AC i AK k AC b AG a AK l AD a AK ŋ AF
tikling	t AC i AK k AC l AD i AK ŋ AF
tiklop	t AC i AK k AC l AD o AM p AG
tiktik	t AC i AK k AC t AC i AK k AC
timbang	t AC i AK m AE b AG a AK ŋ AF
timog	t AC i AK m AE o AM ɡ AC
tin	t AC ɪ AK n AF
tindero	t AC i AK n AF d AC ɛ AK ɾ BD o AM
tindig	t AC i AK n AF d AC i AK ɡ AC
ting	t AC ɪ AK ŋ AF
tinga	t AC i AK ŋ AF a AK
tingala	t AC i AK ŋ AF a AK l AD a AK ʔ AJ
tingalaan	t AC i AK ŋ AF a AK l AD a AK a AK n AF
tingid	t AC i AK ŋ AF i AK d AC
tingin	t AC i AK ŋ AF i AK n AF
tinidor	t AC i AK n AF i AK d AC o AM ɾ BD
tinig	t AC i AK n AF i AK ɡ AC
tinik	t AC i AK n AF i AK k AC
tinikling	t AC i AK n AF i AK k AC l AD i AK ŋ AF
tinta	t AC i AK n AF t AC a AK
tio	t AC j AB o AM
tiongco	t AC i AK o AM ŋ AF k AC o AM
tiozon	t AC j AB o AM s AH o AM n AF
tipaklong	t AC i AK p AG a AK k AC l AD o AM ŋ AF
tipon	t AC i AK p AG o AM n AF
tira	t AC i AK ɾ BD a AK
tiraniya	t AC i AK ɾ BD a AK n AF i AK a AK
tirik	t AC i AK ɾ BD i AK k AC
tiris	t AC i AK ɾ BD i AK s AH
tirona	t AC i AK ɾ BD o AM n AF a AK
tisod	t AC i AK s AH o AM d AC
tita	t AC i AK t AC a AK
tito	t AC i AK t AC o AM ʔ AJ
tiu	t AC j AB uː AN
tiwala	t AC i AK w AI a AK l AD a AK ʔ AJ
tiwali	t AC i AK w AI a AK l AD i AK ʔ AJ
tiya	t AC i AK a AK
tiyaga	t AC i AK a AK ɡ AC a AK ʔ AJ
tiyahin	t AC ʃ AH a AK h AA i AK n AF
tiyan	t AC i AK a AK n AF
tiyanak	t AC i AK a AK n AF a AK k AC
tiyangge	t AC i AK a AK ŋ AF ɡ AC ɛ AK ʔ AJ
tiyo	t AC i AK o AM
tiyubibo	t AC i AK j AB u AM b AG i AK b AG ɔ AM
tiyuhin	t AC ʃ AH u AM h AA i AK n AF
to	t AC o AM
tonelada	t AC o AM n AF ɛ AK l AD a AK d AC a AK
tong	t AC o AM ŋ AF
topacio	t AC o AM p AG a AK s AH j AB o AM
tore	t AC o AM ɾ BD ɛ AK
torotot	t AC o AM ɾ BD o AM t AC o AM t AC
torrecampo	t AC o AM ɾ BD ɾ BD ɛ AK k AC a AK m AE p AG o AM
totanes	t AC o AM t AC a AK n AF ɛ AK s AH
trabaho	t AC r BA a AK b AG a AK h AA o AM
trangkaso	t AC ɾ BD a AK ŋ AF k AC a AK s AH o AM
trapik	t AC ɾ BD a AK p AG i AK k AC
traqueña	t AC ɾ BD a AK k AC ɛ AK ɲ AF a AK
tratado	t AC ɾ BD a AK t AC a AK d AC o AM
trato	t AC ɾ BD a AK t AC o AM
traydor	t AC ɾ BD a AK i AK d AC o AM ɾ BD
tria	t AC ɾ BD i AK a AK
triguhan	t AC r BA ɪ AK ɡ AC ʊ AM h AA a AK n AF
trillanes	t AC ɾ BD i AK l AD l AD a AK n AF ɛ AK s AH
trip	t AC ɾ BD i AK p AG
tropatuts	t AC r BA o AM p AG a AK t AC u AM t AC s AH
tsaka	t AC ʃ AH a AK k AC a AK
tsikinini	t AC ʃ AH i AK k AC i AK n AF i AK n AF i AK ʔ AJ
tsiklet	t AC ʃ AH i AK k AC l AD ɛ AK t AC
tsikot	t AC ʃ AH i AK k AC o AM t AC
tsina	t AC s AH i AK n AF a AK
tsinelas	t AC ʃ AH i AK n AF ɛ AK l AD a AK s AH
tsinoy	t AC s AH ɪ AK n AF ɔ AM ɪ AK
tsong	t AC ʃ AH o AM ŋ AF
tsonggo	t AC ʃ AH o AM ŋ AF ɡ AC o AM
tsugi	t AC ʃ AH u AM ɡ AC i AK
tsuper	t AC ʃ AH u AM p AG e AK ɾ BD
tuason	t AC w AI a AK s AH o AM n AF
tuba	t AC u AM b AG a AK
tubero	t AC u AM b AG ɛ AK ɾ BD o AM
tubig	t AC u AM b AG i AK ɡ AC
tubo	t AC u AM b AG o AM ʔ AJ
tubuhan	t AC u AM b AG u AM h AA a AK n AF
tugade	t AC u AM ɡ AC a AK d AC ɛ AK
tugtog	t AC u AM ɡ AC t AC o AM ɡ AC
tugtugin	t AC u AM ɡ AC t AC u AM ɡ AC i AK n AF
tuhod	t AC u AM h AA o AM d AC
tuklaw	t AC u AM k AC l AD a AK u AM
tukod	t AC u AM k AC o AM d AC
tukso	t AC u AM k AC s AH o AM
tulad	t AC u AM l AD a AK d AC
tulak	t AC u AM l AD a AK k AC
tulatod	t AC u AM l AD a AK t AC o AM d AC
tulay	t AC u AM l AD a AK i AK
tulingan	t AC u AM l AD i AK ŋ AF a AK n AF
tullao	t AC u AM l AD j AB a AK u AM
tulo	t AC u AM l AD o AM ʔ AJ
tulog	t AC u AM l AD o AM ɡ AC
tulong	t AC u AM l AD o AM ŋ AF
tuloy	t AC u AM l AD o AM i AK
tumaba	t AC u AM m AE a AK b AG a AK ʔ AJ
tumacder	t AC u AM m AE a AK k AC d AC ɛ AK ɾ BD
tumae	t AC u AM m AE a AK ʔ AJ ɛ AK
tumahimik	t AC u AM m AE a AK h AA i AK m AE i AK k AC
tumakbo	t AC u AM m AE a AK k AC b AG ɔ AM
tumalima	t AC u AM m AE a AK l AD i AK m AE a AK
tumalon	t AC u AM m AE a AK l AD o AM n AF
tumanggi	t AC u AM m AE a AK ŋ AF ɡ AC i AK
tumapon	t AC u AM m AE a AK p AG o AM n AF
tumawa	t AC u AM m AE a AK w AI a AK
tumayo	t AC u AM m AE a AK j AB o AM ʔ AJ
tumbaga	t AC u AM m AE b AG a AK ɡ AC a AK
tumbalik	t AC u AM m AE b AG a AK l AD i AK k AC
tumbok	t AC u AM m AE b AG o AM k AC
tumbong	t AC u AM m AE b AG o AM ŋ AF
tumimos	t AC u AM m AE i AK m AE o AM s AH
tumingala	t AC u AM m AE i AK ŋ AF a AK l AD a AK ʔ AJ
tumira	t AC u AM m AE i AK ɾ BD a AK
tumirik	t AC u AM m AE i AK r BA i AK k AC
tumpang	t AC u AM m AE p AG a AK ŋ AF
tumpok	t AC u AM m AE p AG o AM k AC
tumugtog	t AC u AM m AE u AM ɡ AC t AC o AM ɡ AC
tumukso	t AC u AM m AE u AM k AC s AH o AM
tumula	t AC u AM m AE u AM l AD a AK ʔ AJ
tumulong	t AC u AM m AE u AM l AD o AM ŋ AF
tunaw	t AC u AM n AF a AK w AI
tunay	t AC u AM n AF a AK i AK
tung	t AC u AM ŋ AF
tungaw	t AC u AM ŋ AF a AK u AM
tungkab	t AC u AM ŋ AF k AC a AK b AG
tungkod	t AC u AM ŋ AF k AC o AM d AC
tungkol	t AC u AM ŋ AF k AC o AM l AD
tungkos	t AC u AM ŋ AF k AC o AM s AH
tunog	t AC u AM n AF o AM ɡ AC
tunton	t AC u AM n AF t AC o AM n AF
tunugan	t AC u AM n AF u AM ɡ AC a AK n AF
tupad	t AC u AM p AG a AK d AC
tupi	t AC u AM p AG i AK ʔ AJ
turnilyo	t AC u AM ɾ BD n AF i AK l AD j AB o AM
turok	t AC u AM ɾ BD o AM k AC
tuso	t AC u AM s AH o AM
tutol	t AC u AM t AC o AM l AD
tutubi	t AC u AM t AC u AM b AG i AK
tuwa	t AC u AM w AI a AK ʔ AJ
tuwad	t AC u AM a AK d AC
tuwalya	t AC u AM a AK l AD j AB a AK
tuwang	t AC u AM a AK ŋ AF
ty	t AC iː AL
uang	u AM ʔ AJ a AK ŋ AF
ubad	ʔ AJ u AM b AG a AK d AC
ubalde	u AM b AG a AK l AD d AC e AK
ubas	ʔ AJ u AM b AG a AK s AH
ubasan	ʔ AJ u AM b AG a AK s AH a AK n AF
ubo	ʔ AJ u AM b AG o AM ʔ AJ
udyukan	ʔ AJ u AM d AC j AB u AM k AC a AK n AF
ugat	ʔ AJ u AM ɡ AC a AK t AC
uhaw	ʔ AJ u AM h AA a AK w AI
ulam	ʔ AJ u AM l AD a AK m AE
ulep	ʔ AJ u AM l AD ɛ AK p AG
ulila	ʔ AJ u AM l AD i AK l AD a AK
uling	ʔ AJ u AM l AD i AK ŋ AF
ulo	u AM l AD o AM
umabay	ʔ AJ u AM m AE a AK b AG a AK j AB
umagahas	ʔ AJ u AM m AE a AK ɡ AC a AK h AA a AK s AH
umakyat	ʔ AJ u AM m AE a AK k AC j AB a AK t AC
umalis	ʔ AJ u AM m AE a AK l AD i AK s AH
umang	ʔ AJ u AM m AE a AK ŋ AF
umanta	ʔ AJ u AM m AE a AK n AF t AC a AK
umaraw	u AM m AE a AK r BA a AK w AI
umasa	ʔ AJ u AM m AE a AK s AH a AK
umasinta	ʔ AJ u AM m AE a AK s AH i AK n AF t AC a AK
umawat	ʔ AJ u AM m AE a AK w AI a AK t AC
umawit	ʔ AJ u AM m AE a AK w AI i AK t AC
umibig	ʔ AJ u AM m AE i AK b AG i AK ɡ AC
umihi	ʔ AJ u AM m AE i AK h AA i AK ʔ AJ
uminom	ʔ AJ u AM m AE i AK n AF o AM m AE
umiwas	ʔ AJ u AM m AE i AK w AI a AK s AH
umiyak	ʔ AJ u AM m AE i AK j AB a AK k AC
umpisa	ʔ AJ u AM m AE p AG i AK s AH a AK
umuha	ʔ AJ u AM m AE u AM h AA a AK ʔ AJ
umunlad	ʔ AJ u AM m AE u AM n AF l AD a AK d AC
umupo	ʔ AJ u AM m AE u AM p AG o AM ʔ AJ
umutot	ʔ AJ u AM m AE u AM t AC o AM t AC
umuwi	ʔ AJ u AM m AE u AM w AI i AK ʔ AJ
unan	u AM n AF a AK n AF
untalan	ʔ AJ u AM n AF t AC a AK l AD a AK n AF
upa	ʔ AJ u AM p AG a AK
upaw	ʔ AJ u AM p AG a AK w AI
uriarte	ʔ AJ u AM ɾ BD j AB a AK ɾ BD t AC ɛ AK
ursua	ʔ AJ u AM ɾ BD s AH u AM a AK
usap	ʔ AJ u AM s AH a AK p AG
usapan	u AM s AH a AK p AG a AK n AF
usisero	ʔ AJ u AM s AH i AK s AH ɛ AK ɾ BD o AM
usog	u AM s AH o AM ɡ AC
utak	ʔ AJ u AM t AC a AK k AC
utang	u AM t AC a AK ŋ AF
utong	ʔ AJ u AM t AC o AM ŋ AF
utot	ʔ AJ u AM t AC o AM t AC
uwak	ʔ AJ u AM a AK k AC
uwang	u AM w AI a AK ŋ AF
uwi	ʔ AJ u AM w AI i AK ʔ AJ
uwian	u AM w AI i AK a AK n AF
uy	u AM i AK
uyaw	ʔ AJ u AM j AB a AK w AI
valera	b AG a AK l AD ɛ AK ɾ BD a AK
valle	b AG a AK l AD l AD ɛ AK
valmores	b AG a AK l AD m AE o AM ɾ BD ɛ AK s AH
vangie	b AG a AK n AF d AC ʒ AH i AK
varias	b AG a AK ɾ BD i AK a AK s AH
varona	b AG a AK ɾ BD o AM n AF a AK
vecino	b AG ɛ AK s AH i AK n AF o AM
velarde	b AG ɛ AK l AD a AK ɾ BD d AC ɛ AK
velasquez	b AG ɛ AK l AD a AK s AH k AC ɛ AK s AH
velez	b AG ɛ AK l AD ɛ AK s AH
veloria	b AG ɛ AK l AD o AM ɾ BD j AB a AK
veneracion	b AG ɛ AK n AF ɛ AK ɾ BD a AK s AH j AB o AM n AF
venturina	b AG ɛ AK n AF t AC u AM ɾ BD i AK n AF a AK
versoza	b AG ɛ AK ɾ BD s AH o AM s AH a AK
viernes	b AG j AB ɛ AK ɾ BD n AF ɛ AK s AH
vigilante	b AG i AK d AC ʒ AH i AK l AD a AK n AF t AC e AK
villablanca	b AG i AK l AD l AD a AK b AG l AD a AK n AF k AC a AK
villacarlos	b AG i AK l AD l AD a AK k AC a AK ɾ BD l AD o AM s AH
villafranca	b AG i AK l AD l AD a AK p AG ɾ BD a AK n AF k AC a AK
villafuerte	b AG i AK l AD l AD a AK p AG w AI ɛ AK ɾ BD t AC ɛ AK
villagracia	b AG i AK l AD l AD a AK ɡ AC ɾ BD a AK s AH j AB a AK
villamater	b AG i AK l AD l AD a AK m AE a AK t AC ɛ AK ɾ BD
villamin	b AG i AK l AD l AD a AK m AE i AK n AF
villamor	b AG i AK l AD l AD a AK m AE o AM ɾ BD
villapando	b AG i AK l AD l AD a AK p AG a AK n AF d AC o AM
villareal	b AG i AK l AD l AD a AK ɾ BD ɛ AK a AK l AD
villarino	b AG i AK l AD l AD a AK ɾ BD i AK n AF o AM
villaruz	b AG i AK l AD l AD a AK ɾ BD u AM s AH
villaseñor	b AG i AK l AD l AD a AK s AH ɛ AK ɲ AF o AM ɾ BD
villasis	b AG i AK l AD l AD a AK s AH i AK s AH
villaverde	b AG i AK l AD l AD a AK b AG ɛ AK ɾ BD d AC ɛ AK
villavicencio	b AG i AK l AD l AD a AK b AG i AK s AH ɛ AK n AF s AH j AB o AM
villegas	b AG i AK l AD l AD ɛ AK ɡ AC a AK s AH
vinoya	b AG i AK n AF o AM j AB a AK
virata	b AG i AK ɾ BD a AK t AC a AK
virrey	b AG i AK ɾ BD ɾ BD ɛ AK i AK
visaya	b AG i AK s AH a AK j AB a AK ʔ AJ
volante	b AG o AM l AD a AK n AF t AC ɛ AK
waag	w AI a AK ʔ AJ a AK ɡ AC
waagan	w AI a AK ʔ AJ a AK ɡ AC a AK n AF
waak	w AI a AK ʔ AJ a AK k AC
waang	w AI a AK ʔ AJ a AK ŋ AF
wadwad	w AI a AK d AC w AI a AK d AC
wagayway	w AI a AK ɡ AC a AK j AB w AI a AK j AB
wagaywayan	w AI a AK ɡ AC a AK j AB w AI a AK j AB a AK n AF
wagi	w AI a AK ɡ AC i AK
wagiswis	w AI a AK ɡ AC i AK s AH w AI i AK s AH
wagwag	w AI a AK ɡ AC w AI a AK ɡ AC
wakaak	w AI a AK k AC a AK ʔ AJ a AK k AC
wakas	w AI a AK k AC a AK s AH
waklas	w AI a AK k AC l AD a AK s AH
wakwak	w AI a AK k AC w AI a AK k AC
wakya	w AI a AK k AC j AB a AK ʔ AJ
wala	w AI a AK l AD a AK ʔ AJ
walawad	w AI a AK l AD a AK w AI a AK d AC
waldas	w AI a AK l AD d AC a AK s AH
waley	w AI a AK l AD e AK ɪ AK
walidwid	w AI a AK l AD i AK d AC w AI i AK d AC
waling	w AI a AK l AD i AK ŋ AF
walingwaling	w AI a AK l AD i AK ŋ AF w AI a AK l AD i AK ŋ AF
waliswis	w AI a AK l AD i AK s AH w AI i AK s AH
waliwali	w AI a AK l AD i AK w AI a AK l AD i AK
walna	w AI a AK l AD n AF a AK ʔ AJ
walo	w AI a AK l AD o AM
walumpu	w AI a AK l AD u AM m AE p AG u AM ʔ AJ
walundaan	w AI a AK l AD u AM n AF d AC a AK ʔ AJ a AK n AF
walunlibo	w AI a AK l AD u AM n AF l AD i AK b AG o AM
walwal	w AI a AK l AD w AI a AK l AD
wang	w AI a AK ŋ AF
wangis	w AI a AK ŋ AF i AK s AH
wani	w AI a AK n AF i AK ʔ AJ
waray	w AI a AK ɾ BD a AK j AB
wardi	w AI a AK ɾ BD d AC i AK
wasak	w AI a AK s AH a AK k AC
watawat	w AI a AK t AC a AK w AI a AK t AC
wating	w AI a AK t AC i AK ŋ AF
wawa	w AI a AK w AI a AK ʔ AJ
webera	w AI e AK b AG e AK ɾ BD a AK
wee	w AI i AK
welga	w AI e AK l AD ɡ AC a AK
werpa	w AI e AK r BA p AG a AK
wigwig	w AI i AK ɡ AC w AI i AK ɡ AC
wika	w AI i AK k AC a AK ʔ AJ
wiklas	w AI i AK k AC l AD a AK s AH
wilik	w AI i AK l AD i AK k AC
wiliwid	w AI i AK l AD i AK w AI i AK d AC
windang	w AI i AK n AF d AC a AK ŋ AF
wingkag	w AI i AK ŋ AF k AC a AK ɡ AC
wisik	w AI i AK s AH i AK k AC
wisit	w AI i AK s AH i AK t AC
wiski	w AI i AK s AH k AC i AK
wiswis	w AI i AK s AH w AI i AK s AH
witwit	w AI i AK t AC w AI i AK t AC
wong	w AI o AM ŋ AF
wu	w AI uː AN
yaang	j AB a AK ʔ AJ a AK ŋ AF
yagban	j AB a AK ɡ AC b AG a AK n AF
yagit	j AB a AK ɡ AC i AK t AC
yakap	j AB a AK k AC a AK p AG
yalung	j AB a AK l AD u AM ŋ AF
yaman	j AB a AK m AE a AK n AF
yamutmot	j AB a AK m AE u AM t AC m AE o AM t AC
yan	j AB a AK n AF
yang	j AB a AK ŋ AF
yangasngas	j AB a AK ŋ AF a AK s AH ŋ AF a AK s AH
yangit	j AB a AK ŋ AF i AK t AC
yangot	j AB a AK ŋ AF o AM t AC
yanig	j AB a AK n AF i AK ɡ AC
yano	j AB a AK n AF o AM
yantas	j AB a AK n AF t AC a AK s AH
yantok	j AB a AK n AF t AC o AM k AC
yao	j AB a AK w AI
yaon	j AB a AK o AM n AF
yap	j AB a AK p AG
yarda	j AB a AK ɾ BD d AC a AK
yasay	j AB a AK s AH a AK i AK
yata	j AB a AK t AC a AK ʔ AJ
yatab	j AB a AK t AC a AK b AG
yatco	j AB a AK t AC k AC o AM
yate	j AB a AK t AC e AK
yatyat	j AB a AK t AC j AB a AK t AC
ybañez	ʔ AJ i AK b AG a AK ɲ AF ɛ AK s AH
yee	j AB i AK
yelo	j AB e AK l AD o AM
yepes	j AB ɛ AK p AG ɛ AK s AH
yongco	j AB ɔ AM ŋ AF k AC o AM
young	j AB ɐ AM ŋ AF
yukyok	j AB u AM k AC j AB o AM k AC
yumabang	j AB u AM m AE a AK b AG a AK ŋ AF
yumabong	j AB u AM m AE a AK b AG o AM ŋ AF
yumahod	j AB u AM m AE a AK h AA o AM d AC
yumakap	j AB u AM m AE a AK k AC a AK p AG
yumaman	j AB u AM m AE a AK m AE a AK n AF
yumamot	j AB u AM m AE a AK m AE o AM t AC
yumanig	j AB u AM m AE a AK n AF i AK ɡ AC
yumari	j AB u AM m AE a AK ɾ BD i AK ʔ AJ
yumasak	j AB u AM m AE a AK s AH a AK k AC
yumukdo	j AB u AM m AE u AM k AC d AC o AM
yumuko	j AB u AM m AE u AM k AC o AM ʔ AJ
yumurak	j AB u AM m AE u AM ɾ BD a AK k AC
yung	j AB ʊ AM ŋ AF
yungib	j AB u AM ŋ AF i AK b AG
yuvienco	j AB u AM b AG i AK ɛ AK n AF k AC o AM
yñiguez	j AB ɲ AF i AK ɡ AC ɛ AK s AH
zafra	s AH a AK p AG ɾ BD a AK
zaide	s AH a AK i AK d AC ɛ AK
zapanta	s AH a AK p AG a AK n AF t AC a AK
zavalla	s AH a AK b AG a AK l AD l AD a AK
zhang	t AC ʃ AH o AM ŋ AF
zoleta	s AH o AM l AD ɛ AK t AC a AK
zubiri	a AK b AG a AK d AC j AB a AK n AF o AM
zuñiga	s AH u AM ɲ AF i AK ɡ AC a AK
