'y	ɪ AM
aba	ʔ AL ɐ BA b AG a AM ʔ AL
abalos	ʔ AL ɐ BA b AG ɐ BA l AD o BA s AH
abandonado	ʔ AL ɐ BA b AG ɐ BA n AF d AI o BA n AF ɐ BA d AI o BA
abaniko	ʔ AL ɐ BA b AG ɐ BA n AF ɪ AM x BC o BA
abejuela	ʔ AL ɐ BA b AG ɛ AM d AI ʒ AH ʊ BA ɛ AM l AD ɐ BA
abelgas	ʔ AL ɐ BA b AG ɛ AM l AD ɡ AC ɐ BA s AH
abellera	ʔ AL ɐ BA b AG ɛ AM l AD l AD ɛ AM ɾ BE ɐ BA
abing	ʔ AL ɐ BA b AG ɪ AM ŋ AK
abisuhan	ʔ AL ɐ BA b AG ɪ AM s AH ʊ BA h AA ɐ BA n AF
abo	ʔ AL ɐ BA b AG o BA
abrazado	ʔ AL ɐ BA b AG ɾ BE ɐ BA s AH ɐ BA d AI o BA
abrenica	ʔ AL ɐ BA b AG ɾ BE ɛ AM n AF ɪ AM x BC ɐ BA
abueg	ʔ AL ɐ BA b AG w AJ ɛ AM ɡ AC
abulencia	ʔ AL ɐ BA b AG ʊ BA l AD ɛ AM n AF ʃ AH ɐ BA
abusado	ʔ AL ɐ BA b AG ʊ BA s AH ɐ BA d AI o BA
abyad	ʔ AL ɐ BA b AG j AB ɐ BA d AI
abyador	ʔ AL ɐ BA b AG j AB ɐ BA d AI o BA ɾ BE
acierto	ʔ AL ɐ BA ʃ AH ɛ AM ɾ BE t AI o BA
acorda	ʔ AL ɐ BA x BC o BA ɾ BE d AI ɐ BA
acuzar	ʔ AL ɐ BA x BC ʊ BA s AH ɐ BA ɾ BE
adajar	ʔ AL ɐ BA d AI ɐ BA d AI ʒ AH ɐ BA ɾ BE
adik	ʔ AL a AM d AI ɪ AM k AC
adlawan	ʔ AL ɐ BA d AI l AD ɐ BA w AJ ɐ BA n AF
adres	ʔ AL ɐ BA d AI ɾ BE ɛ AM s AH
adrias	ʔ AL ɐ BA d AI ɾ BE ɪ AM ɐ BA s AH
agapay	ʔ AL ɐ BA ɰ AB ɐ BA p AG a AM ɪ̯ AB
agila	ʔ AL a AM ɰ AB ɪ AM l AD ɐ BA
agiw	ʔ AL a AM ɰ AB ɪ AM ʊ̯ AJ
agrabyado	ʔ AL ɐ BA ɡ AC ɾ BE ɐ BA b AG j AB a AM d AI o BA
aguas	ʔ AL ɐ BA ɰ AB ʊ BA ɐ BA s AH
aguda	ʔ AL ɐ BA ɰ AB ʊ BA d AI ɐ BA
aguilera	ʔ AL ɐ BA ɰ AB ɪ AM l AD ɛ AM ɾ BE ɐ BA
aguirre	ʔ AL ɐ BA ɰ AB ɪ AM ɾ BE ɛ AM
agustin	ʔ AL ɐ BA ɰ AB ʊ BA s AH t AI ɪ AM n AF
agwat	ʔ AL ɐ BA ɡ AC w AJ ɐ BA t AI
aksayado	ʔ AL ɐ BA k AC s AH ɐ BA j AB a AM d AI o BA
alambre	ʔ AL ɐ BA l AD a AM m AE b AG ɾ BE ɛ AM
alcaide	ʔ AL ɐ BA l AD k AC a AM ɪ̯ AB d AI ɛ AM
aldover	ʔ AL ɐ BA l AD d AI o BA b AG ɛ AM ɾ BE
alegre	ʔ AL ɐ BA l AD ɛ AM ɡ AC ɾ BE ɛ AM
alila	ʔ AL ɐ BA l AD i AM l AD ɐ BA ʔ AL
alimasag	ʔ AL ɐ BA l AD ɪ AM m AE a AM s AH ɐ BA ɡ AC
alipin	ʔ AL ɐ BA l AD ɪ AM p AG ɪ AM n AF
alis	ʔ AL a AM l AD ɪ AM s AH
alkansya	a AM l AD k AC a AM n AF ɕ BC a AM
almaden	ʔ AL ɐ BA l AD m AE ɐ BA d AI ɛ AM n AF
almarez	ʔ AL ɐ BA l AD m AE ɐ BA ɾ BE ɛ AM s AH
almario	ʔ AL ɐ BA l AD m AE ɐ BA ɾ BE ɪ AM o BA
almendrala	ʔ AL ɐ BA l AD m AE ɛ AM n AF d AI ɾ BE ɐ BA l AD ɐ BA
almirol	ʔ AL ɐ BA l AD m AE ɪ AM ɾ BE o BA l AD
alonte	ʔ AL ɐ BA l AD o BA n AF t AI ɛ AM
alonto	ʔ AL ɐ BA l AD o BA n AF t AI o BA
alperes	ʔ AL ɐ BA l AD p AG ɛ AM ɾ BE ɛ AM s AH
altapresyon	ʔ AL ɐ BA l AD t AI ɐ BA p AG ɾ BE ɛ AM ʃ AH o BA n AF
alviar	ʔ AL ɐ BA l AD b AG j AB ɐ BA ɾ BE
amante	ʔ AL ɐ BA m AE ɐ BA n AF t AI ɛ AM
ambag	ʔ AL ɐ BA m AE b AG a AM ɡ AC
amerikana	ʔ AL ɐ BA m AE ɛ AM ɾ BE ɪ AM x BC a AM n AF ɐ BA
amin	ʔ AL a AM m AE ɪ AM n AF
aminado	ʔ AL ɐ BA m AE ɪ AM n AF ɐ BA d AI o BA
amon	ʔ AL ɐ BA m AE o BA n AF
amoranto	ʔ AL ɐ BA m AE o BA ɾ BE ɐ BA n AF t AI o BA
ampaw	ʔ AL ɐ BA m AE p AG a AM ʊ̯ AJ
amurao	ʔ AL ɐ BA m AE ʊ BA ɾ BE a AM ʊ̯ AJ
analisis	ʔ AL ɐ BA n AF ɐ BA l AD i AM s AH ɪ AM s AH
anatomiya	ʔ AL ɐ BA n AF ɐ BA t AI o BA m AE i AM ɐ BA
anay	ʔ AL a AM n AF a AM ɪ̯ AB
anayin	ʔ AL ɐ BA n AF ɐ BA j AB ɪ AM n AF
andal	ʔ AL ɐ BA n AF d AI ɐ BA l AD
anggo	ʔ AL ɐ BA ŋ AK ɡ AC o BA
anghel	ʔ AL ɐ BA ŋ AK h AA ɛ AM l AD
angkla	ʔ AL ɐ BA ŋ AK k AC l AD ɐ BA
ango	ʔ AL ɐ BA ŋ AK o BA
angot	ʔ AL ɐ BA ŋ AK o BA t AI
anim	ʔ AL a AM n AF ɪ AM m AE
anis	ʔ AL ɐ BA n AF i AM s AH
antipona	ʔ AL ɐ BA n AF t AI i AM p AG o BA n AF ɐ BA
antok	ʔ AL ɐ BA n AF t AI o BA k AC
antukin	ʔ AL ɐ BA n AF t AI ʊ BA x BC ɪ AM n AF
anyayahan	ʔ AL ɐ BA ɲ AK ɐ BA j AB ɐ BA h AA ɐ BA n AF
apela	ʔ AL ɐ BA p AG ɛ AM l AD a AM
apilado	ʔ AL ɐ BA p AG ɪ AM l AD ɐ BA d AI o BA
apostasiya	ʔ AL ɐ BA p AG o BA s AH t AI ɐ BA s AH ɪ AM ɐ BA
aranda	ʔ AL ɐ BA ɾ BE ɐ BA n AF d AI ɐ BA
aray	ʔ AL ɐ BA ɾ BE a AM ɪ̯ AB
arañas	ʔ AL ɐ BA ɾ BE ɐ BA ɲ AK ɐ BA s AH
arce	ʔ AL ɐ BA ɾ BE s AH ɛ AM
arcega	ʔ AL ɐ BA ɾ BE s AH ɛ AM ɰ AB ɐ BA
arceo	ʔ AL ɐ BA ɾ BE s AH ɛ AM o BA
arcilla	ʔ AL ɐ BA ɾ BE s AH ɪ AM l AD l AD ɐ BA
arcillas	ʔ AL ɐ BA ɾ BE s AH ɪ AM l AD l AD ɐ BA s AH
arcinas	ʔ AL ɐ BA ɾ BE s AH ɪ AM n AF ɐ BA s AH
arenas	ʔ AL ɐ BA ɾ BE ɛ AM n AF ɐ BA s AH
arevalo	ʔ AL ɐ BA ɾ BE ɛ AM b AG ɐ BA l AD o BA
argente	ʔ AL ɐ BA ɾ BE ɡ AC ɛ AM n AF t AI ɛ AM
arkila	ʔ AL ɐ BA ɾ BE k AC ɪ AM l AD a AM
arquiza	ʔ AL ɐ BA ɾ BE k AC ɪ AM s AH ɐ BA
arriola	ʔ AL ɐ BA ɾ BE ɪ AM o BA l AD ɐ BA
arrogante	ʔ AL ɐ BA ɾ BE o BA ɰ AB ɐ BA n AF t AI ɛ AM
artiaga	ʔ AL ɐ BA ɾ BE t AI ʃ AH ɐ BA ɰ AB ɐ BA
arzadon	ʔ AL ɐ BA ɾ BE s AH ɐ BA d AI o BA n AF
asilo	ʔ AL ɐ BA s AH ɪ AM l AD o BA
asinta	ʔ AL ɐ BA s AH ɪ AM n AF t AI a AM
asul	ʔ AL ɐ BA s AH ʊ BA l AD
asungot	ʔ AL ɐ BA s AH u BA ŋ AK o BA t AI
at	ʔ AL ɐ BA t AI
ataul	ʔ AL ɐ BA t AI ɐ BA ʔ AL u BA l AD
atendido	ʔ AL ɐ BA t AI ɛ AM n AF d AI ɪ AM d AI o BA
avanceña	ʔ AL ɐ BA b AG ɐ BA n AF s AH ɛ AM ɲ AK ɐ BA
avendaño	ʔ AL ɐ BA b AG ɛ AM n AF d AI ɐ BA ɲ AK o BA
awat	ʔ AL a AM w AJ ɐ BA t AI
ay	ʔ AL a AM ɪ̯ AB
ayson	ʔ AL a AM ɪ̯ AB s AH o BA n AF
azaña	ʔ AL ɐ BA s AH ɐ BA ɲ AK ɐ BA
azucena	ʔ AL ɐ BA s AH ʊ BA s AH ɛ AM n AF ɐ BA
babae	b AG ɐ BA b AG a AM ʔ AL ɛ AM
babaero	b AG ɐ BA b AG ɐ BA ʔ AL ɛ AM ɾ BE o BA
babaihin	b AG ɐ BA b AG a AM ɪ̯ AB h AA ɪ AM n AF
babao	b AG ɐ BA b AG a AM ʊ̯ AJ
babasa	b AG ɐ BA b AG ɐ BA s AH ɐ BA
babasagin	b AG ɐ BA b AG ɐ BA s AH ɐ BA ɰ AB ɪ AM n AF
babasahin	b AG ɐ BA b AG ɐ BA s AH ɐ BA h AA ɪ AM n AF
bacani	b AG ɐ BA x BC ɐ BA n AF ɪ AM
baclig	b AG ɐ BA k AC l AD ɪ AM ɡ AC
bacsa	b AG ɐ BA k AC s AH ɐ BA
bactol	b AG ɐ BA k AC t AI o BA l AD
baculi	b AG ɐ BA x BC ʊ BA l AD ɪ AM
badayos	b AG ɐ BA d AI ɐ BA j AB o BA s AH
bagaman	b AG ɐ BA ɰ AB ɐ BA m AE a AM n AF
bagamat	b AG ɐ BA ɰ AB ɐ BA m AE a AM t AI
bagang	b AG ɐ BA ɰ AB a AM ŋ AK
bagaoisan	b AG ɐ BA ɰ AB ɐ BA w AJ ɪ AM s AH ɐ BA n AF
baging	b AG a AM ɰ AB ɪ AM ŋ AK
bagon	b AG ɐ BA ɰ AB o BA n AF
bagsik	b AG ɐ BA ɡ AC s AH i AM k AC
bagsit	b AG ɐ BA ɡ AC s AH ɪ AM t AI
bahaghari	b AG ɐ BA h AA ɐ BA ɡ AC h AA a AM ɾ BE ɪ AM ʔ AL
bahing	b AG ɐ BA h AA i AM ŋ AK
baka	b AG ɐ BA x BC ɐ BA
bakahan	b AG ɐ BA x BC ɐ BA h AA a AM n AF
bakas	b AG ɐ BA x BC a AM s AH
baklad	b AG ɐ BA k AC l AD a AM d AI
bakulaw	b AG ɐ BA x BC u BA l AD a AM ʊ̯ AJ
bakuna	b AG ɐ BA x BC ʊ BA n AF ɐ BA
bakunahan	b AG ɐ BA x BC ʊ BA n AF ɐ BA h AA ɐ BA n AF
bakuran	b AG ɐ BA x BC ʊ BA ɾ BE ɐ BA n AF
balae	b AG ɐ BA l AD ɐ BA ʔ AL ɛ AM
balaguer	b AG ɐ BA l AD ɐ BA ɰ AB ɛ AM ɾ BE
balahibo	b AG ɐ BA l AD ɐ BA h AA i AM b AG o BA
balakubak	b AG ɐ BA l AD ɐ BA x BC u BA b AG ɐ BA k AC
balasa	b AG ɐ BA l AD a AM s AH ɐ BA
balasabas	b AG ɐ BA l AD ɐ BA s AH ɐ BA b AG ɐ BA s AH
balato	b AG ɐ BA l AD a AM t AI o BA
balatong	b AG ɐ BA l AD a AM t AI o BA ŋ AK
balbas	b AG ɐ BA l AD b AG a AM s AH
baldonado	b AG ɐ BA l AD d AI o BA n AF ɐ BA d AI o BA
baligtad	b AG ɐ BA l AD ɪ AM ɡ AC t AI a AM d AI
balingit	b AG ɐ BA l AD ɪ AM ŋ AK ɪ AM t AI
balisacan	b AG ɐ BA l AD ɪ AM s AH ɐ BA x BC ɐ BA n AF
balite	b AG ɐ BA l AD ɪ AM t AI ɛ AM
balon	b AG ɐ BA l AD o BA n AF
baluga	b AG ɐ BA l AD ʊ BA ɰ AB ɐ BA ʔ AL
baluktot	b AG ɐ BA l AD ʊ BA k AC t AI o BA t AI
balwarte	b AG ɐ BA l AD w AJ a AM ɾ BE t AI ɛ AM
banawa	b AG ɐ BA n AF ɐ BA w AJ ɐ BA
bandila	b AG ɐ BA n AF d AI i AM l AD ɐ BA ʔ AL
bangaw	b AG a AM ŋ AK a AM ʊ̯ AJ
bangkay	b AG ɐ BA ŋ AK k AC a AM ɪ̯ AB
bangkiling	b AG ɐ BA ŋ AK k AC ɪ AM l AD i AM ŋ AK
bango	b AG ɐ BA ŋ AK o BA
baniaga	b AG ɐ BA ɲ AK ɐ BA ɰ AB ɐ BA
banig	b AG ɐ BA n AF i AM ɡ AC
banlaw	b AG ɐ BA n AF l AD a AM ʊ̯ AJ
banta	b AG ɐ BA n AF t AI a AM ʔ AL
bantay	b AG ɐ BA n AF t AI a AM ɪ̯ AB
bantog	b AG ɐ BA n AF t AI o BA ɡ AC
banyaga	b AG ɐ BA ɲ AK a AM ɰ AB ɐ BA ʔ AL
baog	b AG ɐ BA ʔ AL o BA ɡ AC
baon	b AG ɐ BA ʔ AL o BA n AF
baquiran	b AG ɐ BA x BC ɪ AM ɾ BE ɐ BA n AF
bara	b AG ɐ BA ɾ BE a AM
barado	b AG ɐ BA ɾ BE ɐ BA d AI o BA
baraha	b AG ɐ BA ɾ BE a AM h AA ɐ BA
barbosa	b AG ɐ BA ɾ BE b AG o BA s AH ɐ BA
barquilla	b AG ɐ BA ɾ BE k AC ɪ AM l AD l AD ɐ BA
barrios	b AG ɐ BA ɾ BE j AB o BA s AH
bartolome	b AG ɐ BA ɾ BE t AI o BA l AD o BA m AE ɛ AM
barya	b AG ɐ BA ɾ BE j AB a AM
basa	b AG ɐ BA s AH ɐ BA
basahan	b AG ɐ BA s AH ɐ BA h AA ɐ BA n AF
basco	b AG ɐ BA s AH k AC o BA
base	b AG ɐ BA s AH ɛ AM
basehan	b AG ɐ BA s AH ɛ AM h AA a AM n AF
basilan	b AG ɐ BA s AH ɪ AM l AD ɐ BA n AF
bastos	b AG ɐ BA s AH t AI o BA s AH
basurahan	b AG ɐ BA s AH ʊ BA ɾ BE ɐ BA h AA a AM n AF
basurero	b AG ɐ BA s AH ʊ BA ɾ BE ɛ AM ɾ BE o BA
batallones	b AG ɐ BA t AI ɐ BA l AD l AD o BA n AF ɛ AM s AH
batalyon	b AG ɐ BA t AI ɐ BA l AD j AB o BA n AF
batangas	b AG ɐ BA t AI ɐ BA ŋ AK ɡ AC ɐ BA s AH
bati	b AG ɐ BA t AI i AM ʔ AL
batugan	b AG ɐ BA t AI ʊ BA ɰ AB ɐ BA n AF
batukan	b AG ɐ BA t AI ʊ BA x BC ɐ BA n AF
batya	b AG ɐ BA t AI ʃ AH a AM ʔ AL
baunan	b AG ɐ BA ʔ AL ʊ BA n AF a AM n AF
bauzon	b AG a AM ʊ̯ AJ s AH o BA n AF
bayabas	b AG ɐ BA j AB ɐ BA b AG ɐ BA s AH
bayad	b AG ɐ BA j AB ɐ BA d AI
bayawak	b AG ɐ BA j AB ɐ BA w AJ ɐ BA k AC
baybayin	b AG a AM i̯ AB b AG aː AN j AB ɪ AM n AF
bayong	b AG ɐ BA j AB o BA ŋ AK
baywang	b AG ɛ AM w AJ ɐ BA ŋ AK
bañaga	b AG ɐ BA ɲ AK ɐ BA ɰ AB ɐ BA
bejasa	b AG ɛ AM d AI ʒ AH ɐ BA s AH ɐ BA
belhiko	b AG ɛ AM l AD h AA ɪ AM x BC o BA
beltran	b AG ɛ AM l AD t AI ɾ BE ɐ BA n AF
benepisyo	b AG ɛ AM n AF ɛ AM p AG i AM ʃ AH o BA
benipayo	b AG ɛ AM n AF ɪ AM p AG ɐ BA j AB o BA
bergonia	b AG ɛ AM ɾ BE ɡ AC o BA ɲ AK ɐ BA
bermudez	b AG ɛ AM ɾ BE m AE ʊ BA d AI ɛ AM s AH
bibingka	b AG ɪ AM b AG ɪ AM ŋ AK k AC ɐ BA
bigat	b AG ɪ AM ɰ AB a AM t AI
bigti	b AG ɪ AM ɡ AC t AI i AM ʔ AL
bihag	b AG ɪ AM h AA a AM ɡ AC
bihira	b AG ɪ AM h AA i AM ɾ BE ɐ BA ʔ AL
bihis	b AG ɪ AM h AA i AM s AH
biik	b AG ɪ AM i AM k AC
bilangguan	b AG ɪ AM l AD ɐ BA ŋ AK ɡ AC ʊ BA ʔ AL ɐ BA n AF
bilao	b AG ɪ AM l AD a AM o BA
bilas	b AG ɪ AM l AD a AM s AH
bilot	b AG ɪ AM l AD o BA t AI
bilugan	b AG ɪ AM l AD ʊ BA ɰ AB ɐ BA n AF
binabae	b AG ɪ AM n AF ɐ BA b AG ɐ BA ʔ AL ɛ AM
binatilyo	b AG ɪ AM n AF ɐ BA t AI ɪ AM l AD j AB o BA
bingwit	b AG ɪ AM ŋ AK w AJ i AM t AI
bintang	b AG ɪ AM n AF t AI a AM ŋ AK
bintog	b AG ɪ AM n AF t AI o BA ɡ AC
binuya	b AG ɪ AM n AF ʊ BA j AB ɐ BA
bisaya	b AG ɪ AM s AH a AM j AB ɐ BA ʔ AL
biscocho	b AG ɪ AM s AH k AC o BA t AI ʃ AH o BA
bisikleta	b AG ɪ AM s AH ɪ AM k AC l AD ɛ AM t AI ɐ BA
bisita	b AG ɪ AM s AH i AM t AI ɐ BA
bitay	b AG i AM t AI a AM ɪ̯ AB
biyas	b AG j AB a AM s AH
biyaya	b AG j AB a AM j AB ɐ BA ʔ AL
biyuda	b AG j AB u BA d AI ɐ BA
bobadilla	b AG o BA b AG ɐ BA d AI ɪ AM l AD l AD ɐ BA
bodega	b AG o BA d AI ɛ AM ɰ AB ɐ BA
bolante	b AG o BA l AD ɐ BA n AF t AI ɛ AM
bolaños	b AG o BA l AD ɐ BA ɲ AK o BA s AH
boluntaryo	b AG o BA l AD ʊ BA n AF t AI ɐ BA ɾ BE j AB o BA
bonifacio	b AG o BA n AF ɪ AM f BD ɐ BA ʃ AH o BA
bonilla	b AG o BA n AF ɪ AM l AD l AD ɐ BA
boongaling	b AG o BA o BA ŋ AK ɡ AC ɐ BA l AD ɪ AM ŋ AK
borillo	b AG o BA ɾ BE ɪ AM l AD l AD o BA
borlaza	b AG o BA ɾ BE l AD ɐ BA s AH ɐ BA
botika	b AG o BA t AI ɪ AM x BC ɐ BA
brillantes	b AG ɾ BE ɪ AM l AD l AD ɐ BA n AF t AI ɛ AM s AH
bruha	b AG ɾ BE u BA h AA ɐ BA
bubog	b AG ʊ BA b AG o BA ɡ AC
bubuli	b AG ʊ BA b AG ʊ BA l AD i AM
budhi	b AG ʊ BA d AI h AA i AM ʔ AL
buenafe	b AG ʊ BA ɛ AM n AF ɐ BA p AG ɛ AM
buga	b AG ʊ BA ɰ AB a AM
bugarin	b AG ʊ BA ɰ AB ɐ BA ɾ BE ɪ AM n AF
bugaw	b AG u BA ɰ AB a AM ʊ̯ AJ
bugayong	b AG ʊ BA ɰ AB ɐ BA j AB o BA ŋ AK
bugtong	b AG ʊ BA ɡ AC t AI o BA ŋ AK
buhaghag	b AG ʊ BA h AA a AM ɡ AC h AA a AM ɡ AC
buhawi	b AG ʊ BA h AA a AM w AJ ɪ AM ʔ AL
bukambibig	b AG ʊ BA x BC ɐ BA m AE b AG ɪ AM b AG i AM ɡ AC
bukas	b AG ʊ BA x BC a AM s AH
bukbok	b AG ʊ BA k AC b AG o BA k AC
buking	b AG ʊ BA x BC i AM ŋ AK
bula	b AG ʊ BA l AD a AM ʔ AL
bulaan	b AG ʊ BA l AD ɐ BA ʔ AL ɐ BA n AF
bulahaw	b AG ʊ BA l AD a AM h AA a AM ʊ̯ AJ
bulalakaw	b AG ʊ BA l AD ɐ BA l AD a AM x BC a AM ʊ̯ AJ
bulanadi	b AG ʊ BA l AD ɐ BA n AF ɐ BA d AI ɪ AM
bulanhagui	b AG ʊ BA l AD ɐ BA ŋ AK h AA ɐ BA ɰ AB ɪ AM
bulati	b AG ʊ BA l AD ɐ BA t AI ɪ AM
bulaw	b AG u BA l AD a AM ʊ̯ AJ
bulbol	b AG ʊ BA l AD b AG o BA l AD
bulok	b AG ʊ BA l AD o BA k AC
bulutong	b AG ʊ BA l AD u BA t AI o BA ŋ AK
bulyaw	b AG ʊ BA l AD j AB a AM ʊ̯ AJ
bumahing	b AG ʊ BA m AE ɐ BA h AA ɪ AM ŋ AK
bumbunan	b AG u BA m AE b AG ʊ BA n AF ɐ BA n AF
bumiyahe	b AG ʊ BA m AE j AB a AM h AA ɛ AM
bunag	b AG ʊ BA n AF ɐ BA ɡ AC
bunga	b AG ʊ BA ŋ AK ɐ BA
bungkos	b AG ʊ BA ŋ AK k AC o BA s AH
bungo	b AG ʊ BA ŋ AK o BA ʔ AL
buno	b AG ʊ BA n AF o BA ʔ AL
bunso	b AG ʊ BA ŋ AK s AH o BA ʔ AL
bunyi	b AG ʊ BA ɲ AK ɪ AM
buo	b AG ʊ BA o BA ʔ AL
buol	b AG ʊ BA ʔ AL o BA l AD
buquid	b AG ʊ BA x BC ɪ AM d AI
burgis	b AG ʊ BA ɾ BE ɡ AC ɪ AM s AH
buryong	b AG ʊ BA ɾ BE j AB o BA ŋ AK
buson	b AG ʊ BA s AH o BA n AF
butac	b AG ʊ BA t AI ɐ BA k AC
butaka	b AG ʊ BA t AI a AM x BC ɐ BA
buto	b AG ʊ BA t AI ʔ AL o BA
buwag	b AG w AJ a AM ɡ AC
buwakaw	b AG w AJ a AM x BC a AM ʊ̯ AJ
buwanan	b AG ʊ BA ɐ BA n AF ɐ BA n AF
buwaya	b AG w AJ ɐ BA j AB ɐ BA
buweltahan	b AG w AJ ɛ AM l AD t AI ɐ BA h AA a AM n AF
buwisit	b AG w AJ i AM s AH ɪ AM t AI
cabahug	k AC x BC ɐ BA b AG ɐ BA h AA ʊ BA ɡ AC
cabanayan	k AC x BC ɐ BA b AG ɐ BA n AF ɐ BA j AB ɐ BA n AF
cabanlit	k AC x BC ɐ BA b AG ɐ BA n AF l AD ɪ AM t AI
cabasag	k AC x BC ɐ BA b AG ɐ BA s AH ɐ BA ɡ AC
cabiling	k AC x BC ɐ BA b AG ɪ AM l AD ɪ AM ŋ AK
cabral	k AC x BC ɐ BA b AG ɾ BE ɐ BA l AD
cabuhat	k AC x BC ɐ BA b AG ʊ BA h AA ɐ BA t AI
cabungcal	k AC x BC ɐ BA b AG ʊ BA ŋ AK k AC ɐ BA l AD
cacdac	k AC x BC ɐ BA k AC d AI ɐ BA k AC
cadano	k AC x BC ɐ BA d AI ɐ BA n AF o BA
cadapan	k AC x BC ɐ BA d AI ɐ BA p AG ɐ BA n AF
cadayona	k AC x BC ɐ BA d AI ɐ BA j AB o BA n AF ɐ BA
cagalingan	k AC x BC ɐ BA ɰ AB ɐ BA l AD ɪ AM ŋ AK ɐ BA n AF
caguiat	k AC x BC ɐ BA ɡ AC j AB ɐ BA t AI
caguioa	k AC x BC ɐ BA ɰ AB ɪ AM w AJ ɐ BA
calalo	k AC x BC ɐ BA l AD ɐ BA l AD o BA
calaunan	k AC x BC ɐ BA l AD ɐ BA ʔ AL ʊ BA n AF ɐ BA n AF
calaycay	k AC x BC ɐ BA l AD a AM ɪ̯ AB x BC a AM ɪ̯ AB
calinawan	k AC x BC ɐ BA l AD ɪ AM n AF ɐ BA w AJ ɐ BA n AF
calingasan	k AC x BC ɐ BA l AD ɪ AM ŋ AK ɐ BA s AH ɐ BA n AF
calinisan	k AC x BC ɐ BA l AD ɪ AM n AF ɪ AM s AH ɐ BA n AF
calma	k AC x BC ɐ BA l AD m AE ɐ BA
campo	k AC x BC ɐ BA m AE p AG o BA
cancio	k AC x BC ɐ BA n AF s AH ɪ AM o BA
canicosa	k AC x BC ɐ BA n AF ɪ AM x BC o BA s AH ɐ BA
canilao	k AC x BC ɐ BA n AF ɪ AM l AD a AM ʊ̯ AJ
cantiveros	k AC x BC ɐ BA n AF t AI ɪ AM b AG ɛ AM ɾ BE o BA s AH
cantos	k AC x BC ɐ BA n AF t AI o BA s AH
caparas	k AC x BC ɐ BA p AG ɐ BA ɾ BE ɐ BA s AH
capinpin	k AC x BC ɐ BA p AG ɪ AM n AF p AG ɪ AM n AF
cardiño	k AC x BC ɐ BA ɾ BE d AI ɪ AM ɲ AK o BA
cariaso	k AC x BC ɐ BA ɾ BE j AB ɐ BA s AH o BA
carillo	k AC x BC ɐ BA ɾ BE ɪ AM l AD l AD o BA
carrillo	k AC x BC ɐ BA ɾ BE ɾ BE ɪ AM l AD l AD o BA
casal	k AC x BC ɐ BA s AH ɐ BA l AD
casanova	k AC x BC ɐ BA s AH ɐ BA n AF o BA b AG ɐ BA
casao	k AC x BC ɐ BA s AH ɐ BA o BA
caseda	k AC x BC ɐ BA s AH ɛ AM d AI ɐ BA
castañeda	k AC x BC ɐ BA s AH t AI ɐ BA ɲ AK ɛ AM d AI ɐ BA
castrence	k AC x BC ɐ BA s AH t AI ɾ BE ɛ AM n AF s AH ɛ AM
catapang	k AC x BC ɐ BA t AI ɐ BA p AG ɐ BA ŋ AK
catibog	k AC x BC ɐ BA t AI ɪ AM b AG o BA ɡ AC
catimbang	k AC x BC ɐ BA t AI ɪ AM m AE b AG ɐ BA ŋ AK
catipon	k AC x BC ɐ BA t AI ɪ AM p AG o BA n AF
catral	k AC x BC ɐ BA t AI ɾ BE ɐ BA l AD
cauilan	k AC x BC ɐ BA w AJ ɪ AM l AD ɐ BA n AF
cenizal	s AH ɛ AM n AF ɪ AM s AH ɐ BA l AD
cerillo	s AH ɛ AM ɾ BE ɪ AM l AD l AD o BA
ching	t AI ʃ AH ɪ AM ŋ AK
cinco	s AH ɪ AM ŋ AK k AC o BA
closa	k AC x BC l AD o BA s AH ɐ BA
collado	k AC x BC o BA l AD l AD ɐ BA d AI o BA
cometa	k AC x BC o BA m AE ɛ AM t AI ɐ BA
comia	k AC x BC o BA m AE ɪ AM ɐ BA
condez	k AC x BC o BA n AF d AI ɛ AM s AH
coquia	k AC x BC o BA x BC ɪ AM ɐ BA
corcuera	k AC x BC o BA ɾ BE k AC w AJ ɛ AM ɾ BE ɐ BA
cornejo	k AC x BC o BA ɾ BE n AF ɛ AM d AI ʒ AH o BA
coronel	k AC x BC o BA ɾ BE o BA n AF ɛ AM l AD
corrales	k AC x BC o BA ɾ BE ɾ BE ɐ BA l AD ɛ AM s AH
correa	k AC x BC o BA ɾ BE ɾ BE ɛ AM ɐ BA
corro	k AC x BC o BA ɾ BE ɾ BE o BA
cosico	k AC x BC o BA s AH ɪ AM x BC o BA
cruzat	k AC x BC ɾ BE ʊ BA s AH ɐ BA t AI
cuasay	k AC w AJ ɐ BA s AH a AM ɪ̯ AB
cubacub	k AC x BC ʊ BA b AG ɐ BA x BC ʊ BA b AG
cuizon	k AC x BC ʊ BA ɪ AM s AH o BA n AF
custodio	k AC x BC ʊ BA s AH t AI o BA d AI ʒ AH o BA
daan	d AI ɐ BA ʔ AL a AM n AF
dacanay	d AI ɐ BA x BC ɐ BA n AF a AM ɪ̯ AB
dado	d AI ɐ BA d AI o BA
daga	d AI ɐ BA ɰ AB a AM ʔ AL
dagat	d AI a AM ɰ AB ɐ BA t AI
dagta	d AI ɐ BA ɡ AC t AI a AM ʔ AL
dahas	d AI ɐ BA h AA a AM s AH
dahilan	d AI ɐ BA h AA ɪ AM l AD a AM n AF
dakip	d AI ɐ BA x BC i AM p AG
dalagita	d AI ɐ BA l AD ɐ BA ɰ AB ɪ AM t AI ɐ BA
dalang	d AI a AM l AD ɐ BA ŋ AK
dalaw	d AI a AM l AD a AM ʊ̯ AJ
dalubhasa	d AI ɐ BA l AD ʊ BA b AG h AA a AM s AH ɐ BA ʔ AL
dalusong	d AI ɐ BA l AD ʊ BA s AH o BA ŋ AK
dantay	d AI ɐ BA n AF t AI a AM ɪ̯ AB
dapdap	d AI ɐ BA p AG d AI a AM p AG
datapwa	d AI ɐ BA t AI ɐ BA p AG w AJ a AM ʔ AL
datinguinoo	d AI ɐ BA t AI ɪ AM ŋ AK ɪ AM n AF o BA o BA
daw	ɾ BE a AM ʊ̯ AJ
daya	d AI a AM j AB ɐ BA ʔ AL
dayag	d AI ɐ BA j AB ɐ BA ɡ AC
dayami	d AI ɐ BA j AB ɐ BA m AE ɪ AM
dayanghirang	d AI ɐ BA j AB ɐ BA ŋ AK h AA ɪ AM ɾ BE ɐ BA ŋ AK
dayrit	d AI a AM ɪ̯ AB ɾ BE ɪ AM t AI
dazo	d AI ɐ BA s AH o BA
deang	d AI ʒ AH ɐ BA ŋ AK
decena	d AI ɛ AM s AH ɛ AM n AF ɐ BA
dee	d AI ɪ AM
dekada	d AI ɛ AM x BC a AM d AI ɐ BA
dekorasyon	d AI ɛ AM x BC o BA ɾ BE ɐ BA ʃ AH o BA n AF
delegasyon	d AI ɛ AM l AD ɛ AM ɰ AB ɐ BA ʃ AH o BA n AF
demonyo	d AI ɛ AM m AE o BA ɲ AK o BA
dentista	d AI ɛ AM n AF t AI i AM s AH t AI ɐ BA
depensahan	d AI ɛ AM p AG ɛ AM n AF s AH ɐ BA h AA a AM n AF
desisyon	d AI ɛ AM s AH ɪ AM ʃ AH o BA n AF
diamante	d AI ɪ AM ɐ BA m AE ɐ BA n AF t AI ɛ AM
dijamco	d AI ɪ AM d AI ʒ AH ɐ BA m AE k AC o BA
dilaw	d AI ɪ AM l AD a AM ʊ̯ AJ
dimaala	d AI ɪ AM m AE ɐ BA ɐ BA l AD ɐ BA
dimaandal	d AI ɪ AM m AE ɐ BA ɐ BA n AF d AI ɐ BA l AD
dimaapi	d AI ɪ AM m AE ɐ BA ɐ BA p AG ɪ AM
dimacali	d AI ɪ AM m AE ɐ BA x BC ɐ BA l AD ɪ AM
dimagiba	d AI ɪ AM m AE ɐ BA ɰ AB ɪ AM b AG ɐ BA
dimailig	d AI ɪ AM m AE a AM ɪ̯ AB l AD ɪ AM ɡ AC
dimalaluan	d AI ɪ AM m AE ɐ BA l AD ɐ BA l AD ʊ BA ɐ BA n AF
dimalanta	d AI ɪ AM m AE ɐ BA l AD ɐ BA n AF t AI ɐ BA
dimapilis	d AI ɪ AM m AE ɐ BA p AG ɪ AM l AD ɪ AM s AH
dimaranan	d AI ɪ AM m AE ɐ BA ɾ BE ɐ BA n AF ɐ BA n AF
dimatatac	d AI ɪ AM m AE ɐ BA t AI ɐ BA t AI ɐ BA k AC
diokno	d AI ɪ AM o BA k AC n AF o BA
dipasupil	d AI ɪ AM p AG ɐ BA s AH ʊ BA p AG ɪ AM l AD
diplomasya	d AI ɪ AM p AG l AD o BA m AE a AM ʃ AH ɐ BA
disisais	d AI ɪ AM s AH ɪ AM s AH ɐ BA ʔ AL i AM s AH
diskumpiyado	d AI ɪ AM s AH k AC u BA m AE p AG j AB ɐ BA d AI o BA
dismayado	d AI ɪ AM s AH m AE ɐ BA j AB ɐ BA d AI o BA
diyablo	d AI ʒ AH ɐ BA b AG l AD o BA
diyamante	d AI ʒ AH a AM m AE a AM n AF t AI ɛ AM
diño	d AI ɪ AM ɲ AK o BA
domantay	d AI o BA m AE ɐ BA n AF t AI a AM ɪ̯ AB
domingo	d AI o BA m AE ɪ AM ŋ AK ɡ AC o BA
dueñas	d AI ʊ BA ɛ AM ɲ AK ɐ BA s AH
duhat	d AI u BA h AA ɐ BA t AI
dukot	d AI u BA x BC o BA t AI
dukwang	d AI ʊ BA k AC w AJ a AM ŋ AK
dulay	d AI ʊ BA l AD a AM ɪ̯ AB
duldol	d AI ʊ BA l AD d AI o BA l AD
dumaguing	d AI ʊ BA m AE ɐ BA ɰ AB ɪ AM ŋ AK
dumating	d AI ʊ BA m AE ɐ BA t AI ɪ AM ŋ AK
dumlao	d AI ʊ BA m AE l AD ɐ BA o BA
dumpit	d AI u BA m AE p AG ɪ AM t AI
dumungaw	d AI ʊ BA m AE u BA ŋ AK a AM ʊ̯ AJ
dumura	d AI ʊ BA m AE ʊ BA ɾ BE a AM ʔ AL
dungaw	d AI u BA ŋ AK a AM ʊ̯ AJ
dura	d AI ʊ BA ɾ BE a AM ʔ AL
durante	d AI ʊ BA ɾ BE ɐ BA n AF t AI ɛ AM
duwag	d AI w AJ a AM ɡ AC
dyahe	d AI ʒ AH ɐ BA h AA ɛ AM
dyaket	d AI ʒ AH a AM x BC ɛ AM t AI
dyanitor	d AI ʒ AH a AM n AF ɪ AM t AI o BA ɾ BE
echano	ʔ AL ɛ AM t AI ʃ AH ɐ BA n AF o BA
echevarria	ʔ AL ɛ AM t AI ʃ AH ɛ AM b AG ɐ BA ɾ BE j AB ɐ BA
edisyon	ʔ AL ɛ AM d AI ɪ AM ʃ AH o BA n AF
ekis	ʔ AL ɛ AM x BC ɪ AM s AH
ekisan	ʔ AL ɛ AM x BC ɪ AM s AH ɐ BA n AF
ekonomiya	ʔ AL ɛ AM x BC o BA n AF o BA m AE ɪ AM ɐ BA
elamparo	ʔ AL ɛ AM l AD ɐ BA m AE p AG ɐ BA ɾ BE o BA
elizaga	ʔ AL ɛ AM t AI ʃ AH ɛ AM b AG ɐ BA ɾ BE j AB ɐ BA
encarnado	ʔ AL ɛ AM ŋ AK k AC ɐ BA ɾ BE n AF ɐ BA d AI o BA
encinas	ʔ AL ɛ AM n AF s AH ɪ AM n AF ɐ BA s AH
endaya	ʔ AL ɛ AM n AF d AI ɐ BA j AB ɐ BA
epidemya	ʔ AL ɛ AM p AG ɪ AM d AI ɛ AM m AE j AB ɐ BA
ermitanyo	ʔ AL ɛ AM ɾ BE m AE ɪ AM t AI ɐ BA ɲ AK o BA
escalona	ʔ AL ɛ AM s AH k AC ɐ BA l AD o BA n AF ɐ BA
escaño	ʔ AL ɛ AM s AH k AC ɐ BA ɲ AK o BA
esguerra	ʔ AL ɛ AM s AH ɡ AC ɛ AM ɾ BE ɾ BE ɐ BA
eskaparate	ʔ AL ɛ AM s AH k AC ɐ BA p AG ɐ BA ɾ BE a AM t AI ɛ AM
espadahan	ʔ AL ɛ AM s AH p AG ɐ BA d AI ɐ BA h AA a AM n AF
espasyo	ʔ AL ɛ AM s AH p AG a AM ʃ AH o BA
espinoza	ʔ AL ɛ AM s AH p AG ɪ AM n AF o BA s AH ɐ BA
esquivel	ʔ AL ɛ AM s AH k AC ɪ AM b AG ɛ AM l AD
estabillo	ʔ AL ɛ AM s AH t AI ɐ BA b AG ɪ AM l AD l AD o BA
estrella	ʔ AL ɛ AM s AH t AI ɾ BE ɛ AM l AD l AD ɐ BA
eugenio	j AB ʊ BA h AA ɛ AM ɲ AK o BA
fabregas	p AG ɐ BA b AG ɾ BE ɛ AM ɰ AB ɐ BA s AH
fabros	p AG ɐ BA b AG ɾ BE o BA s AH
fajardo	p AG ɐ BA d AI ʒ AH ɐ BA ɾ BE d AI o BA
falcon	p AG ɐ BA l AD k AC o BA n AF
faltado	p AG ɐ BA l AD t AI ɐ BA d AI o BA
fernandez	p AG ɛ AM ɾ BE n AF ɐ BA n AF d AI ɛ AM s AH
ferriols	p AG ɛ AM ɾ BE ɾ BE ɪ AM o BA l AD s AH
figueras	p AG ɪ AM ɰ AB ɛ AM ɾ BE ɐ BA s AH
figueroa	p AG ɪ AM ɰ AB ɛ AM ɾ BE o BA ɐ BA
fojas	p AG o BA d AI ʒ AH ɐ BA s AH
fonacier	p AG o BA n AF ɐ BA s AH ɪ AM ɛ AM ɾ BE
fontelera	p AG o BA n AF t AI ɛ AM l AD ɛ AM ɾ BE ɐ BA
fontillas	p AG o BA n AF t AI ɪ AM l AD l AD ɐ BA s AH
forteza	p AG o BA ɾ BE t AI ɛ AM s AH ɐ BA
fortich	p AG o BA ɾ BE t AI ɪ AM t AI ʃ AH
frias	p AG ɾ BE ɪ AM ɐ BA s AH
fronda	p AG ɾ BE o BA n AF d AI ɐ BA
fuentebella	p AG ʊ BA ɛ AM n AF t AI ɛ AM b AG ɛ AM l AD l AD ɐ BA
furagganan	p AG ʊ BA ɾ BE ɐ BA ɡ AC ɡ AC ɐ BA n AF ɐ BA n AF
gabi	ɡ AC ɐ BA b AG ɪ AM
gabiana	ɡ AC ɐ BA b AG ɪ AM ɐ BA n AF ɐ BA
gacula	ɡ AC ɐ BA x BC ʊ BA l AD ɐ BA
gacusan	ɡ AC ɐ BA x BC ʊ BA s AH ɐ BA n AF
gacutan	ɡ AC ɐ BA x BC ʊ BA t AI ɐ BA n AF
galamay	ɡ AC ɐ BA l AD ɐ BA m AE a AM ɪ̯ AB
galapong	ɡ AC ɐ BA l AD ɐ BA p AG o BA ŋ AK
galis	ɡ AC ɐ BA l AD i AM s AH
gallo	ɡ AC ɐ BA l AD l AD o BA
gan	ɡ AC ɐ BA n AF
ganap	ɡ AC ɐ BA n AF a AM p AG
gancayco	ɡ AC ɐ BA ŋ AK k AC a AM ɪ̯ AB x BC o BA
gansa	ɡ AC ɐ BA n AF s AH a AM
ganti	ɡ AC ɐ BA n AF t AI i AM
ganzon	ɡ AC ɐ BA n AF s AH o BA n AF
garalde	ɡ AC ɐ BA ɾ BE ɐ BA l AD d AI ɛ AM
garapata	ɡ AC ɐ BA ɾ BE ɐ BA p AG ɐ BA t AI ɐ BA
garay	ɡ AC ɐ BA ɾ BE a AM ɪ̯ AB
garces	ɡ AC ɐ BA ɾ BE s AH ɛ AM s AH
garchitorena	ɡ AC ɐ BA ɾ BE t AI ʃ AH ɪ AM t AI o BA ɾ BE ɛ AM n AF ɐ BA
garciano	ɡ AC ɐ BA ɾ BE s AH ɪ AM ɐ BA n AF o BA
gascon	ɡ AC ɐ BA s AH k AC o BA n AF
gaslaw	ɡ AC ɐ BA s AH l AD a AM ʊ̯ AJ
gasolinahan	ɡ AC ɐ BA s AH o BA l AD ɪ AM n AF ɐ BA h AA a AM n AF
gaspang	ɡ AC ɐ BA s AH p AG a AM ŋ AK
gaston	ɡ AC ɐ BA s AH t AI o BA n AF
gatbonton	ɡ AC ɐ BA t AI b AG o BA n AF t AI o BA n AF
gatchalian	ɡ AC ɐ BA t AI t AI ʃ AH ɐ BA l AD j AB ɐ BA n AF
gayuma	ɡ AC ɐ BA j AB u BA m AE ɐ BA
gerilya	ɡ AC ɛ AM ɾ BE ɪ AM l AD j AB ɐ BA
gerodias	d AI ʒ AH ɛ AM ɾ BE o BA d AI ʒ AH ɐ BA s AH
geronimo	h AA ɛ AM ɾ BE o BA n AF ɪ AM m AE o BA
gilagid	ɡ AC ɪ AM l AD a AM ɰ AB ɪ AM d AI
ginhawa	ɡ AC ɪ AM ŋ AK h AA a AM w AJ ɐ BA
ginto	ɡ AC ɪ AM n AF t AI o BA ʔ AL
giron	h AA ɪ AM ɾ BE o BA n AF
gisa	ɡ AC ɪ AM s AH a AM
gitna	ɡ AC ɪ AM t AI n AF a AM ʔ AL
godoy	ɡ AC o BA d AI o BA ɪ̯ AB
gradweyt	ɡ AC ɾ BE a AM d AI w AJ ɛ AM ɪ̯ AB t AI
grasa	ɡ AC ɾ BE ɐ BA s AH ɐ BA
grasya	ɡ AC ɾ BE a AM ʃ AH ɐ BA
grumadweyt	ɡ AC ɾ BE ʊ BA m AE a AM d AI w AJ ɛ AM ɪ̯ AB t AI
guanzon	ɡ AC ʊ BA ɐ BA n AF s AH o BA n AF
gubat	ɡ AC ʊ BA b AG ɐ BA t AI
guerra	ɡ AC ɛ AM ɾ BE ɐ BA
gulpi	ɡ AC ʊ BA l AD p AG i AM
gumapac	ɡ AC ʊ BA m AE ɐ BA p AG ɐ BA k AC
gumiran	ɡ AC ʊ BA m AE ɪ AM ɾ BE ɐ BA n AF
guwantes	ɡ AC w AJ ɐ BA n AF t AI ɛ AM s AH
guwardiya	ɡ AC w AJ a AM ɾ BE d AI ʒ AH ɐ BA
habagat	h AA ɐ BA b AG a AM ɰ AB ɐ BA t AI
hagod	h AA a AM ɰ AB o BA d AI
hagok	h AA a AM ɰ AB o BA k AC
hagulgol	h AA ɐ BA ɰ AB ʊ BA l AD ɡ AC o BA l AD
hagulhol	h AA ɐ BA ɰ AB ʊ BA l AD h AA o BA l AD
hagupit	h AA ɐ BA ɰ AB ʊ BA p AG i AM t AI
halabos	h AA ɐ BA l AD ɐ BA b AG o BA s AH
halaga	h AA ɐ BA l AD ɐ BA ɰ AB a AM
halasan	h AA ɐ BA l AD ɐ BA s AH ɐ BA n AF
haligi	h AA ɐ BA l AD i AM ɰ AB ɪ AM
halik	h AA ɐ BA l AD i AM k AC
halimaw	h AA ɐ BA l AD ɪ AM m AE a AM ʊ̯ AJ
hambalang	h AA ɐ BA m AE b AG a AM l AD ɐ BA ŋ AK
hamog	h AA ɐ BA m AE o BA ɡ AC
hangal	h AA ɐ BA ŋ AK a AM l AD
hapdi	h AA ɐ BA p AG d AI i AM ʔ AL
hapit	h AA ɐ BA p AG ɪ AM t AI
hapo	h AA ɐ BA p AG o BA ʔ AL
hapones	h AA ɐ BA p AG o BA n AF ɛ AM s AH
hapunan	h AA ɐ BA p AG ʊ BA n AF ɐ BA n AF
harana	h AA ɐ BA ɾ BE ɐ BA n AF ɐ BA
harang	h AA a AM ɾ BE ɐ BA ŋ AK
harap	h AA ɐ BA ɾ BE a AM p AG
hasik	h AA ɐ BA s AH i AM k AC
hawa	h AA ɐ BA w AJ ɐ BA
hawla	h AA a AM ʊ̯ AJ l AD ɐ BA
hayag	h AA ɐ BA j AB ɐ BA ɡ AC
herradura	ʔ AL ɛ AM ɾ BE ɐ BA d AI ʊ BA ɾ BE ɐ BA
higop	h AA ɪ AM ɰ AB o BA p AG
hilab	h AA i AM l AD ɐ BA b AG
hilaw	h AA ɪ AM l AD a AM ʊ̯ AJ
hilera	h AA ɪ AM l AD ɛ AM ɾ BE ɐ BA
himala	h AA ɪ AM m AE ɐ BA l AD a AM ʔ AL
himasok	h AA ɪ AM m AE a AM s AH o BA k AC
himatayin	h AA ɪ AM m AE ɐ BA t AI ɐ BA j AB i AM n AF
hina	h AA i AM n AF ɐ BA ʔ AL
hinagpis	h AA ɪ AM n AF ɐ BA ɡ AC p AG i AM s AH
hinala	h AA ɪ AM n AF a AM l AD ɐ BA ʔ AL
hinga	h AA ɪ AM ŋ AK a AM
hinlalaki	h AA ɪ AM n AF l AD ɐ BA l AD ɐ BA x BC i AM
hinog	h AA ɪ AM n AF o BA ɡ AC
hintuturo	h AA ɪ AM n AF t AI ʊ BA t AI ʊ BA ɾ BE o BA ʔ AL
hipolito	h AA ɪ AM p AG o BA l AD ɪ AM t AI o BA
hipon	h AA ɪ AM p AG o BA n AF
hira	ç i AM r BB a AM ʔ AL
hirap	h AA ɪ AM ɾ BE a AM p AG
hithit	h AA ɪ AM t AI h AA i AM t AI
hitsura	h AA ɪ AM t AI ʃ AH u BA ɾ BE ɐ BA
hiwalay	h AA ɪ AM w AJ ɐ BA l AD a AM ɪ̯ AB
hiya	h AA ɪ AM a AM ʔ AL
hiyaw	h AA ɪ AM a AM ʊ̯ AJ
hizon	h AA ɪ AM s AH o BA n AF
homiliya	h AA o BA m AE ɪ AM l AD ɪ AM ɐ BA
hortaleza	h AA o BA ɾ BE t AI ɐ BA l AD ɛ AM s AH ɐ BA
hulog	h AA ʊ BA l AD o BA ɡ AC
humagulgol	h AA ʊ BA m AE ɐ BA ɰ AB ʊ BA l AD ɡ AC o BA l AD
humandusay	h AA ʊ BA m AE ɐ BA n AF d AI u BA s AH a AM ɪ̯ AB
huni	h AA u BA n AF ɪ AM
husga	h AA ʊ BA s AH ɡ AC a AM
husgado	h AA ʊ BA s AH ɡ AC ɐ BA d AI o BA
husgahan	h AA ʊ BA s AH ɡ AC ɐ BA h AA a AM n AF
huweteng	h AA ʊ BA ɛ AM t AI ɛ AM ŋ AK
ibasco	ʔ AL ɪ AM b AG ɐ BA s AH k AC o BA
igib	ʔ AL ɪ AM ɰ AB i AM b AG
ignacio	ʔ AL ɪ AM ɡ AC n AF ɐ BA ʃ AH o BA
ignoransiya	ʔ AL ɪ AM ɡ AC n AF o BA ɾ BE a AM n AF ʃ AH ɐ BA
ignorante	ʔ AL ɪ AM ɡ AC n AF o BA ɾ BE a AM n AF t AI ɛ AM
ilag	ʔ AL i AM l AD ɐ BA ɡ AC
ilao	ʔ AL ɪ AM l AD a AM ʊ̯ AJ
iling	ʔ AL ɪ AM l AD i AM ŋ AK
ilog	ʔ AL ɪ AM l AD o BA ɡ AC
ilong	ʔ AL ɪ AM l AD o BA ŋ AK
ilustre	ʔ AL ɪ AM l AD ʊ BA s AH t AI ɾ BE ɛ AM
imahen	ʔ AL ɪ AM m AE a AM h AA ɛ AM n AF
imbentaryo	ʔ AL ɪ AM m AE b AG ɛ AM n AF t AI ɐ BA ɾ BE j AB o BA
imperial	ʔ AL ɪ AM m AE p AG ɛ AM ɾ BE j AB ɐ BA l AD
impluwensiya	ʔ AL ɪ AM m AE p AG l AD ʊ BA ɛ AM n AF s AH ɪ AM ɐ BA
importansiya	ʔ AL ɪ AM m AE p AG o BA ɾ BE t AI a AM n AF ʃ AH ɐ BA
importante	ʔ AL ɪ AM m AE p AG o BA ɾ BE t AI a AM n AF t AI ɛ AM
ina	ʔ AL ɪ AM n AF a AM
inahin	ʔ AL ɪ AM n AF ɐ BA h AA i AM n AF
infante	ʔ AL ɪ AM n AF p AG ɐ BA n AF t AI ɛ AM
ingay	ʔ AL ɪ AM ŋ AK a AM ɪ̯ AB
inggit	ʔ AL ɪ AM ŋ AK ɡ AC i AM t AI
inggitero	ʔ AL ɪ AM ŋ AK ɡ AC ɪ AM t AI ɛ AM ɾ BE o BA
inggo	ʔ AL ɪ AM ŋ AK ɡ AC o BA ʔ AL
ingrato	ʔ AL ɪ AM ŋ AK ɡ AC ɾ BE ɐ BA t AI o BA
inip	ʔ AL ɪ AM n AF i AM p AG
inosente	ʔ AL ɪ AM n AF o BA s AH ɛ AM n AF t AI ɛ AM
insulto	ʔ AL ɪ AM n AF s AH ʊ BA l AD t AI o BA
interbiyu	ʔ AL ɪ AM n AF t AI ɛ AM ɾ BE b AG ɪ AM ʊ̯ AJ
interes	ʔ AL ɪ AM n AF t AI ɛ AM ɾ BE ɛ AM s AH
intsik	ʔ AL ɪ AM n AF t AI ʃ AH i AM k AC
inumin	ʔ AL ɪ AM n AF ʊ BA m AE ɪ AM n AF
inutil	ʔ AL ɪ AM n AF u BA t AI ɪ AM l AD
ipagbilin	ʔ AL ɪ AM p AG ɐ BA ɡ AC b AG ɪ AM l AD ɪ AM n AF
ipamigay	ʔ AL ɪ AM p AG ɐ BA m AE ɪ AM ɰ AB a AM ɪ̯ AB
ipis	ʔ AL i AM p AG ɪ AM s AH
irebisa	ʔ AL ɪ AM ɾ BE ɛ AM b AG ɪ AM s AH a AM
isa	ʔ AL ɪ AM s AH a AM
isagani	ʔ AL ɪ AM s AH ɐ BA ɰ AB ɐ BA n AF ɪ AM
isangkot	ʔ AL ɪ AM s AH ɐ BA ŋ AK k AC o BA t AI
ishinare	ʔ AL ɪ AM s AH h AA ɪ AM n AF ɛ AM ɾ BE
isidro	ʔ AL ɪ AM s AH ɪ AM d AI ɾ BE o BA
isisi	ʔ AL ɪ AM s AH ɪ AM s AH ɪ AM
iskedyul	ʔ AL ɪ AM s AH k AC ɛ AM d AI ʒ AH ʊ BA l AD
iskolar	ʔ AL ɪ AM s AH k AC o BA l AD ɐ BA ɾ BE
iskrip	ʔ AL ɪ AM s AH k AC ɾ BE i AM p AG
istorya	ʔ AL ɪ AM s AH t AI o BA ɾ BE j AB ɐ BA
itlog	ʔ AL ɪ AM t AI l AD o BA ɡ AC
ito	ʔ AL ɪ AM t AI o BA
jalandoni	d AI ʒ AH ɐ BA l AD ɐ BA n AF d AI o BA n AF ɪ AM
jamisola	d AI ʒ AH ɐ BA m AE ɪ AM s AH o BA l AD ɐ BA
jara	d AI ʒ AH ɐ BA ɾ BE ɐ BA
jaramillo	d AI ʒ AH ɐ BA ɾ BE ɐ BA m AE ɪ AM l AD l AD o BA
jaranilla	d AI ʒ AH ɐ BA ɾ BE ɐ BA n AF ɪ AM l AD l AD ɐ BA
juarez	d AI ʒ AH ʊ BA ɐ BA ɾ BE ɛ AM s AH
jumarang	d AI ʒ AH ʊ BA m AE ɐ BA ɾ BE ɐ BA ŋ AK
juntilla	d AI ʒ AH ʊ BA n AF t AI ɪ AM l AD l AD ɐ BA
jurado	d AI ʒ AH ʊ BA ɾ BE ɐ BA d AI o BA
jusi	d AI ʒ AH ʊ BA s AH ɪ AM
justiniano	d AI ʒ AH ʊ BA s AH t AI ɪ AM n AF ɪ AM ɐ BA n AF o BA
kababaihan	k AC x BC ɐ BA b AG ɐ BA b AG ɐ BA ʔ AL ɪ AM h AA ɐ BA n AF
kabaligtaran	k AC x BC ɐ BA b AG ɐ BA l AD ɪ AM ɡ AC t AI ɐ BA ɾ BE a AM n AF
kabaong	k AC x BC ɐ BA b AG a AM o BA ŋ AK
kabastusan	k AC x BC ɐ BA b AG ɐ BA s AH t AI ʊ BA s AH a AM n AF
kabayo	k AC x BC ɐ BA b AG ɐ BA j AB o BA
kaberdehan	k AC x BC ɐ BA b AG ɛ AM ɾ BE d AI ɛ AM h AA a AM n AF
kabig	k AC x BC a AM b AG ɪ AM ɡ AC
kabiling	k AC x BC ɐ BA b AG ɪ AM l AD ɪ AM ŋ AK
kabuwanan	k AC x BC ɐ BA b AG w AJ ɐ BA n AF ɐ BA n AF
kadena	k AC x BC ɐ BA d AI ɛ AM n AF ɐ BA
kadugo	k AC x BC ɐ BA d AI ʊ BA ɰ AB o BA ʔ AL
kadyos	k AC x BC ɐ BA d AI ʒ AH o BA s AH
kagalingan	k AC x BC ɐ BA ɰ AB ɐ BA l AD ɪ AM ŋ AK ɐ BA n AF
kagaw	k AC x BC ɐ BA ɰ AB a AM ʊ̯ AJ
kaha	k AC x BC ɐ BA h AA ɐ BA
kahabagan	k AC x BC ɐ BA h AA ɐ BA b AG ɐ BA ɰ AB a AM n AF
kahandaan	k AC x BC ɐ BA h AA ɐ BA n AF d AI ɐ BA ʔ AL a AM n AF
kahero	k AC x BC ɐ BA h AA ɛ AM ɾ BE o BA
kahihiyan	k AC x BC a AM h AA ɪ AM h AA ɪ AM a AM n AF
kahoy	k AC x BC a AM h AA o BA ɪ̯ AB
kaibigan	k AC x BC a AM ɪ̯ AB b AG ɪ AM ɰ AB a AM n AF
kakarampot	k AC x BC ɐ BA x BC ɐ BA ɾ BE ɐ BA m AE p AG o BA t AI
kakulangan	k AC x BC ɐ BA x BC ʊ BA l AD ɐ BA ŋ AK a AM n AF
kalaguyo	k AC x BC ɐ BA l AD ɐ BA ɰ AB u BA j AB o BA ʔ AL
kalaliman	k AC x BC ɐ BA l AD ɐ BA l AD ɪ AM m AE ɐ BA n AF
kalan	k AC x BC ɐ BA l AD a AM n AF
kalantas	k AC x BC ɐ BA l AD ɐ BA n AF t AI a AM s AH
kalaswaan	k AC x BC ɐ BA l AD ɐ BA s AH w AJ ɐ BA ʔ AL a AM n AF
kalatas	k AC x BC ɐ BA l AD ɐ BA t AI a AM s AH
kalatsutsi	k AC x BC ɐ BA l AD ɐ BA t AI ʃ AH u BA t AI ʃ AH ɪ AM ʔ AL
kalawang	k AC x BC ɐ BA l AD a AM w AJ ɐ BA ŋ AK
kalawangin	k AC x BC ɐ BA l AD ɐ BA w AJ ɐ BA ŋ AK ɪ AM n AF
kalbaryo	k AC x BC ɐ BA l AD b AG a AM ɾ BE j AB o BA
kaldero	k AC x BC ɐ BA l AD d AI ɛ AM ɾ BE o BA
kalendaryo	k AC x BC ɐ BA l AD ɛ AM n AF d AI a AM ɾ BE j AB o BA
kalibre	k AC x BC ɐ BA l AD ɪ AM b AG ɾ BE ɛ AM
kalibugan	k AC x BC ɐ BA l AD ɪ AM b AG ʊ BA ɰ AB ɐ BA n AF
kalidad	k AC x BC ɐ BA l AD ɪ AM d AI a AM d AI
kaligayahan	k AC x BC ɐ BA l AD ɪ AM ɰ AB ɐ BA j AB ɐ BA h AA ɐ BA n AF
kaligkig	k AC x BC ɐ BA l AD ɪ AM ɡ AC k AC i AM ɡ AC
kalis	k AC x BC a AM l AD ɪ AM s AH
kaliskis	k AC x BC ɐ BA l AD ɪ AM s AH k AC ɪ AM s AH
kaliwanagan	k AC x BC ɐ BA l AD ɪ AM w AJ ɐ BA n AF ɐ BA ɰ AB ɐ BA n AF
kaliwete	k AC x BC ɐ BA l AD ɪ AM w AJ ɛ AM t AI ɛ AM
kalso	k AC x BC ɐ BA l AD s AH o BA
kalungsuran	k AC x BC ɐ BA l AD ʊ BA ŋ AK s AH ʊ BA ɾ BE a AM n AF
kaluwalhatian	k AC x BC ɐ BA l AD ʊ BA l AD ʊ BA ɐ BA l AD h AA ɐ BA t AI i AM ʔ AL ɐ BA n AF
kalyo	k AC x BC ɐ BA l AD j AB o BA
kamandag	k AC x BC ɐ BA m AE ɐ BA n AF d AI a AM ɡ AC
kamangmangan	k AC x BC ɐ BA m AE ɐ BA ŋ AK m AE ɐ BA ŋ AK a AM n AF
kamatayan	k AC x BC ɐ BA m AE ɐ BA t AI ɐ BA j AB ɐ BA n AF
kambal	k AC x BC ɐ BA m AE b AG ɐ BA l AD
kambyo	k AC x BC ɐ BA m AE b AG j AB o BA
kampana	k AC x BC ɐ BA m AE p AG a AM n AF ɐ BA ʔ AL
kampante	k AC x BC ɐ BA m AE p AG a AM n AF t AI ɛ AM
kampanya	k AC x BC ɐ BA m AE p AG ɐ BA ɲ AK a AM
kamukha	k AC x BC ɐ BA m AE ʊ BA k AC h AA a AM ʔ AL
kamunduhan	k AC x BC ɐ BA m AE ʊ BA n AF d AI ʊ BA h AA a AM n AF
kandidato	k AC x BC ɐ BA n AF d AI ɪ AM d AI a AM t AI o BA
kandila	k AC x BC ɐ BA n AF d AI i AM l AD ɐ BA ʔ AL
kanduli	k AC x BC ɐ BA n AF d AI u BA l AD ɪ AM ʔ AL
kangkungan	k AC x BC ɐ BA ŋ AK k AC ʊ BA ŋ AK ɐ BA n AF
kanina	k AC x BC ɐ BA n AF i AM n AF ɐ BA
kanino	k AC x BC ɐ BA n AF ɪ AM n AF o BA
kaniyugan	k AC x BC ɐ BA ɲ AK ʊ BA ɰ AB ɐ BA n AF
kanlong	k AC x BC ɐ BA n AF l AD o BA ŋ AK
kanlungan	k AC x BC ɐ BA n AF l AD ʊ BA ŋ AK ɐ BA n AF
kanselasyon	k AC x BC ɐ BA n AF s AH ɛ AM l AD ɐ BA ʃ AH o BA n AF
kanser	k AC x BC a AM n AF s AH ɛ AM ɾ BE
kanta	k AC x BC ɐ BA n AF t AI a AM
kantahin	k AC x BC ɐ BA n AF t AI ɐ BA h AA i AM n AF
kaopisina	k AC x BC ɐ BA o BA p AG ɪ AM s AH ɪ AM n AF ɐ BA
kapabayaan	k AC x BC ɐ BA p AG ɐ BA b AG ɐ BA j AB ɐ BA a AM n AF
kapakanan	k AC x BC ɐ BA p AG ɐ BA x BC ɐ BA n AF ʔ AL a AM n AF
kapalit	k AC x BC ɐ BA p AG ɐ BA l AD i AM t AI
kapanahunan	k AC x BC ɐ BA p AG ɐ BA n AF ɐ BA h AA ʊ BA n AF ɐ BA n AF
kapatawaran	k AC x BC ɐ BA p AG ɐ BA t AI ɐ BA w AJ ɐ BA ɾ BE a AM n AF
kapiraso	k AC x BC ɐ BA p AG ɪ AM ɾ BE ɐ BA s AH o BA
kapitan	k AC x BC ɐ BA p AG ɪ AM t AI ɐ BA n AF
kaplastikan	k AC x BC ɐ BA p AG l AD ɐ BA s AH t AI ɪ AM x BC a AM n AF
kapon	k AC x BC ɐ BA p AG o BA n AF
kapre	k AC x BC ɐ BA p AG ɾ BE ɛ AM
kaputsino	k AC x BC ɐ BA p AG ʊ BA t AI ʃ AH ɪ AM n AF o BA
karakter	k AC x BC ɐ BA ɾ BE a AM k AC t AI ɛ AM ɾ BE
karambola	k AC x BC ɐ BA ɾ BE ɐ BA m AE b AG o BA l AD ɐ BA
karamihan	k AC x BC ɐ BA ɾ BE ɐ BA m AE ɪ AM h AA ɐ BA n AF
karampatan	k AC x BC ɐ BA ɾ BE ɐ BA m AE p AG a AM t AI ɐ BA n AF
karayom	k AC x BC ɐ BA ɾ BE ɐ BA j AB o BA m AE
karbon	k AC x BC ɐ BA ɾ BE b AG o BA n AF
karerahan	k AC x BC a AM ɾ BE ɛ AM ɾ BE ɐ BA h AA a AM n AF
karibal	k AC x BC ɐ BA ɾ BE ɪ AM b AG a AM l AD
karitela	k AC x BC ɐ BA ɾ BE ɪ AM t AI ɛ AM l AD ɐ BA
kariton	k AC x BC ɐ BA ɾ BE ɪ AM t AI o BA n AF
karo	k AC x BC a AM ɾ BE o BA
karpintero	k AC x BC ɐ BA ɾ BE p AG ɪ AM n AF t AI ɛ AM ɾ BE o BA
karton	k AC x BC ɐ BA ɾ BE t AI o BA n AF
karunungan	k AC x BC ɐ BA ɾ BE ʊ BA n AF ʊ BA ŋ AK ɐ BA n AF
karupukan	k AC x BC ɐ BA ɾ BE ʊ BA p AG ʊ BA x BC a AM n AF
karuwagan	k AC x BC ɐ BA ɾ BE ʊ BA ɐ BA ɰ AB a AM n AF
kasalanan	k AC x BC ɐ BA s AH ɐ BA l AD a AM n AF ɐ BA n AF
kasambahay	k AC x BC ɐ BA s AH ɐ BA m AE b AG ɐ BA h AA a AM ɪ̯ AB
kasera	k AC x BC ɐ BA s AH ɛ AM ɾ BE ɐ BA
kasero	k AC x BC ɐ BA s AH ɛ AM ɾ BE o BA
kaserola	k AC x BC ɐ BA s AH ɛ AM ɾ BE o BA l AD ɐ BA
kasiguraduhan	k AC x BC ɐ BA s AH ɪ AM ɰ AB ʊ BA ɾ BE ɐ BA d AI ʊ BA h AA ɐ BA n AF
kasintahan	k AC x BC ɐ BA s AH ɪ AM n AF t AI ɐ BA h AA ɐ BA n AF
kasinungalingan	k AC x BC ɐ BA s AH ɪ AM n AF ʊ BA ŋ AK ɐ BA l AD i AM ŋ AK ɐ BA n AF
kasoy	k AC x BC ɐ BA s AH o BA ɪ̯ AB
kastigo	k AC x BC ɐ BA s AH t AI ɪ AM ɰ AB o BA
kastiguhin	k AC x BC ɐ BA s AH t AI ɪ AM ɰ AB ʊ BA h AA ɪ AM n AF
kasubha	k AC x BC ɐ BA s AH u BA b AG h AA a AM ʔ AL
kataga	k AC x BC ɐ BA t AI ɐ BA ɰ AB a AM ʔ AL
katagalugan	k AC x BC ɐ BA t AI ɐ BA ɰ AB ɐ BA l AD ʊ BA ɰ AB ɐ BA n AF
katakawan	k AC x BC ɐ BA t AI ɐ BA x BC ɐ BA w AJ ɐ BA n AF
katang	k AC x BC ɐ BA t AI a AM ŋ AK
katangahan	k AC x BC ɐ BA t AI ɐ BA ŋ AK ɐ BA h AA a AM n AF
katarata	k AC x BC ɐ BA t AI ɐ BA ɾ BE ɐ BA t AI ɐ BA
katawan	k AC x BC ɐ BA t AI ɐ BA w AJ a AM n AF
katedral	k AC x BC ɐ BA t AI ɛ AM d AI ɾ BE ɐ BA l AD
katigbak	k AC x BC ɐ BA t AI ɪ AM ɡ AC b AG ɐ BA k AC
katiwalian	k AC x BC ɐ BA t AI ɪ AM w AJ ɐ BA l AD ɪ AM a AM n AF
kato	k AC x BC ɐ BA t AI o BA ʔ AL
katolisismo	k AC x BC ɐ BA t AI o BA l AD ɪ AM s AH ɪ AM s AH m AE o BA
katungkulan	k AC x BC ɐ BA t AI ʊ BA ŋ AK k AC ʊ BA l AD ɐ BA n AF
katuwang	k AC x BC ɐ BA t AI w AJ a AM ŋ AK
kawad	k AC x BC a AM w AJ ɐ BA d AI
kay	k AC x BC a AM ɪ̯ AB
kendi	k AC x BC ɛ AM n AF d AI ɪ AM
ketongin	k AC x BC ɛ AM t AI o BA ŋ AK ɪ AM n AF
kiamzon	k AC x BC ɪ AM ɐ BA m AE s AH o BA n AF
kikil	k AC x BC i AM x BC ɪ AM l AD
kilikili	k AC x BC ɪ AM l AD ɪ AM x BC ɪ AM l AD ɪ AM
kilo	k AC x BC ɪ AM l AD o BA ʔ AL
king	k AC x BC ɪ AM ŋ AK
kintsay	k AC x BC ɪ AM n AF t AI ʃ AH a AM ɪ̯ AB
kita	k AC ɪ AM t AI a AM
kitikiti	k AC x BC ɪ AM t AI ɪ AM x BC ɪ AM t AI i AM
klima	k AC x BC l AD i AM m AE ɐ BA
klinika	k AC x BC l AD i AM n AF ɪ AM x BC ɐ BA
kolera	k AC x BC o BA l AD ɛ AM ɾ BE ɐ BA
kombinasyon	k AC x BC u BA m AE b AG ɪ AM n AF ɐ BA ʃ AH o BA n AF
komedya	k AC x BC o BA m AE ɛ AM d AI ʒ AH ɐ BA
komento	k AC x BC o BA m AE ɛ AM n AF t AI o BA
kometa	k AC x BC o BA m AE ɛ AM t AI ɐ BA
kompleto	k AC x BC u BA m AE p AG l AD ɛ AM t AI o BA
komplikasyon	k AC x BC u BA m AE p AG l AD ɪ AM x BC ɐ BA ʃ AH o BA n AF
komunidad	k AC x BC o BA m AE ʊ BA n AF ɪ AM d AI a AM d AI
kondenahin	k AC x BC o BA n AF d AI ɛ AM n AF ɐ BA h AA i AM n AF
kondisyon	k AC x BC o BA n AF d AI ɪ AM ʃ AH o BA n AF
konstitusyon	k AC x BC o BA n AF s AH t AI ɪ AM t AI ʊ BA ʃ AH o BA n AF
konsumisyon	k AC x BC o BA n AF s AH ʊ BA m AE ɪ AM ʃ AH o BA n AF
kontak	k AC x BC o BA n AF t AI ɐ BA k AC
kontakin	k AC x BC o BA n AF t AI ɐ BA x BC ɪ AM n AF
kontrobersiya	k AC x BC o BA n AF t AI ɾ BE o BA b AG ɛ AM ɾ BE ʃ AH ɐ BA
koral	k AC x BC o BA ɾ BE a AM l AD
korona	k AC x BC o BA ɾ BE o BA n AF ɐ BA
koronahan	k AC x BC o BA ɾ BE o BA n AF a AM h AA ɐ BA n AF
kotse	k AC x BC o BA t AI ʃ AH ɛ AM
krimen	k AC x BC ɾ BE ɪ AM m AE ɛ AM n AF
kriminal	k AC x BC ɾ BE ɪ AM m AE ɪ AM n AF a AM l AD
kritiko	k AC x BC ɾ BE i AM t AI ɪ AM x BC o BA
kroni	k AC x BC ɾ BE o BA n AF ɪ AM
kroniyismo	k AC x BC ɾ BE o BA n AF ɪ AM j AB ɪ AM s AH m AE o BA
kuba	k AC x BC u BA b AG ɐ BA ʔ AL
kubeta	k AC x BC ʊ BA b AG ɛ AM t AI ɐ BA
kubo	k AC x BC ʊ BA b AG o BA
kudkurin	k AC x BC ʊ BA d AI k AC ʊ BA ɾ BE i AM n AF
kuha	k AC x BC ʊ BA h AA ɐ BA
kulambo	k AC x BC ʊ BA l AD ɐ BA m AE b AG o BA ʔ AL
kulangi	k AC x BC ʊ BA l AD ɐ BA ŋ AK ɪ AM ʔ AL
kulangot	k AC x BC ʊ BA l AD a AM ŋ AK o BA t AI
kulimlim	k AC x BC ʊ BA l AD ɪ AM m AE l AD i AM m AE
kulugo	k AC x BC ʊ BA l AD ʊ BA ɰ AB o BA
kumabig	k AC x BC ʊ BA m AE a AM b AG ɪ AM ɡ AC
kumanta	k AC x BC ʊ BA m AE ɐ BA n AF t AI a AM
kumbensiyon	k AC x BC u BA m AE b AG ɛ AM n AF ʃ AH o BA n AF
kumbento	k AC x BC u BA m AE b AG ɛ AM n AF t AI o BA
kumbulsiyon	k AC x BC u BA m AE b AG ʊ BA l AD ʃ AH o BA n AF
kumpas	k AC x BC u BA m AE p AG a AM s AH
kumpederasyon	k AC x BC u BA m AE p AG ɛ AM d AI ɛ AM ɾ BE ɐ BA ʃ AH o BA n AF
kumpisal	k AC x BC u BA m AE p AG ɪ AM s AH a AM l AD
kumunoy	k AC x BC ʊ BA m AE ʊ BA n AF o BA ɪ̯ AB
kumupas	k AC x BC ʊ BA m AE ʊ BA p AG ɐ BA s AH
kumuyakoy	k AC x BC ʊ BA m AE ʊ BA j AB a AM x BC o BA ɪ̯ AB
kunan	k AC x BC ʊ BA n AF ɐ BA n AF
kupas	k AC x BC ʊ BA p AG a AM s AH
kurba	k AC x BC ʊ BA ɾ BE b AG a AM
kurbata	k AC x BC ʊ BA ɾ BE b AG ɐ BA t AI ɐ BA
kurot	k AC x BC ʊ BA ɾ BE o BA t AI
kursonada	k AC x BC ʊ BA ɾ BE s AH o BA n AF ɐ BA d AI ɐ BA
kurtina	k AC x BC ʊ BA ɾ BE t AI ɪ AM n AF ɐ BA
kusina	k AC x BC ʊ BA s AH ɪ AM n AF ɐ BA
kustodiya	k AC x BC ʊ BA s AH t AI o BA d AI ɪ AM ɐ BA
kuting	k AC x BC ʊ BA t AI i AM ŋ AK
kutis	k AC x BC u BA t AI ɪ AM s AH
kuto	k AC x BC ʊ BA t AI o BA ʔ AL
kutsara	k AC x BC ʊ BA t AI ʃ AH ɐ BA ɾ BE ɐ BA
kutson	k AC x BC ʊ BA t AI ʃ AH o BA n AF
kutya	k AC x BC ʊ BA t AI ʃ AH a AM ʔ AL
kuwan	k AC w AJ a AM n AF
laba	l AD ɐ BA b AG a AM
labada	l AD ɐ BA b AG ɐ BA d AI ɐ BA
labag	l AD ɐ BA b AG a AM ɡ AC
labastida	l AD ɐ BA b AG ɐ BA s AH t AI ɪ AM d AI ɐ BA
labhan	l AD ɐ BA b AG h AA a AM n AF
labnot	l AD ɐ BA b AG n AF o BA t AI
labong	l AD ɐ BA b AG o BA ŋ AK
lacambra	l AD ɐ BA x BC ɐ BA m AE b AG ɾ BE ɐ BA
lacap	l AD ɐ BA x BC ɐ BA p AG
laganap	l AD ɐ BA ɰ AB ɐ BA n AF ɐ BA p AG
lagay	l AD ɐ BA ɰ AB a AM ɪ̯ AB
lagdameo	l AD ɐ BA ɡ AC d AI ɐ BA m AE ɛ AM o BA
lagmay	l AD ɐ BA ɡ AC m AE a AM ɪ̯ AB
lagundi	l AD ɐ BA ɰ AB ʊ BA n AF d AI i AM
laitin	l AD a AM ɪ̯ AB t AI ɪ AM n AF
lampara	l AD a AM m AE p AG ɐ BA ɾ BE ɐ BA
lampin	l AD ɐ BA m AE p AG i AM n AF
lana	l AD a AM n AF ɐ BA
landrito	l AD ɐ BA n AF d AI ɾ BE ɪ AM t AI o BA
langkaan	l AD ɐ BA ŋ AK k AC ɐ BA ʔ AL ɐ BA n AF
lanting	l AD ɐ BA n AF t AI ɪ AM ŋ AK
lantsa	l AD a AM n AF t AI ʃ AH ɐ BA
lanuza	l AD ɐ BA n AF ʊ BA s AH ɐ BA
lapis	l AD a AM p AG ɪ AM s AH
lapnos	l AD ɐ BA p AG n AF o BA s AH
lapuz	l AD ɐ BA p AG ʊ BA s AH
laquindanum	l AD ɐ BA x BC ɪ AM n AF d AI ɐ BA n AF ʊ BA m AE
larawan	l AD ɐ BA ɾ BE a AM w AJ ɐ BA n AF
lascano	l AD ɐ BA s AH k AC ɐ BA n AF o BA
laspag	l AD ɐ BA s AH p AG a AM ɡ AC
lastiko	l AD a AM s AH t AI ɪ AM x BC o BA
laswa	l AD ɐ BA s AH w AJ a AM ʔ AL
latayan	l AD ɐ BA t AI ɐ BA j AB ɐ BA n AF
lawa	l AD a AM w AJ ɐ BA ʔ AL
lawaan	l AD ɐ BA w AJ a AM ʔ AL ɐ BA n AF
laway	l AD a AM w AJ a AM ɪ̯ AB
lawlaw	l AD a AM ʊ̯ AJ l AD a AM ʊ̯ AJ
laxamana	l AD ɐ BA k AC s AH ɐ BA m AE ɐ BA n AF ɐ BA
layag	l AD a AM j AB ɐ BA ɡ AC
layas	l AD ɐ BA j AB a AM s AH
laygo	l AD a AM ɪ̯ AB ɰ AB o BA
laylayan	l AD a AM ɪ̯ AB l AD a AM j AB ɐ BA n AF
laylo	l AD a AM ɪ̯ AB l AD o BA
layno	l AD a AM ɪ̯ AB n AF o BA
lazarte	l AD ɐ BA s AH ɐ BA ɾ BE t AI ɛ AM
lazatin	l AD ɐ BA s AH ɐ BA t AI ɪ AM n AF
lehitimo	l AD ɛ AM h AA i AM t AI ɪ AM m AE o BA
leynes	l AD ɛ AM ɪ̯ AB n AF ɛ AM s AH
libak	l AD ɪ AM b AG a AM k AC
libradilla	l AD ɪ AM b AG ɾ BE ɐ BA d AI ɪ AM l AD l AD ɐ BA
libre	l AD ɪ AM b AG ɾ BE ɛ AM
lichauco	l AD ɪ AM t AI ʃ AH a AM ʊ̯ AJ x BC o BA
licup	l AD ɪ AM x BC ʊ BA p AG
ligpit	l AD ɪ AM ɡ AC p AG i AM t AI
liha	l AD ɪ AM h AA ɐ BA
lihim	l AD i AM h AA ɪ AM m AE
liko	l AD ɪ AM x BC o BA ʔ AL
limahid	l AD ɪ AM m AE a AM h AA ɪ AM d AI
limbaga	l AD ɪ AM m AE b AG ɐ BA ɰ AB ɐ BA
limjoco	l AD ɪ AM m AE d AI ʒ AH o BA x BC o BA
limos	l AD ɪ AM m AE o BA s AH
linatoc	l AD ɪ AM n AF ɐ BA t AI o BA k AC
lingad	l AD ɪ AM ŋ AK ɐ BA d AI
linggo	l AD ɪ AM ŋ AK ɡ AC o BA
lingon	l AD ɪ AM ŋ AK o BA n AF
linta	l AD ɪ AM n AF t AI a AM ʔ AL
liquigan	l AD ɪ AM x BC ɪ AM ɰ AB ɐ BA n AF
lising	l AD ɪ AM s AH ɪ AM ŋ AK
lislis	l AD ɪ AM s AH l AD i AM s AH
literasiya	l AD ɪ AM t AI ɛ AM ɾ BE ɐ BA s AH ɪ AM ɐ BA
litrato	l AD ɪ AM t AI ɾ BE ɐ BA t AI o BA
liwag	l AD ɪ AM w AJ ɐ BA ɡ AC
lizada	l AD ɪ AM s AH ɐ BA d AI ɐ BA
llanera	l AD l AD ɐ BA n AF ɛ AM ɾ BE ɐ BA
llanto	l AD l AD ɐ BA n AF t AI o BA
lobo	l AD o BA b AG o BA
logarta	l AD o BA ɰ AB ɐ BA ɾ BE t AI ɐ BA
loko	l AD o BA x BC o BA
lola	l AD o BA l AD ɐ BA
lomibao	l AD o BA m AE ɪ AM b AG a AM ʊ̯ AJ
lona	l AD o BA n AF ɐ BA
longhitud	l AD o BA ŋ AK h AA ɪ AM t AI ʊ BA d AI
lorenzana	l AD o BA ɾ BE ɛ AM n AF s AH ɐ BA n AF ɐ BA
loterya	l AD o BA t AI ɛ AM ɾ BE j AB ɐ BA
lozada	l AD o BA s AH ɐ BA d AI ɐ BA
lubak	l AD ʊ BA b AG a AM k AC
lubha	l AD ʊ BA b AG h AA a AM ʔ AL
lubiano	l AD ʊ BA b AG j AB ɐ BA n AF o BA
lukban	l AD ʊ BA k AC b AG ɐ BA n AF
lula	l AD ʊ BA l AD a AM ʔ AL
lumad	l AD u BA m AE ɐ BA d AI
lumagui	l AD ʊ BA m AE ɐ BA ɰ AB ɪ AM
lumanglas	l AD ʊ BA m AE ɐ BA ŋ AK l AD ɐ BA s AH
lumbang	l AD u BA m AE b AG ɐ BA ŋ AK
lumbao	l AD u BA m AE b AG a AM ʊ̯ AJ
lumibao	l AD ʊ BA m AE ɪ AM b AG a AM ʊ̯ AJ
luwag	l AD w AJ a AM ɡ AC
luzano	l AD ʊ BA s AH ɐ BA n AF o BA
luzon	l AD ʊ BA s AH o BA n AF
luzuriaga	l AD ʊ BA s AH ʊ BA ɾ BE j AB ɐ BA ɰ AB ɐ BA
maagrabyado	m AE ɐ BA ʔ AL ɐ BA ʔ AL ɡ AC ɾ BE ɐ BA b AG j AB a AM d AI o BA
maangas	m AE ɐ BA ʔ AL a AM ŋ AK ɐ BA s AH
mababa	m AE ɐ BA b AG a AM b AG ɐ BA ʔ AL
mabalot	m AE ɐ BA b AG ɐ BA l AD o BA t AI
mabigat	m AE ɐ BA b AG ɪ AM ɰ AB a AM t AI
mabini	m AE ɐ BA b AG ɪ AM n AF ɪ AM
mabulaklak	m AE ɐ BA b AG ʊ BA l AD ɐ BA k AC l AD a AM k AC
maburyong	m AE ɐ BA b AG ʊ BA ɾ BE j AB o BA ŋ AK
mabuwisit	m AE ɐ BA b AG w AJ i AM s AH ɪ AM t AI
macababbad	m AE ɐ BA x BC ɐ BA b AG ɐ BA b AG b AG ɐ BA d AI
macadangdang	m AE ɐ BA x BC ɐ BA d AI ɐ BA ŋ AK d AI ɐ BA ŋ AK
macalalad	m AE ɐ BA x BC ɐ BA l AD ɐ BA l AD ɐ BA d AI
macalindong	m AE ɐ BA x BC ɐ BA l AD ɪ AM n AF d AI o BA ŋ AK
macapagal	m AE ɐ BA x BC ɐ BA p AG ɐ BA ɰ AB ɐ BA l AD
macapinlac	m AE ɐ BA x BC ɐ BA p AG ɪ AM n AF l AD ɐ BA k AC
macapugay	m AE ɐ BA x BC ɐ BA p AG ʊ BA ɰ AB a AM ɪ̯ AB
macaranas	m AE ɐ BA x BC ɐ BA ɾ BE ɐ BA n AF ɐ BA s AH
macasaet	m AE ɐ BA x BC ɐ BA s AH ɐ BA ɛ AM t AI
macasieb	m AE ɐ BA x BC ɐ BA s AH ɪ AM ɛ AM b AG
macaspac	m AE ɐ BA x BC ɐ BA s AH p AG ɐ BA k AC
macatulad	m AE ɐ BA x BC ɐ BA t AI ʊ BA l AD ɐ BA d AI
maceda	m AE ɐ BA s AH ɛ AM d AI ɐ BA
macuha	m AE ɐ BA x BC ʊ BA h AA ɐ BA
madalas	m AE ɐ BA d AI ɐ BA l AD a AM s AH
madlangbayan	m AE ɐ BA d AI l AD ɐ BA ŋ AK b AG ɐ BA j AB ɐ BA n AF
madriaga	m AE ɐ BA d AI ɾ BE ɪ AM ɐ BA ɰ AB ɐ BA
madulas	m AE ɐ BA d AI ʊ BA l AD a AM s AH
magaling	m AE ɐ BA ɰ AB ɐ BA l AD ɪ AM ŋ AK
magallanes	m AE ɐ BA ɰ AB ɐ BA l AD l AD ɐ BA n AF ɛ AM s AH
magalona	m AE ɐ BA ɰ AB ɐ BA l AD o BA n AF ɐ BA
magandahan	m AE ɐ BA ɰ AB ɐ BA n AF d AI ɐ BA h AA a AM n AF
magbabaon	n AF ɐ BA ɡ AC b AG ɐ BA ʔ AL o BA n AF
magbanua	m AE ɐ BA ɡ AC b AG ɐ BA n AF ʊ BA ɐ BA
magbaon	m AE ɐ BA ɡ AC b AG ɐ BA ʔ AL o BA n AF
magbarena	m AE ɐ BA ɡ AC b AG ɐ BA ɾ BE ɛ AM n AF ɐ BA
magbihis	m AE ɐ BA ɡ AC b AG i AM h AA ɪ AM s AH
magbinata	m AE ɐ BA ɡ AC b AG ɪ AM n AF ɐ BA t AI a AM ʔ AL
magbiro	m AE ɐ BA ɡ AC b AG ɪ AM ɾ BE o BA ʔ AL
magbisikleta	m AE ɐ BA ɡ AC b AG ɪ AM s AH ɪ AM k AC l AD ɛ AM t AI ɐ BA
magboo	m AE ɐ BA ɡ AC b AG o BA o BA
magbubukid	m AE ɐ BA ɡ AC b AG ʊ BA b AG ʊ BA x BC i AM d AI
magbuhat	m AE ɐ BA ɡ AC b AG ʊ BA h AA ɐ BA t AI
magbulakbol	m AE ɐ BA ɡ AC b AG ʊ BA l AD ɐ BA k AC b AG o BA l AD
magdalaga	m AE ɐ BA ɡ AC d AI ɐ BA l AD ɐ BA ɰ AB a AM
magdayao	m AE ɐ BA ɡ AC d AI ɐ BA j AB a AM ʊ̯ AJ
magdeliryo	m AE ɐ BA ɡ AC d AI ɛ AM l AD i AM ɾ BE j AB o BA
magdemanda	m AE ɐ BA ɡ AC d AI ɛ AM m AE ɐ BA n AF d AI ɐ BA
maghabilin	m AE ɐ BA ɡ AC h AA ɐ BA b AG ɪ AM l AD ɪ AM n AF
maghabla	m AE ɐ BA ɡ AC h AA ɐ BA b AG l AD a AM
maghanapbuhay	m AE ɐ BA ɡ AC h AA ɐ BA n AF ɐ BA p AG b AG ʊ BA h AA a AM ɪ̯ AB
maghanda	m AE ɐ BA ɡ AC h AA ɐ BA n AF d AI a AM ʔ AL
maghangad	m AE ɐ BA ɡ AC h AA ɐ BA ŋ AK a AM d AI
maghari	m AE ɐ BA ɡ AC h AA a AM ɾ BE ɪ AM ʔ AL
maghasik	m AE ɐ BA ɡ AC h AA ɐ BA s AH i AM k AC
maghati	m AE ɐ BA ɡ AC h AA ɐ BA t AI ɪ AM ʔ AL
maghiganti	m AE ɐ BA ɡ AC h AA ɪ AM ɰ AB ɐ BA n AF t AI i AM
maghikab	m AE ɐ BA ɡ AC h AA ɪ AM x BC a AM b AG
maghikaw	m AE ɐ BA ɡ AC h AA ɪ AM x BC a AM ʊ̯ AJ
maghilik	m AE ɐ BA ɡ AC h AA ɪ AM l AD i AM k AC
maghimagsik	m AE ɐ BA ɡ AC h AA ɪ AM m AE ɐ BA ɡ AC s AH i AM k AC
maghimutok	m AE ɐ BA ɡ AC h AA ɪ AM m AE ʊ BA t AI o BA k AC
maghinala	m AE ɐ BA ɡ AC h AA ɪ AM n AF ɐ BA l AD ɐ BA ʔ AL
maghingalo	m AE ɐ BA ɡ AC h AA ɪ AM ŋ AK ɐ BA l AD o BA
maghinto	m AE ɐ BA ɡ AC h AA ɪ AM n AF t AI o BA ʔ AL
maghinuha	m AE ɐ BA ɡ AC h AA ɪ AM n AF u BA h AA ɐ BA ʔ AL
maghirang	m AE ɐ BA ɡ AC h AA ɪ AM ɾ BE ɐ BA ŋ AK
maghirap	m AE ɐ BA ɡ AC h AA ɪ AM ɾ BE ɐ BA p AG
maghiyas	m AE ɐ BA ɡ AC h AA ɪ AM a AM s AH
maghumpay	m AE ɐ BA ɡ AC h AA u BA m AE p AG a AM ɪ̯ AB
magkanlong	m AE ɐ BA ɡ AC k AC ɐ BA n AF l AD o BA ŋ AK
magkataon	m AE ɐ BA ɡ AC k AC ɐ BA t AI ɐ BA ʔ AL o BA n AF
maglalang	m AE ɐ BA ɡ AC l AD ɐ BA l AD ɐ BA ŋ AK
maglanggas	m AE ɐ BA ɡ AC l AD ɐ BA ŋ AK ɡ AC a AM s AH
maglangib	m AE ɐ BA ɡ AC l AD ɐ BA ŋ AK i AM b AG
maglango	m AE ɐ BA ɡ AC l AD ɐ BA ŋ AK o BA
maglantod	m AE ɐ BA ɡ AC l AD ɐ BA n AF t AI o BA d AI
maglapa	m AE ɐ BA ɡ AC l AD a AM p AG ɐ BA ʔ AL
maglarawan	m AE ɐ BA ɡ AC l AD ɐ BA ɾ BE ɐ BA w AJ ɐ BA n AF
maglaro	m AE ɐ BA ɡ AC l AD ɐ BA ɾ BE o BA ʔ AL
maglaso	m AE ɐ BA ɡ AC l AD ɐ BA s AH o BA
maglaway	m AE ɐ BA ɡ AC l AD ɐ BA w AJ a AM ɪ̯ AB
maglingid	m AE ɐ BA ɡ AC l AD ɪ AM ŋ AK i AM d AI
maglingkod	m AE ɐ BA ɡ AC l AD ɪ AM ŋ AK k AC o BA d AI
maglola	m AE ɐ BA ɡ AC l AD o BA l AD ɐ BA
maglolo	m AE ɐ BA ɡ AC l AD o BA l AD o BA
magmaliw	m AE ɐ BA ɡ AC m AE ɐ BA l AD ɪ AM ʊ̯ AJ
magmartsa	m AE ɐ BA ɡ AC m AE ɐ BA ɾ BE t AI ʃ AH ɐ BA
magnakaw	m AE ɐ BA ɡ AC n AF a AM x BC a AM ʊ̯ AJ
magno	m AE ɐ BA ɡ AC n AF o BA
magpalaganap	m AE ɐ BA ɡ AC p AG ɐ BA l AD ɐ BA ɰ AB a AM n AF ɐ BA p AG
magpanatili	m AE ɐ BA ɡ AC p AG ɐ BA n AF ɐ BA t AI ɪ AM l AD ɪ AM
magparaya	m AE ɐ BA ɡ AC p AG ɐ BA ɾ BE ɐ BA j AB ɐ BA ʔ AL
magpasubasta	m AE ɐ BA ɡ AC p AG ɐ BA s AH ʊ BA b AG ɐ BA s AH t AI ɐ BA
magpaubaya	m AE ɐ BA ɡ AC p AG ɐ BA ʔ AL ʊ BA b AG ɐ BA j AB ɐ BA ʔ AL
magpraktis	m AE ɐ BA ɡ AC p AG ɾ BE ɐ BA k AC t AI ɪ AM s AH
magrenta	m AE ɐ BA ɡ AC ɾ BE ɛ AM n AF t AI ɐ BA
magsalang	m AE ɐ BA ɡ AC s AH a AM l AD ɐ BA ŋ AK
magsaliksik	m AE ɐ BA ɡ AC s AH ɐ BA l AD ɪ AM k AC s AH i AM k AC
magsimba	m AE ɐ BA ɡ AC s AH ɪ AM m AE b AG a AM
magsiwalat	m AE ɐ BA ɡ AC s AH ɪ AM w AJ a AM l AD ɐ BA t AI
magsugal	m AE ɐ BA ɡ AC s AH ʊ BA ɰ AB a AM l AD
magsuntukan	m AE ɐ BA ɡ AC s AH ʊ BA n AF t AI ʊ BA x BC ɐ BA n AF
magtalas	m AE ɐ BA ɡ AC t AI ɐ BA l AD ɐ BA s AH
magtalo	m AE ɐ BA ɡ AC t AI ɐ BA l AD o BA
magustuhan	m AE ɐ BA ɰ AB ʊ BA s AH t AI ʊ BA h AA a AM n AF
mahinay	m AE ɐ BA h AA ɪ AM n AF a AM ɪ̯ AB
mahirap	m AE ɐ BA h AA i AM ɾ BE ɐ BA p AG
maingay	m AE ɐ BA ʔ AL i AM ŋ AK a AM ɪ̯ AB
mais	m AE ɐ BA ʔ AL i AM s AH
makalat	m AE ɐ BA x BC a AM l AD ɐ BA t AI
makaluma	m AE ɐ BA x BC ɐ BA l AD u BA m AE ɐ BA ʔ AL
makapuno	m AE ɐ BA x BC ɐ BA p AG ʊ BA n AF o BA ʔ AL
makatotohanan	m AE ɐ BA x BC ɐ BA t AI o BA t AI o BA h AA ɐ BA n AF ɐ BA n AF
makatulog	m AE ɐ BA x BC ɐ BA t AI ʊ BA l AD o BA ɡ AC
makiapid	m AE ɐ BA x BC i AM ʔ AL ɐ BA p AG i AM d AI
makibahagi	m AE ɐ BA x BC ɪ AM b AG ɐ BA h AA a AM ɰ AB ɪ AM ʔ AL
makina	m AE a AM x BC ɪ AM n AF ɐ BA
makinis	m AE ɐ BA x BC ɪ AM n AF ɪ AM s AH
makipagbati	m AE ɐ BA x BC ɪ AM p AG ɐ BA ɡ AC b AG ɐ BA t AI i AM ʔ AL
makipagsuntukan	m AE ɐ BA x BC ɪ AM p AG ɐ BA ɡ AC s AH ʊ BA n AF t AI ʊ BA x BC ɐ BA n AF
makontento	m AE ɐ BA x BC o BA n AF t AI ɛ AM n AF t AI o BA
makulimlim	m AE ɐ BA x BC ʊ BA l AD ɪ AM m AE l AD i AM m AE
makunan	m AE ɐ BA x BC ʊ BA n AF ɐ BA n AF
malabuyoc	m AE ɐ BA l AD ɐ BA b AG ʊ BA j AB o BA k AC
malakanyang	m AE ɐ BA l AD ɐ BA x BC ɐ BA ɲ AK ɐ BA ŋ AK
malaluan	m AE ɐ BA l AD ɐ BA l AD ʊ BA ɐ BA n AF
malambot	m AE ɐ BA l AD ɐ BA m AE b AG o BA t AI
malas	m AE ɐ BA l AD ɐ BA s AH
malaswa	m AE ɐ BA l AD ɐ BA s AH w AJ a AM ʔ AL
malibiran	m AE ɐ BA l AD ɪ AM b AG ɪ AM ɾ BE ɐ BA n AF
malicsi	m AE ɐ BA l AD ɪ AM k AC s AH ɪ AM
maligaw	m AE ɐ BA l AD ɪ AM ɰ AB a AM ʊ̯ AJ
malihan	m AE ɐ BA l AD ɪ AM h AA ɐ BA n AF
maliksi	m AE ɐ BA l AD ɪ AM k AC s AH ɪ AM
mallare	m AE ɐ BA l AD l AD ɐ BA ɾ BE ɛ AM
mallorca	m AE ɐ BA l AD l AD o BA ɾ BE k AC ɐ BA
malubak	m AE ɐ BA l AD ʊ BA b AG a AM k AC
mamagitan	m AE ɐ BA m AE ɐ BA ɰ AB i AM t AI ɐ BA n AF
mamahagi	m AE ɐ BA m AE ɐ BA h AA a AM ɰ AB ɪ AM ʔ AL
mamakyaw	m AE ɐ BA m AE ɐ BA k AC j AB a AM ʊ̯ AJ
mamanhikan	m AE ɐ BA m AE ɐ BA ŋ AK h AA ɪ AM x BC ɐ BA n AF
mamaril	m AE ɐ BA m AE ɐ BA ɾ BE ɪ AM l AD
mamasada	m AE ɐ BA m AE ɐ BA s AH ɐ BA d AI ɐ BA
mamasura	m AE ɐ BA m AE ɐ BA s AH ʊ BA ɾ BE ɐ BA
mambabae	m AE ɐ BA m AE b AG ɐ BA b AG ɐ BA ʔ AL ɛ AM
mambola	m AE ɐ BA m AE b AG o BA l AD ɐ BA
mamboso	m AE ɐ BA m AE b AG o BA s AH o BA
mambugaw	m AE ɐ BA m AE b AG u BA ɰ AB a AM ʊ̯ AJ
mambuwisit	m AE ɐ BA m AE b AG w AJ i AM s AH ɪ AM t AI
mamigay	m AE ɐ BA m AE ɪ AM ɰ AB a AM ɪ̯ AB
mamihasa	m AE ɐ BA m AE ɪ AM h AA a AM s AH ɐ BA ʔ AL
mamimili	m AE ɐ BA m AE ɪ AM m AE ɪ AM l AD ɪ AM
mamintog	m AE ɐ BA m AE ɪ AM n AF t AI o BA ɡ AC
mamuhunan	m AE ɐ BA m AE ʊ BA h AA ʊ BA n AF ɐ BA n AF
mamulaklak	m AE ɐ BA m AE ʊ BA l AD ɐ BA k AC l AD a AM k AC
mamuti	m AE ɐ BA m AE ʊ BA t AI i AM ʔ AL
mamuyac	m AE ɐ BA m AE ʊ BA j AB ɐ BA k AC
manabat	m AE ɐ BA n AF ɐ BA b AG ɐ BA t AI
manabunot	m AE ɐ BA n AF ɐ BA b AG ʊ BA n AF o BA t AI
managinip	m AE ɐ BA n AF ɐ BA ɰ AB i AM n AF ɪ AM p AG
manakit	m AE ɐ BA n AF ɐ BA x BC i AM t AI
manalad	m AE ɐ BA n AF ɐ BA l AD ɐ BA d AI
manalo	m AE ɐ BA n AF a AM l AD o BA
manaloto	m AE ɐ BA n AF ɐ BA l AD o BA t AI o BA
manamantala	m AE ɐ BA n AF ɐ BA m AE ɐ BA n AF t AI ɐ BA l AD a AM
mananahi	m AE ɐ BA n AF ɐ BA n AF ɐ BA h AA i AM ʔ AL
manananggal	m AE ɐ BA n AF ɐ BA n AF ɐ BA ŋ AK ɡ AC a AM l AD
manangan	m AE ɐ BA n AF ɐ BA ŋ AK ɐ BA n AF
mananghalian	m AE ɐ BA n AF ɐ BA ŋ AK h AA ɐ BA l AD i AM ʔ AL ɐ BA n AF
mananquil	m AE ɐ BA n AF ɐ BA ŋ AK k AC ɪ AM l AD
manantan	m AE ɐ BA n AF ɐ BA n AF t AI ɐ BA n AF
manaog	m AE ɐ BA n AF ɐ BA o BA ɡ AC
manaois	m AE ɐ BA n AF ɐ BA o BA ɪ̯ AB s AH
manarang	m AE ɐ BA n AF ɐ BA ɾ BE ɐ BA ŋ AK
manatad	m AE ɐ BA n AF ɐ BA t AI ɐ BA d AI
mancao	m AE ɐ BA ŋ AK k AC a AM ʊ̯ AJ
mandaragat	m AE ɐ BA n AF d AI ɐ BA ɾ BE ɐ BA ɰ AB a AM t AI
mandirigma	m AE ɐ BA n AF d AI ɪ AM ɾ BE ɪ AM ɡ AC m AE a AM ʔ AL
mandocdoc	m AE ɐ BA n AF d AI o BA k AC d AI o BA k AC
mandukot	m AE ɐ BA n AF d AI u BA x BC o BA t AI
mandurukot	m AE ɐ BA n AF d AI ʊ BA ɾ BE u BA x BC o BA t AI
mangagat	m AE ɐ BA ŋ AK ɐ BA ɰ AB a AM t AI
mangailangan	m AE ɐ BA ŋ AK ɐ BA ʔ AL ɪ AM l AD ɐ BA ŋ AK ɐ BA n AF
mangalunya	m AE ɐ BA ŋ AK ɐ BA l AD ʊ BA ɲ AK a AM ʔ AL
mangamba	m AE ɐ BA ŋ AK ɐ BA m AE b AG a AM
mangamote	m AE ɐ BA ŋ AK ɐ BA m AE o BA t AI ɛ AM
manganak	m AE ɐ BA ŋ AK ɐ BA n AF a AM k AC
mangaoang	m AE ɐ BA ŋ AK ɐ BA w AJ ɐ BA ŋ AK
mangaway	m AE ɐ BA ŋ AK ɐ BA w AJ a AM ɪ̯ AB
manggagantso	m AE ɐ BA ŋ AK ɡ AC ɐ BA ɰ AB ɐ BA n AF t AI ʃ AH o BA
manggantso	m AE ɐ BA ŋ AK ɡ AC ɐ BA n AF t AI ʃ AH o BA
manggas	m AE ɐ BA ŋ AK ɡ AC a AM s AH
manggulo	m AE ɐ BA ŋ AK ɡ AC ʊ BA l AD o BA
manghawa	m AE ɐ BA ŋ AK h AA ɐ BA w AJ ɐ BA
manghimasok	m AE ɐ BA ŋ AK h AA ɪ AM m AE a AM s AH o BA k AC
manghuhula	m AE ɐ BA ŋ AK h AA ʊ BA h AA u BA l AD ɐ BA ʔ AL
manghula	m AE ɐ BA ŋ AK h AA u BA l AD ɐ BA ʔ AL
manghusga	m AE ɐ BA ŋ AK h AA ʊ BA s AH ɡ AC a AM
mangikil	m AE ɐ BA ŋ AK i AM x BC ɪ AM l AD
mangilit	m AE ɐ BA ŋ AK ɪ AM l AD ɪ AM t AI
mangingisda	m AE ɐ BA ŋ AK ɪ AM ŋ AK ɪ AM s AH d AI a AM ʔ AL
mangisay	m AE ɐ BA ŋ AK ɪ AM s AH a AM ɪ̯ AB
mangisda	m AE ɐ BA ŋ AK ɪ AM s AH d AI a AM ʔ AL
mangitlog	m AE ɐ BA ŋ AK ɪ AM t AI l AD o BA ɡ AC
mangkok	m AE ɐ BA ŋ AK k AC o BA k AC
manglicmot	m AE ɐ BA ŋ AK l AD ɪ AM k AC m AE o BA t AI
mangoba	m AE ɐ BA ŋ AK o BA b AG ɐ BA
mangopya	m AE ɐ BA ŋ AK o BA p AG j AB ɐ BA
mangubra	m AE ɐ BA ŋ AK ʊ BA b AG ɾ BE a AM
manguiat	m AE ɐ BA ŋ AK ɪ AM ɐ BA t AI
mangulabnan	m AE ɐ BA ŋ AK ʊ BA l AD ɐ BA b AG n AF ɐ BA n AF
mangulangot	m AE ɐ BA ŋ AK ʊ BA l AD a AM ŋ AK o BA t AI
mangupit	m AE ɐ BA ŋ AK u BA p AG ɪ AM t AI
manhid	m AE ɐ BA ŋ AK h AA i AM d AI
maniago	m AE ɐ BA n AF ɪ AM ɐ BA ɰ AB o BA
maniego	m AE ɐ BA ɲ AK ɛ AM ɰ AB o BA
manilaw	m AE ɐ BA n AF ɪ AM l AD a AM ʊ̯ AJ
manilip	m AE ɐ BA n AF i AM l AD ɪ AM p AG
manindigan	m AE ɐ BA n AF ɪ AM n AF d AI ɪ AM ɰ AB ɐ BA n AF
maniquiz	m AE ɐ BA n AF ɪ AM x BC ɪ AM s AH
manlaban	m AE ɐ BA n AF l AD ɐ BA b AG a AM n AF
manlait	m AE ɐ BA n AF l AD ɐ BA ʔ AL ɪ AM t AI
manlangit	m AE ɐ BA n AF l AD ɐ BA ŋ AK ɪ AM t AI
manlapaz	m AE ɐ BA n AF l AD ɐ BA p AG ɐ BA s AH
manlapig	m AE ɐ BA n AF l AD ɐ BA p AG ɪ AM ɡ AC
manloko	m AE ɐ BA n AF l AD o BA x BC o BA
manlutac	m AE ɐ BA n AF l AD ʊ BA t AI ɐ BA k AC
manrique	m AE ɐ BA n AF ɾ BE ɪ AM x BC ɛ AM
mansiyon	m AE ɐ BA n AF ʃ AH o BA n AF
mantika	m AE ɐ BA n AF t AI i AM x BC ɐ BA ʔ AL
manuhol	m AE ɐ BA n AF u BA h AA o BA l AD
manuntok	m AE ɐ BA n AF ʊ BA n AF t AI o BA k AC
mapagmatyag	m AE ɐ BA p AG ɐ BA ɡ AC m AE ɐ BA t AI ʃ AH a AM ɡ AC
mapagsamantala	m AE ɐ BA p AG ɐ BA ɡ AC s AH ɐ BA m AE ɐ BA n AF t AI ɐ BA l AD a AM
mapahiya	m AE ɐ BA p AG ɐ BA h AA ɪ AM a AM ʔ AL
mapalad	m AE ɐ BA p AG ɐ BA l AD ɐ BA d AI
mapanghusga	m AE ɐ BA p AG a AM ŋ AK h AA ʊ BA s AH ɡ AC a AM
mapangutya	m AE ɐ BA p AG a AM ŋ AK ʊ BA t AI ʃ AH a AM ʔ AL
mapaniil	m AE ɐ BA p AG ɐ BA n AF ɪ AM i AM l AD
mapusyaw	m AE ɐ BA p AG ʊ BA ʃ AH ɐ BA u BA
maralit	m AE ɐ BA ɾ BE ɐ BA l AD ɪ AM t AI
marapao	m AE ɐ BA ɾ BE ɐ BA p AG ɐ BA o BA
maravilla	m AE ɐ BA ɾ BE ɐ BA b AG ɪ AM l AD l AD ɐ BA
marbella	m AE ɐ BA ɾ BE b AG ɛ AM l AD l AD ɐ BA
marcial	m AE ɐ BA ɾ BE ʃ AH ɐ BA l AD
maristela	m AE ɐ BA ɾ BE ɪ AM s AH t AI ɛ AM l AD ɐ BA
mariñas	m AE ɐ BA ɾ BE ɪ AM ɲ AK ɐ BA s AH
marquez	m AE ɐ BA ɾ BE k AC ɛ AM s AH
marquinez	m AE ɐ BA ɾ BE k AC ɪ AM n AF ɛ AM s AH
marupok	m AE ɐ BA ɾ BE ʊ BA p AG o BA k AC
masabon	m AE ɐ BA s AH ɐ BA b AG o BA n AF
masaker	m AE ɐ BA s AH ɐ BA x BC ɛ AM ɾ BE
masamid	m AE a AM s AH ɐ BA m AE i AM d AI
masangcay	m AE ɐ BA s AH ɐ BA ŋ AK k AC a AM ɪ̯ AB
masangkay	m AE ɐ BA s AH ɐ BA ŋ AK k AC a AM ɪ̯ AB
maselan	m AE ɐ BA s AH ɛ AM l AD ɐ BA n AF
maski	m AE ɐ BA s AH k AC i AM
masukal	m AE ɐ BA s AH u BA x BC ɐ BA l AD
masurot	m AE ɐ BA s AH ʊ BA ɾ BE o BA t AI
mataasnakahoy	m AE ɐ BA t AI ɐ BA ʔ AL a AM s AH n AF ɐ BA x BC ɐ BA h AA o BA ɪ̯ AB
matae	m AE ɐ BA t AI ɐ BA ʔ AL ɛ AM
matalo	m AE ɐ BA t AI a AM l AD o BA
matatakutin	m AE ɐ BA t AI ɐ BA t AI ɐ BA x BC ʊ BA t AI i AM n AF
matauhan	m AE ɐ BA t AI ɐ BA ʔ AL u BA h AA ɐ BA n AF
matibag	m AE ɐ BA t AI ɪ AM b AG ɐ BA ɡ AC
matigas	m AE ɐ BA t AI ɪ AM ɰ AB a AM s AH
matisod	m AE ɐ BA t AI i AM s AH o BA d AI
matrapik	m AE ɐ BA t AI ɾ BE a AM p AG ɪ AM k AC
mauleon	m AE a AM ʊ̯ AJ l AD ɛ AM o BA n AF
maunahan	m AE a AM ʊ̯ AJ n AF ɐ BA h AA ɐ BA n AF
maya	m AE a AM j AB ɐ BA
mayuga	m AE ɐ BA j AB ʊ BA ɰ AB ɐ BA
mañago	m AE ɐ BA ɲ AK ɐ BA ɰ AB o BA
mañalac	m AE ɐ BA ɲ AK ɐ BA l AD ɐ BA k AC
medalya	m AE ɛ AM d AI a AM l AD j AB ɐ BA
medrano	m AE ɛ AM d AI ɾ BE ɐ BA n AF o BA
melegrito	m AE ɛ AM l AD ɛ AM ɡ AC ɾ BE ɪ AM t AI o BA
menchavez	m AE ɛ AM n AF t AI ʃ AH ɐ BA b AG ɛ AM s AH
menorca	m AE ɛ AM n AF o BA ɾ BE k AC ɐ BA
meryenda	m AE ɛ AM ɾ BE j AB ɛ AM n AF d AI ɐ BA
mesa	m AE ɛ AM s AH ɐ BA
michelena	m AE ɪ AM t AI ʃ AH ɛ AM l AD ɛ AM n AF ɐ BA
mijares	m AE ɪ AM d AI ʒ AH ɐ BA ɾ BE ɛ AM s AH
militante	m AE ɪ AM l AD ɪ AM t AI ɐ BA n AF t AI ɛ AM
minviluz	m AE ɪ AM n AF b AG ɪ AM l AD ʊ BA s AH
miranda	m AE ɪ AM ɾ BE ɐ BA n AF d AI ɐ BA
misteryo	m AE ɪ AM s AH t AI ɛ AM ɾ BE j AB o BA
mitsa	m AE ɪ AM t AI ʃ AH a AM
mondragon	m AE o BA n AF d AI ɾ BE ɐ BA ɰ AB o BA n AF
montealegre	m AE o BA n AF t AI ɛ AM ɐ BA l AD ɛ AM ɡ AC ɾ BE ɛ AM
montecalvo	m AE o BA n AF t AI ɛ AM x BC ɐ BA l AD b AG o BA
montejo	ʔ AL ɐ BA l AD k AC a AM ɪ̯ AB d AI ɛ AM
montillano	m AE o BA n AF t AI ɪ AM l AD l AD ɐ BA n AF o BA
montinola	m AE o BA n AF t AI ɪ AM n AF o BA l AD ɐ BA
montoya	m AE o BA n AF t AI o BA j AB ɐ BA
morato	m AE o BA ɾ BE ɐ BA t AI o BA
munggo	m AE ʊ BA ŋ AK ɡ AC o BA
mura	m AE u BA ɾ BE ɐ BA
musika	m AE u BA s AH ɪ AM x BC ɐ BA
musoleyo	m AE ʊ BA s AH o BA l AD ɛ AM j AB o BA
mutuc	m AE ʊ BA t AI ʊ BA k AC
nacpil	n AF ɐ BA k AC p AG ɪ AM l AD
nagbabaon	n AF ɐ BA ɡ AC b AG ɐ BA b AG ɐ BA ʔ AL o BA n AF
nagbaon	n AF ɐ BA ɡ AC b AG ɐ BA ʔ AL o BA n AF
nakakaalarma	n AF ɐ BA x BC ɐ BA k AC ɐ BA ɐ BA l AD ɐ BA ɾ BE m AE ɐ BA
nakakabingi	n AF ɐ BA x BC ɐ BA k AC ɐ BA b AG ɪ AM ŋ AK i AM
nakakabuwisit	n AF ɐ BA x BC ɐ BA k AC ɐ BA b AG w AJ i AM s AH ɪ AM t AI
nakakabwisit	n AF ɐ BA x BC ɐ BA k AC ɐ BA b AG w AJ i AM s AH ɪ AM t AI
nakakahawa	n AF ɐ BA x BC ɐ BA k AC ɐ BA h AA a AM w AJ ɐ BA
nakakaintriga	n AF ɐ BA x BC ɐ BA k AC ɐ BA ʔ AL ɪ AM n AF t AI ɾ BE ɪ AM ɰ AB ɐ BA
nakakaloko	n AF ɐ BA x BC ɐ BA k AC ɐ BA l AD o BA x BC o BA
nakakatakot	n AF ɐ BA x BC ɐ BA k AC ɐ BA t AI a AM x BC o BA t AI
nakamulaga	n AF ɐ BA x BC ɐ BA m AE ʊ BA l AD ɐ BA ɰ AB a AM ʔ AL
nakawin	n AF ɐ BA x BC ɐ BA w AJ ɪ AM n AF
nakpil	n AF ɐ BA k AC p AG ɪ AM l AD
nanlilimahid	n AF ɐ BA n AF l AD ɪ AM l AD ɪ AM m AE a AM h AA ɪ AM d AI
narvaez	n AF ɐ BA ɾ BE b AG ɐ BA ɛ AM s AH
natae	n AF ɐ BA t AI ɐ BA ʔ AL ɛ AM
navoa	n AF ɐ BA b AG o BA ɐ BA
ngalan	ŋ AK a AM l AD ɐ BA n AF
ngimay	ŋ AK ɪ AM m AE a AM ɪ̯ AB
nguso	ŋ AK ʊ BA s AH o BA ʔ AL
nguya	ŋ AK ʊ BA j AB ɐ BA ʔ AL
nicdao	n AF ɪ AM k AC d AI ɐ BA o BA
nietes	ɲ AK ɛ AM t AI ɛ AM s AH
niknik	n AF ɪ AM k AC n AF i AM k AC
nilabhan	n AF ɪ AM l AD ɐ BA b AG h AA a AM n AF
ninang	n AF ɪ AM n AF ɐ BA ŋ AK
niyo	ɲ AK o BA
nobela	n AF o BA b AG ɛ AM l AD ɐ BA
nobleza	n AF o BA b AG l AD ɛ AM s AH ɐ BA
nolasco	n AF o BA l AD ɐ BA s AH k AC o BA
noriega	n AF o BA ɾ BE j AB ɛ AM ɰ AB ɐ BA
notarte	n AF o BA t AI ɐ BA ɾ BE t AI ɛ AM
nuevo	n AF ʊ BA ɛ AM b AG o BA
obligacion	ʔ AL o BA b AG l AD ɪ AM ɰ AB ɐ BA ʃ AH o BA n AF
ocampo	ʔ AL o BA x BC ɐ BA m AE p AG o BA
olaguer	ʔ AL o BA l AD ɐ BA ɰ AB ɛ AM ɾ BE
olaivar	ʔ AL o BA l AD a AM ɪ̯ AB b AG ɐ BA ɾ BE
olalia	ʔ AL o BA l AD ɐ BA l AD ɪ AM ɐ BA
olayvar	ʔ AL o BA l AD a AM ɪ̯ AB b AG ɐ BA ɾ BE
oliva	ʔ AL o BA l AD ɪ AM b AG ɐ BA
olivares	ʔ AL o BA l AD ɪ AM b AG ɐ BA ɾ BE ɛ AM s AH
oliveros	ʔ AL o BA l AD ɪ AM b AG ɛ AM ɾ BE o BA s AH
ongkiko	ʔ AL o BA ŋ AK k AC ɪ AM x BC o BA
opeña	ʔ AL o BA p AG ɛ AM ɲ AK ɐ BA
opisyales	ʔ AL o BA p AG ɪ AM ʃ AH ɐ BA l AD ɛ AM s AH
opyum	ʔ AL o BA p AG j AB ʊ BA m AE
oracion	ʔ AL o BA ɾ BE ɐ BA ʃ AH o BA n AF
orendain	ʔ AL o BA ɾ BE ɛ AM n AF d AI a AM ɪ̯ AB n AF
oribello	ʔ AL o BA ɾ BE ɪ AM b AG ɛ AM l AD l AD o BA
pabor	p AG ɐ BA b AG o BA ɾ BE
paborito	p AG ɐ BA b AG o BA ɾ BE a AM b AG l AD ɛ AM
pacana	p AG ɐ BA x BC ɐ BA n AF ɐ BA
pacaña	p AG ɐ BA x BC ɐ BA ɲ AK ɐ BA
pader	p AG ɐ BA d AI ɛ AM ɾ BE
pagala	p AG ɐ BA ɰ AB a AM l AD ɐ BA ʔ AL
pagbasehan	p AG ɐ BA ɡ AC b AG ɐ BA s AH ɛ AM h AA ɐ BA n AF
pagbati	p AG ɐ BA ɡ AC b AG a AM t AI ɪ AM ʔ AL
pagbubuntis	p AG ɐ BA ɡ AC b AG ʊ BA b AG ʊ BA n AF t AI i AM s AH
pagcaliwagan	p AG ɐ BA ɡ AC k AC ɐ BA l AD ɪ AM w AJ ɐ BA ɰ AB ɐ BA n AF
pagdilao	p AG ɐ BA ɡ AC d AI ɪ AM l AD a AM ʊ̯ AJ
paggiba	p AG ɐ BA ɡ AC ɡ AC ɪ AM b AG a AM ʔ AL
pagi	p AG a AM ɰ AB ɪ AM
pagitan	p AG ɐ BA ɰ AB i AM t AI ɐ BA n AF
pagkakataon	p AG ɐ BA ɡ AC k AC ɐ BA x BC ɐ BA t AI ɐ BA ʔ AL o BA n AF
pagmamadali	p AG ɐ BA ɡ AC m AE ɐ BA m AE ɐ BA d AI ɐ BA l AD i AM ʔ AL
pagnanakaw	p AG ɐ BA ɡ AC n AF ɐ BA n AF a AM x BC a AM ʊ̯ AJ
pagsamantalahan	p AG ɐ BA ɡ AC s AH ɐ BA m AE ɐ BA n AF t AI ɐ BA l AD ɐ BA h AA a AM n AF
pagsanjan	p AG ɐ BA ɡ AC s AH ɐ BA ŋ AK h AA a AM n AF
pagsuway	p AG ɐ BA ɡ AC s AH w AJ a AM ɪ̯ AB
pagtakhan	p AG ɐ BA ɡ AC t AI ɐ BA k AC h AA ɐ BA n AF
pagtripan	p AG ɐ BA ɡ AC t AI ɾ BE ɪ AM p AG a AM n AF
pagtutulungan	p AG ɐ BA ɡ AC t AI ʊ BA t AI ʊ BA l AD ʊ BA ŋ AK a AM n AF
paguia	p AG ɐ BA ɡ AC j AB ɐ BA
paguio	p AG ɐ BA ɡ AC j AB o BA
pahina	p AG a AM h AA ɪ AM n AF ɐ BA
pahintulot	p AG ɐ BA h AA ɪ AM n AF t AI ʊ BA l AD o BA t AI
pahiyain	p AG ɐ BA h AA ɪ AM ɐ BA ʔ AL i AM n AF
pajares	p AG ɐ BA d AI ʒ AH ɐ BA ɾ BE ɛ AM s AH
pakla	p AG ɐ BA k AC l AD a AM
pakulo	p AG ɐ BA x BC ʊ BA l AD o BA ʔ AL
palacol	p AG ɐ BA l AD ɐ BA x BC o BA l AD
palafox	p AG ɐ BA l AD ɐ BA p AG o BA k AC s AH
palahaw	p AG ɐ BA l AD a AM h AA a AM ʊ̯ AJ
palakol	p AG ɐ BA l AD ɐ BA x BC o BA l AD
palamuti	p AG ɐ BA l AD ɐ BA m AE ʊ BA t AI i AM ʔ AL
palaspas	p AG ɐ BA l AD ɐ BA s AH p AG a AM s AH
palayan	p AG ɐ BA l AD ɐ BA j AB a AM n AF
palayasin	p AG ɐ BA l AD ɐ BA j AB a AM s AH ɪ AM n AF
palima	p AG ɐ BA l AD ɪ AM m AE ɐ BA
palisoc	p AG ɐ BA l AD ɪ AM s AH o BA k AC
palit	p AG ɐ BA l AD i AM t AI
palitada	p AG ɐ BA l AD ɪ AM t AI ɐ BA d AI ɐ BA
palitadahan	p AG ɐ BA l AD ɪ AM t AI ɐ BA d AI ɐ BA h AA ɐ BA n AF
palitan	p AG ɐ BA l AD ɪ AM t AI a AM n AF
palomares	p AG ɐ BA l AD o BA m AE ɐ BA ɾ BE ɛ AM s AH
pamalo	p AG ɐ BA m AE ɐ BA l AD o BA ʔ AL
pamamanhikan	p AG ɐ BA m AE ɐ BA m AE ɐ BA ŋ AK h AA ɪ AM x BC ɐ BA n AF
pamamaril	p AG ɐ BA m AE ɐ BA m AE ɐ BA ɾ BE i AM l AD
pamaypay	p AG ɐ BA m AE a AM ɪ̯ AB p AG a AM ɪ̯ AB
pamimilosopo	p AG ɐ BA m AE ɪ AM m AE ɪ AM l AD o BA s AH o BA p AG o BA
paminta	p AG ɐ BA m AE ɪ AM n AF t AI a AM
pamintuan	p AG ɐ BA m AE ɪ AM n AF t AI ʊ BA ɐ BA n AF
panalangin	p AG ɐ BA n AF ɐ BA l AD ɐ BA ŋ AK ɪ AM n AF
panalo	p AG ɐ BA n AF a AM l AD o BA
pananabotahe	p AG ɐ BA n AF ɐ BA n AF ɐ BA b AG o BA t AI ɐ BA h AA ɛ AM
pananagutan	p AG ɐ BA n AF ɐ BA n AF ɐ BA ɰ AB ʊ BA t AI ɐ BA n AF
pandemya	p AG ɐ BA n AF d AI ɛ AM m AE j AB ɐ BA
panelo	p AG ɐ BA n AF ɛ AM l AD o BA
pangalan	p AG ɐ BA ŋ AK a AM l AD ɐ BA n AF
panghimasukan	p AG ɐ BA ŋ AK h AA ɪ AM m AE ɐ BA s AH ʊ BA x BC ɐ BA n AF
pangngalan	p AG ɐ BA ŋ AK ŋ AK a AM l AD ɐ BA n AF
panibughuin	p AG ɐ BA n AF ɪ AM b AG ʊ BA ɡ AC h AA u BA ʔ AL ɪ AM n AF
paninigarilyo	p AG ɐ BA n AF ɪ AM n AF ɪ AM ɰ AB ɐ BA ɾ BE ɪ AM l AD j AB o BA
panlaqui	p AG ɐ BA n AF l AD ɐ BA x BC ɪ AM
pansamantala	p AG ɐ BA n AF s AH ɐ BA m AE ɐ BA n AF t AI ɐ BA l AD a AM
pantig	p AG ɐ BA n AF t AI ɪ AM ɡ AC
panukala	p AG ɐ BA n AF ʊ BA x BC ɐ BA l AD ɐ BA ʔ AL
paraan	p AG ɐ BA ɾ BE ɐ BA ʔ AL a AM n AF
parada	p AG ɐ BA ɾ BE a AM d AI ɐ BA
paragas	p AG ɐ BA ɾ BE ɐ BA ɰ AB ɐ BA s AH
parayno	p AG ɐ BA ɾ BE a AM ɪ̯ AB n AF o BA
pareño	p AG ɐ BA ɾ BE ɛ AM ɲ AK o BA
pari	p AG a AM ɾ BE ɪ AM ʔ AL
parilla	p AG ɐ BA ɾ BE ɪ AM l AD l AD ɐ BA
parreño	p AG ɐ BA ɾ BE ɛ AM ɲ AK o BA
parusa	p AG ɐ BA ɾ BE u BA s AH ɐ BA
pasaway	p AG ɐ BA s AH ɐ BA w AJ a AM ɪ̯ AB
pasiya	p AG ɐ BA ʃ AH a AM
pasko	p AG ɐ BA s AH k AC o BA
paskuwa	p AG ɐ BA s AH k AC ʊ BA ɐ BA
pasugalan	p AG a AM s AH ʊ BA ɰ AB a AM l AD ɐ BA n AF
pasukan	p AG ɐ BA s AH ʊ BA x BC ɐ BA n AF
pasulo	p AG ɐ BA s AH ʊ BA l AD o BA
patahian	p AG ɐ BA t AI ɐ BA h AA i AM ʔ AL ɐ BA n AF
patiag	p AG ɐ BA t AI ʃ AH ɐ BA ɡ AC
patiño	p AG ɐ BA t AI ɪ AM ɲ AK o BA
patnubay	p AG ɐ BA t AI n AF ʊ BA b AG a AM ɪ̯ AB
patron	p AG ɐ BA t AI ɾ BE o BA n AF
paupahan	p AG a AM ʊ̯ AJ p AG ɐ BA h AA ɐ BA n AF
pawis	p AG ɐ BA w AJ i AM s AH
payumo	p AG ɐ BA j AB ʊ BA m AE o BA
paz	p AG ɐ BA s AH
peke	p AG ɛ AM x BC ɛ AM ʔ AL
peklat	p AG ɛ AM k AC l AD ɐ BA t AI
pestisidyo	p AG ɛ AM s AH t AI ɪ AM s AH ɪ AM d AI ʒ AH o BA
peñaflor	p AG ɛ AM ɲ AK ɐ BA p AG l AD o BA ɾ BE
peñaflorida	p AG ɛ AM ɲ AK ɐ BA p AG l AD o BA ɾ BE ɪ AM d AI ɐ BA
peñaranda	p AG ɛ AM ɲ AK ɐ BA ɾ BE ɐ BA n AF d AI ɐ BA
piga	p AG ɪ AM ɰ AB a AM ʔ AL
pigain	p AG ɪ AM ɰ AB ɐ BA ʔ AL i AM n AF
pigsa	p AG ɪ AM ɡ AC s AH a AM ʔ AL
pihikan	p AG ɪ AM h AA i AM x BC ɐ BA n AF
pilantik	p AG ɪ AM l AD ɐ BA n AF t AI i AM k AC
pilantropo	p AG ɪ AM l AD a AM n AF t AI ɾ BE o BA p AG o BA
pilapil	p AG ɪ AM l AD a AM p AG ɪ AM l AD
pilat	p AG i AM l AD ɐ BA t AI
pilipinas	p AG ɪ AM l AD ɪ AM p AG ɪ AM n AF ɐ BA s AH
pilosopiya	p AG ɪ AM l AD o BA s AH o BA p AG i AM ɐ BA
pilosopo	p AG ɪ AM l AD o BA s AH o BA p AG o BA
pilyo	p AG ɪ AM l AD j AB o BA
pinaghihinalaan	p AG ɪ AM n AF ɐ BA ɡ AC h AA ɪ AM h AA ɪ AM n AF ɐ BA l AD a AM ɐ BA n AF
pinagsamantalahan	p AG ɪ AM n AF ɐ BA ɡ AC s AH ɐ BA m AE ɐ BA n AF t AI ɐ BA l AD ɐ BA h AA a AM n AF
pindot	p AG ɪ AM n AF d AI o BA t AI
pinggan	p AG ɪ AM ŋ AK ɡ AC a AM n AF
pinlac	p AG ɪ AM n AF l AD ɐ BA k AC
pintakasi	p AG ɪ AM n AF t AI ɐ BA x BC a AM s AH ɪ AM
piraso	p AG ɪ AM ɾ BE a AM s AH o BA
pirmahan	p AG ɪ AM ɾ BE m AE ɐ BA h AA a AM n AF
piskal	p AG ɪ AM s AH k AC a AM l AD
piskalya	p AG ɪ AM s AH k AC ɐ BA l AD j AB a AM
pista	p AG ɪ AM s AH t AI a AM
piyo	p AG j AB o BA ʔ AL
pizarro	p AG ɪ AM s AH ɐ BA ɾ BE ɾ BE o BA
piñon	p AG ɪ AM ɲ AK o BA n AF
planas	p AG l AD ɐ BA n AF ɐ BA s AH
plastik	p AG l AD ɐ BA s AH t AI ɪ AM k AC
policarpio	p AG o BA l AD ɪ AM x BC ɐ BA ɾ BE p AG j AB o BA
polintan	p AG o BA l AD ɪ AM n AF t AI ɐ BA n AF
portuges	p AG o BA ɾ BE t AI ʊ BA ɰ AB ɛ AM s AH
posas	p AG o BA s AH ɐ BA s AH
post	p AG o BA ʊ BA s AH t AI
prado	p AG ɾ BE ɐ BA d AI o BA
praning	p AG ɾ BE ɐ BA n AF ɪ AM ŋ AK
prayoridad	p AG ɾ BE ɐ BA j AB o BA ɾ BE ɪ AM d AI ɐ BA d AI
proklamasyon	p AG ɾ BE o BA k AC l AD ɐ BA m AE ɐ BA ʃ AH o BA n AF
prudente	p AG ɾ BE ʊ BA d AI ɛ AM n AF t AI ɛ AM
pudpod	p AG ʊ BA d AI p AG o BA d AI
pugad	p AG u BA ɰ AB ɐ BA d AI
pugo	p AG ʊ BA ɰ AB o BA ʔ AL
pugot	p AG ʊ BA ɰ AB o BA t AI
pugutan	p AG ʊ BA ɰ AB ʊ BA t AI ɐ BA n AF
puhunan	p AG ʊ BA h AA ʊ BA n AF ɐ BA n AF
pukyutan	p AG ʊ BA k AC j AB ʊ BA t AI ɐ BA n AF
pulahan	p AG ʊ BA l AD ɐ BA h AA a AM n AF
pulgada	p AG ʊ BA l AD ɡ AC ɐ BA d AI ɐ BA
pulgas	p AG ʊ BA l AD ɡ AC a AM s AH
pulikat	p AG ʊ BA l AD i AM x BC ɐ BA t AI
pulmonya	p AG ʊ BA l AD m AE o BA ɲ AK a AM
pulo	p AG ʊ BA l AD o BA ʔ AL
pulot	p AG ʊ BA l AD o BA t AI
pulubi	p AG ʊ BA l AD ʊ BA b AG ɪ AM
pulutan	p AG ʊ BA l AD ʊ BA t AI ɐ BA n AF
pumula	p AG ʊ BA m AE ʊ BA l AD a AM
pumutok	p AG ʊ BA m AE ʊ BA t AI o BA k AC
pundido	p AG ʊ BA n AF d AI i AM d AI o BA
punongbayan	p AG ʊ BA n AF o BA ŋ AK b AG ɐ BA j AB ɐ BA n AF
punsalang	p AG ʊ BA n AF s AH ɐ BA l AD ɐ BA ŋ AK
puntahan	p AG ʊ BA n AF t AI ɐ BA h AA a AM n AF
puntirya	p AG ʊ BA n AF t AI ɪ AM ɾ BE j AB a AM
punzalan	p AG ʊ BA n AF s AH ɐ BA l AD ɐ BA n AF
puson	p AG ʊ BA s AH o BA n AF
pusta	p AG ʊ BA s AH t AI a AM
pustiso	p AG ʊ BA s AH t AI i AM s AH o BA
pusyaw	p AG ʊ BA ʃ AH a AM u BA
putakti	p AG ʊ BA t AI ɐ BA k AC t AI i AM
puyod	p AG ʊ BA j AB o BA d AI
quezon	k AC x BC ɛ AM s AH o BA n AF
quiambao	k AC j AB ɐ BA m AE b AG a AM ʊ̯ AJ
quimpo	k AC x BC ɪ AM m AE p AG o BA
quintos	k AC x BC ɪ AM n AF t AI o BA s AH
quirante	k AC x BC ɪ AM ɾ BE ɐ BA n AF t AI ɛ AM
quisumbing	k AC x BC ɪ AM s AH u BA m AE b AG ɪ AM ŋ AK
quitain	k AC x BC ɪ AM t AI a AM ɪ̯ AB n AF
quiñones	k AC x BC ɪ AM ɲ AK o BA n AF ɛ AM s AH
racelis	ɾ BE ɐ BA s AH ɛ AM l AD ɪ AM s AH
ragas	ɾ BE ɐ BA ɰ AB ɐ BA s AH
ragudo	ɾ BE ɐ BA ɰ AB ʊ BA d AI o BA
rali	ɾ BE a AM l AD ɪ AM
raliyista	ɾ BE ɐ BA l AD ɪ AM j AB i AM s AH t AI ɐ BA
rambol	ɾ BE ɐ BA m AE b AG o BA l AD
rambulan	ɾ BE ɐ BA m AE b AG ʊ BA l AD ɐ BA n AF
rantso	ɾ BE ɐ BA n AF t AI ʃ AH o BA
rason	ɾ BE ɐ BA s AH o BA n AF
rayos	ɾ BE ɐ BA j AB o BA s AH
razon	ɾ BE ɐ BA s AH o BA n AF
reaño	ɾ BE ɛ AM ɐ BA ɲ AK o BA
regala	ɾ BE ɛ AM ɰ AB ɐ BA l AD ɐ BA
regidor	ɾ BE ɛ AM h AA ɪ AM d AI o BA ɾ BE
rehas	ɾ BE ɛ AM h AA ɐ BA s AH
rekisito	ɾ BE ɛ AM x BC ɪ AM s AH ɪ AM t AI o BA
rekisitos	ɾ BE ɛ AM x BC ɪ AM s AH ɪ AM t AI o BA s AH
remigio	ɾ BE ɛ AM m AE ɪ AM h AA j AB o BA
remulla	ɾ BE ɛ AM m AE ʊ BA l AD l AD ɐ BA
reodica	ɾ BE ɛ AM o BA d AI ɪ AM x BC ɐ BA
resistensya	ɾ BE ɛ AM s AH ɪ AM s AH t AI ɛ AM n AF ʃ AH ɐ BA
resurreccion	ɾ BE ɛ AM s AH ʊ BA ɾ BE ɛ AM k AC ʃ AH o BA n AF
ricafort	ɾ BE ɪ AM x BC ɐ BA p AG o BA ɾ BE t AI
ricarte	ɾ BE ɪ AM x BC ɐ BA ɾ BE t AI ɛ AM
riles	ɾ BE ɪ AM l AD ɛ AM s AH
rivero	ɾ BE ɪ AM b AG ɛ AM ɾ BE o BA
riñon	ɾ BE ɪ AM ɲ AK o BA n AF
rombaoa	ɾ BE u BA m AE b AG ɐ BA w AJ ɐ BA
romualdez	ɾ BE o BA m AE w AJ ɐ BA l AD d AI ɛ AM s AH
romualdo	ɾ BE o BA m AE w AJ ɐ BA l AD d AI o BA
roxas	ɾ BE o BA d AI ʒ AH ɐ BA s AH
rulloda	ɾ BE ʊ BA l AD l AD o BA d AI ɐ BA
rumupok	ɾ BE ʊ BA m AE ʊ BA p AG o BA k AC
sabana	s AH ɐ BA b AG ɐ BA n AF ɐ BA
sabangan	s AH ɐ BA b AG ɐ BA ŋ AK ɐ BA n AF
sabon	s AH ɐ BA b AG o BA n AF
saboy	s AH a AM b AG o BA ɪ̯ AB
sabunin	s AH ɐ BA b AG ʊ BA n AF i AM n AF
sabunot	s AH ɐ BA b AG u BA n AF o BA t AI
sabunutan	s AH ɐ BA b AG ʊ BA n AF ʊ BA t AI ɐ BA n AF
sacdalan	s AH ɐ BA k AC d AI ɐ BA l AD ɐ BA n AF
sadya	s AH ɐ BA d AI ʒ AH a AM ʔ AL
sagimuymoy	s AH a AM ɰ AB i AM m AE u BA j AB m AE o BA j AB
saguinsin	s AH ɐ BA ɰ AB ɪ AM n AF s AH ɪ AM n AF
sagun	s AH ɐ BA ɰ AB ʊ BA n AF
saha	s AH ɐ BA h AA ɐ BA ʔ AL
sahagun	s AH ɐ BA h AA ɐ BA ɰ AB ʊ BA n AF
sahog	s AH ɐ BA h AA o BA ɡ AC
sais	s AH ɐ BA ʔ AL i AM s AH
sakal	s AH ɐ BA x BC a AM l AD
sakit	s AH ɐ BA x BC i AM t AI
sakitin	s AH ɐ BA x BC ɪ AM t AI ɪ AM n AF
saksi	s AH ɐ BA k AC s AH i AM
saksihan	s AH ɐ BA k AC s AH ɪ AM h AA a AM n AF
sakuna	s AH ɐ BA x BC ʊ BA n AF a AM
sala	s AH a AM l AD ɐ BA
salagubang	s AH ɐ BA l AD ɐ BA ɰ AB ʊ BA b AG ɐ BA ŋ AK
salarin	s AH ɐ BA l AD ɐ BA ɾ BE i AM n AF
salaula	s AH ɐ BA l AD ɐ BA ʔ AL ʊ BA l AD ɐ BA ʔ AL
salawal	s AH ɐ BA l AD ɐ BA w AJ a AM l AD
saldaña	s AH ɐ BA l AD d AI ɐ BA ɲ AK ɐ BA
sales	s AH ɐ BA l AD ɛ AM s AH
salitre	s AH ɐ BA l AD i AM t AI ɾ BE ɛ AM
salonga	s AH ɐ BA l AD o BA ŋ AK ɡ AC ɐ BA
salud	s AH ɐ BA l AD ʊ BA d AI
salumbides	s AH ɐ BA l AD u BA m AE b AG ɪ AM d AI ɛ AM s AH
salvacion	s AH ɐ BA l AD b AG ɐ BA s AH ɪ AM o BA n AF
salvatierra	s AH ɐ BA l AD b AG ɐ BA t AI ɪ AM ɛ AM ɾ BE ɾ BE ɐ BA
samaniego	s AH ɐ BA m AE ɐ BA ɲ AK ɛ AM ɰ AB o BA
samantala	s AH ɐ BA m AE ɐ BA n AF t AI a AM l AD ɐ BA ʔ AL
samid	s AH ɐ BA m AE i AM d AI
samonte	s AH ɐ BA m AE o BA n AF t AI ɛ AM
sampaloc	s AH ɐ BA m AE p AG ɐ BA l AD o BA k AC
sampalok	s AH ɐ BA m AE p AG a AM l AD o BA k AC
sangalang	s AH ɐ BA ŋ AK ɡ AC ɐ BA l AD ɐ BA ŋ AK
sangco	s AH ɐ BA ŋ AK k AC o BA
sanggol	s AH ɐ BA ŋ AK ɡ AC o BA l AD
sangkot	s AH ɐ BA ŋ AK k AC o BA t AI
sapa	s AH ɐ BA p AG ɐ BA ʔ AL
sapak	s AH ɐ BA p AG a AM k AC
sapok	s AH ɐ BA p AG o BA k AC
sapot	s AH ɐ BA p AG o BA t AI
saquing	s AH ɐ BA x BC ɪ AM ŋ AK
sawa	s AH ɐ BA w AJ a AM ʔ AL
saway	s AH ɐ BA w AJ a AM ɪ̯ AB
sawayin	s AH ɐ BA w AJ ɐ BA j AB i AM n AF
sayson	s AH a AM ɪ̯ AB s AH o BA n AF
segismundo	s AH ɛ AM ɰ AB ɪ AM s AH m AE ʊ BA n AF d AI o BA
segui	s AH ɛ AM ɰ AB ɪ AM
semantika	s AH ɛ AM m AE a AM n AF t AI ɪ AM x BC ɐ BA
semaña	s AH ɛ AM m AE ɐ BA ɲ AK ɐ BA
sentenaryo	s AH ɛ AM n AF t AI ɛ AM n AF ɐ BA ɾ BE j AB o BA
sentensiya	s AH ɛ AM n AF t AI ɛ AM n AF ʃ AH ɐ BA
sentensiyahan	s AH ɛ AM n AF t AI ɛ AM n AF ʃ AH ɐ BA h AA a AM n AF
sentido	s AH ɛ AM n AF t AI ɪ AM d AI o BA
seremonya	s AH ɛ AM ɾ BE ɛ AM m AE o BA ɲ AK ɐ BA
serna	s AH ɛ AM ɾ BE n AF ɐ BA
shabu	ʃ AH ɐ BA b AG u BA
siason	ʃ AH ɐ BA s AH o BA n AF
sibayan	s AH ɪ AM b AG ɐ BA j AB ɐ BA n AF
sibug	s AH ɪ AM b AG ʊ BA ɡ AC
sibuyas	s AH ɪ AM b AG ʊ BA j AB ɐ BA s AH
siga	s AH ɪ AM ɰ AB a AM ʔ AL
sigarilyas	s AH ɪ AM ɰ AB ɐ BA ɾ BE ɪ AM l AD j AB ɐ BA s AH
sige	s AH ɪ AM ɰ AB ɛ AM
siguraduhin	s AH ɪ AM ɰ AB ʊ BA ɾ BE ɐ BA d AI ʊ BA h AA ɪ AM n AF
siko	s AH i AM x BC o BA
silayan	s AH ɪ AM l AD ɐ BA j AB ɐ BA n AF
silindro	s AH ɪ AM l AD ɪ AM n AF d AI ɾ BE o BA
simbulan	s AH ɪ AM m AE b AG ʊ BA l AD ɐ BA n AF
sinapupunan	s AH ɪ AM n AF ɐ BA p AG ʊ BA p AG ʊ BA n AF ɐ BA n AF
sinat	s AH i AM n AF ɐ BA t AI
sinauna	s AH ɪ AM n AF a AM ʊ̯ AJ n AF ɐ BA
sinco	s AH ɪ AM ŋ AK k AC o BA
singil	s AH ɪ AM ŋ AK i AM l AD
sioson	ʃ AH o BA s AH o BA n AF
siping	s AH i AM p AG ɪ AM ŋ AK
sipon	s AH ɪ AM p AG ʔ AL o BA n AF
sipsip	s AH ɪ AM p AG s AH ɪ AM p AG
sira	s AH ɪ AM ɾ BE a AM ʔ AL
sirain	s AH ɪ AM ɾ BE a AM ʔ AL ɪ AM n AF
sisi	s AH i AM s AH ɪ AM
sisid	s AH i AM s AH ɪ AM d AI
sisihan	s AH ɪ AM s AH ɪ AM h AA a AM n AF
sitwasyon	s AH ɪ AM t AI w AJ ɐ BA ʃ AH o BA n AF
siya	ʃ AH a AM
sobrepeña	s AH o BA b AG ɾ BE ɛ AM p AG ɛ AM ɲ AK ɐ BA
soledad	s AH o BA l AD ɛ AM d AI ɐ BA d AI
solis	s AH o BA l AD ɪ AM s AH
sosa	s AH o BA s AH ɐ BA
suazo	s AH w AJ ɐ BA s AH o BA
sucgang	s AH ʊ BA k AC ɡ AC ɐ BA ŋ AK
sugal	s AH ʊ BA ɰ AB a AM l AD
suico	s AH ʊ BA ɪ AM x BC o BA
suka	s AH u BA x BC ɐ BA ʔ AL
sukal	s AH u BA x BC ɐ BA l AD
sulsol	s AH ʊ BA l AD s AH o BA l AD
sumadsad	s AH ʊ BA m AE ɐ BA d AI s AH ɐ BA d AI
sumemplang	s AH ʊ BA m AE ɛ AM m AE p AG l AD ɐ BA ŋ AK
suntok	s AH ʊ BA n AF t AI o BA k AC
suntukan	s AH ʊ BA n AF t AI ʊ BA x BC ɐ BA n AF
suntukin	s AH ʊ BA n AF t AI ʊ BA x BC i AM n AF
supling	s AH ʊ BA p AG l AD i AM ŋ AK
surot	s AH ʊ BA ɾ BE o BA t AI
sustento	s AH ʊ BA s AH t AI ɛ AM n AF t AI o BA
taduran	t AI ɐ BA d AI ʊ BA ɾ BE ɐ BA n AF
tagapagmana	t AI ɐ BA ɰ AB ɐ BA p AG ɐ BA ɡ AC m AE ɐ BA n AF ɐ BA
tagas	t AI ɐ BA ɰ AB ɐ BA s AH
tagiktik	t AI ɐ BA ɰ AB ɪ AM k AC t AI i AM k AC
tagtuyot	t AI ɐ BA ɡ AC t AI ʊ BA j AB o BA t AI
taguba	t AI ɐ BA ɰ AB ʊ BA b AG ɐ BA
tagubilin	t AI ɐ BA ɰ AB ʊ BA b AG ɪ AM l AD ɪ AM n AF
taguinod	t AI ɐ BA ɰ AB ɪ AM n AF o BA d AI
tagupa	t AI ɐ BA ɰ AB ʊ BA p AG ɐ BA
takahashi	t AI ɐ BA x BC ɐ BA h AA ɐ BA ʃ AH ɪ AM
talag	t AI ɐ BA l AD ɐ BA ɡ AC
talampas	t AI ɐ BA l AD ɐ BA m AE p AG ɐ BA s AH
talavera	t AI ɐ BA l AD ɐ BA b AG ɛ AM ɾ BE ɐ BA
talento	t AI ɐ BA l AD ɛ AM n AF t AI o BA
talo	t AI ɐ BA l AD o BA
talong	t AI ɐ BA l AD o BA ŋ AK
talukbong	t AI ɐ BA l AD ʊ BA k AC b AG o BA ŋ AK
talunan	t AI ɐ BA l AD ʊ BA n AF a AM n AF
tamban	t AI ɐ BA m AE b AG a AM n AF
tamis	t AI ɐ BA m AE i AM s AH
tampal	t AI ɐ BA m AE p AG a AM l AD
tanauan	t AI ɐ BA n AF ʔ AL ɐ BA w AJ ɐ BA n AF
tancinco	t AI ɐ BA n AF s AH ɪ AM ŋ AK k AC o BA
tangco	t AI ɐ BA ŋ AK k AC o BA
tanghalian	t AI ɐ BA ŋ AK h AA ɐ BA l AD ɪ AM ʔ AL ɐ BA n AF
tanikala	t AI ɐ BA n AF ɪ AM x BC ɐ BA l AD a AM ʔ AL
tanso	t AI ɐ BA n AF s AH o BA ʔ AL
tantiya	t AI ɐ BA n AF t AI ʃ AH ɐ BA
taon	t AI ɐ BA ʔ AL o BA n AF
tapales	t AI ɐ BA p AG ɐ BA l AD ɛ AM s AH
tapilok	t AI ɐ BA p AG ɪ AM l AD o BA k AC
tarik	t AI ɐ BA ɾ BE i AM k AC
taruc	t AI ɐ BA ɾ BE ʊ BA k AC
tasa	t AI ɐ BA s AH a AM
tatlonghari	t AI ɐ BA t AI l AD o BA ŋ AK h AA ɐ BA ɾ BE ɪ AM
tato	t AI ɐ BA t AI o BA ʔ AL
tañada	t AI ɐ BA ɲ AK ɐ BA d AI ɐ BA
tenyente	t AI ɛ AM ɲ AK ɛ AM n AF t AI ɛ AM
teoriya	t AI ɛ AM o BA ɾ BE i AM ɐ BA
teritoryo	t AI ɛ AM ɾ BE ɪ AM t AI o BA ɾ BE j AB o BA
tiamson	t AI ʃ AH ɐ BA m AE s AH o BA n AF
tiangco	t AI ʃ AH ɐ BA ŋ AK k AC o BA
tibay	t AI i AM b AG a AM ɪ̯ AB
tiburcio	t AI ɪ AM b AG ʊ BA ɾ BE ʃ AH o BA
ticzon	t AI ɪ AM k AC s AH o BA n AF
tigang	t AI ɪ AM ɰ AB a AM ŋ AK
tigas	t AI ɪ AM ɰ AB a AM s AH
tiis	t AI ɪ AM ʔ AL i AM s AH
tikbalang	t AI ɪ AM k AC b AG a AM l AD ɐ BA ŋ AK
tiklop	t AI ɪ AM k AC l AD o BA p AG
tiktik	t AI ɪ AM k AC t AI i AM k AC
timbang	t AI ɪ AM m AE b AG a AM ŋ AK
tindero	t AI ɪ AM n AF d AI ɛ AM ɾ BE o BA
tindig	t AI ɪ AM n AF d AI i AM ɡ AC
tinga	t AI ɪ AM ŋ AK a AM
tingala	t AI ɪ AM ŋ AK ɐ BA l AD a AM ʔ AL
tingalaan	t AI ɪ AM ŋ AK ɐ BA l AD ɐ BA a AM n AF
tingin	t AI ɪ AM ŋ AK i AM n AF
tinidor	t AI ɪ AM n AF ɪ AM d AI o BA ɾ BE
tinik	t AI ɪ AM n AF i AM k AC
tinta	t AI ɪ AM n AF t AI a AM
tio	t AI ʃ AH o BA
tiongco	t AI ɪ AM o BA ŋ AK k AC o BA
tiozon	t AI ʃ AH o BA s AH o BA n AF
tipaklong	t AI ɪ AM p AG a AM k AC l AD o BA ŋ AK
tira	t AI ɪ AM ɾ BE a AM
tiraniya	t AI ɪ AM ɾ BE ɐ BA n AF i AM ɐ BA
tirik	t AI ɪ AM ɾ BE i AM k AC
tiris	t AI ɪ AM ɾ BE i AM s AH
tirona	t AI ɪ AM ɾ BE o BA n AF ɐ BA
tiwali	t AI ɪ AM w AJ ɐ BA l AD i AM ʔ AL
tiya	t AI ɪ AM ɐ BA
tiyaga	t AI ɪ AM ɐ BA ɰ AB a AM ʔ AL
tiyahin	t AI ʃ AH ɐ BA h AA ɪ AM n AF
tiyan	t AI ʃ AH a AM n AF
tiyanak	t AI ʃ AH a AM n AF ɐ BA k AC
tiyangge	t AI ʃ AH a AM ŋ AK ɡ AC ɛ AM ʔ AL
tiyo	t AI ɪ AM o BA
tiyuhin	t AI ʃ AH ʊ BA h AA ɪ AM n AF
tonelada	t AI o BA n AF ɛ AM l AD ɐ BA d AI ɐ BA
topacio	t AI o BA p AG ɐ BA ʃ AH o BA
torrecampo	t AI o BA ɾ BE ɾ BE ɛ AM x BC ɐ BA m AE p AG o BA
totanes	t AI o BA t AI ɐ BA n AF ɛ AM s AH
trangkaso	t AI ɾ BE ɐ BA ŋ AK k AC a AM s AH o BA
trapik	t AI ɾ BE a AM p AG ɪ AM k AC
traqueña	t AI ɾ BE ɐ BA x BC ɛ AM ɲ AK ɐ BA
tratado	t AI ɾ BE ɐ BA t AI a AM d AI o BA
traydor	t AI ɾ BE a AM ɪ̯ AB d AI o BA ɾ BE
tren	t AI ɾ BE ɛ AM n AF
tria	t AI ɾ BE ɪ AM ɐ BA
trillanes	t AI ɾ BE ɪ AM l AD l AD ɐ BA n AF ɛ AM s AH
trip	t AI ɾ BE ɪ AM p AG
tsikinini	t AI ʃ AH ɪ AM x BC ɪ AM n AF i AM n AF ɪ AM ʔ AL
tsikot	t AI ʃ AH ɪ AM x BC o BA t AI
tuason	t AI w AJ ɐ BA s AH o BA n AF
tuba	t AI ʊ BA b AG a AM
tubero	t AI ʊ BA b AG ɛ AM ɾ BE o BA
tubo	t AI ʊ BA b AG o BA
tubuhan	t AI ʊ BA b AG ʊ BA h AA a AM n AF
tugade	t AI ʊ BA ɰ AB ɐ BA d AI ɛ AM
tugtog	t AI ʊ BA ɡ AC t AI o BA ɡ AC
tukod	t AI u BA x BC o BA d AI
tukso	t AI ʊ BA k AC s AH o BA
tulad	t AI u BA l AD ɐ BA d AI
tulak	t AI u BA l AD ɐ BA k AC
tulay	t AI ʊ BA l AD a AM ɪ̯ AB
tulingan	t AI ʊ BA l AD ɪ AM ŋ AK ɐ BA n AF
tullao	t AI ʊ BA l AD j AB a AM ʊ̯ AJ
tuloy	t AI ʊ BA l AD o BA ɪ̯ AB
tumacder	t AI ʊ BA m AE ɐ BA k AC d AI ɛ AM ɾ BE
tumae	t AI ʊ BA m AE ɐ BA ʔ AL ɛ AM
tumbaga	t AI u BA m AE b AG ɐ BA ɰ AB ɐ BA
tumbalik	t AI u BA m AE b AG ɐ BA l AD ɪ AM k AC
tumingala	t AI ʊ BA m AE ɪ AM ŋ AK ɐ BA l AD a AM ʔ AL
tumira	t AI ʊ BA m AE ɪ AM ɾ BE ɐ BA
tumukso	t AI ʊ BA m AE ʊ BA k AC s AH o BA
tunay	t AI u BA n AF a AM ɪ̯ AB
tungaw	t AI ʊ BA ŋ AK a AM ʊ̯ AJ
tungkab	t AI ʊ BA ŋ AK k AC a AM b AG
tungkod	t AI ʊ BA ŋ AK k AC o BA d AI
tungkol	t AI ʊ BA ŋ AK k AC o BA l AD
tungkos	t AI ʊ BA ŋ AK k AC o BA s AH
tunton	t AI ʊ BA n AF t AI o BA n AF
tupad	t AI ʊ BA p AG a AM d AI
tupi	t AI ʊ BA p AG i AM ʔ AL
turnilyo	t AI ʊ BA ɾ BE n AF i AM l AD j AB o BA
turok	t AI ʊ BA ɾ BE o BA k AC
tutol	t AI ʊ BA t AI o BA l AD
tuwa	t AI w AJ a AM ʔ AL
tuwad	t AI w AJ a AM d AI
tuwalya	t AI w AJ ɐ BA l AD j AB ɐ BA
tuwang	t AI w AJ a AM ŋ AK
ubas	ʔ AL ʊ BA b AG ɐ BA s AH
ubasan	ʔ AL ʊ BA b AG ɐ BA s AH a AM n AF
udyukan	ʔ AL ʊ BA d AI ʒ AH ʊ BA x BC a AM n AF
ugat	ʔ AL ʊ BA ɰ AB a AM t AI
ulep	ʔ AL ʊ BA l AD ɛ AM p AG
ulila	ʔ AL ʊ BA l AD i AM l AD ɐ BA
uling	ʔ AL u BA l AD ɪ AM ŋ AK
umasinta	ʔ AL ʊ BA m AE ɐ BA s AH ɪ AM n AF t AI a AM
umawat	ʔ AL ʊ BA m AE a AM w AJ ɐ BA t AI
umpisa	ʔ AL u BA m AE p AG ɪ AM s AH a AM
umutot	ʔ AL ʊ BA m AE ʊ BA t AI o BA t AI
untalan	ʔ AL ʊ BA n AF t AI ɐ BA l AD ɐ BA n AF
upa	ʔ AL ʊ BA p AG ɐ BA
uriarte	ʔ AL ʊ BA ɾ BE j AB ɐ BA ɾ BE t AI ɛ AM
ursua	ʔ AL ʊ BA ɾ BE s AH ʊ BA ɐ BA
usap	ʔ AL u BA s AH ɐ BA p AG
usisero	ʔ AL ʊ BA s AH ɪ AM s AH ɛ AM ɾ BE o BA
utot	ʔ AL ʊ BA t AI o BA t AI
uwak	ʔ AL ʊ BA a AM k AC
uwi	ʔ AL ʊ BA i AM ʔ AL
valera	b AG ɐ BA l AD ɛ AM ɾ BE ɐ BA
valle	b AG ɐ BA l AD l AD ɛ AM
valmores	b AG ɐ BA l AD m AE o BA ɾ BE ɛ AM s AH
varias	b AG ɐ BA ɾ BE ɪ AM ɐ BA s AH
varona	b AG ɐ BA ɾ BE o BA n AF ɐ BA
vecino	b AG ɛ AM s AH ɪ AM n AF o BA
velarde	b AG ɛ AM l AD ɐ BA ɾ BE d AI ɛ AM
velasquez	b AG ɛ AM l AD ɐ BA s AH k AC ɛ AM s AH
veloria	b AG ɛ AM l AD o BA ɾ BE j AB ɐ BA
veneracion	b AG ɛ AM n AF ɛ AM ɾ BE ɐ BA ʃ AH o BA n AF
venturina	b AG ɛ AM n AF t AI ʊ BA ɾ BE ɪ AM n AF ɐ BA
versoza	b AG ɛ AM ɾ BE s AH o BA s AH ɐ BA
villablanca	b AG ɪ AM l AD l AD ɐ BA b AG l AD ɐ BA ŋ AK k AC ɐ BA
villacarlos	b AG ɪ AM l AD l AD ɐ BA x BC ɐ BA ɾ BE l AD o BA s AH
villafranca	b AG ɪ AM l AD l AD ɐ BA p AG ɾ BE ɐ BA ŋ AK k AC ɐ BA
villafuerte	b AG ɪ AM l AD l AD ɐ BA p AG w AJ ɛ AM ɾ BE t AI ɛ AM
villagracia	b AG ɪ AM l AD l AD ɐ BA ɡ AC ɾ BE ɐ BA ʃ AH ɐ BA
villamater	b AG ɪ AM l AD l AD ɐ BA m AE ɐ BA t AI ɛ AM ɾ BE
villamin	b AG ɪ AM l AD l AD ɐ BA m AE ɪ AM n AF
villamor	b AG ɪ AM l AD l AD ɐ BA m AE o BA ɾ BE
villapando	b AG ɪ AM l AD l AD ɐ BA p AG ɐ BA n AF d AI o BA
villareal	b AG ɪ AM l AD l AD ɐ BA ɾ BE ɛ AM ɐ BA l AD
villarino	b AG ɪ AM l AD l AD ɐ BA ɾ BE ɪ AM n AF o BA
villaruz	b AG ɪ AM l AD l AD ɐ BA ɾ BE ʊ BA s AH
villaseñor	b AG ɪ AM l AD l AD ɐ BA s AH ɛ AM ɲ AK o BA ɾ BE
villasis	b AG ɪ AM l AD l AD ɐ BA s AH ɪ AM s AH
villaverde	b AG ɪ AM l AD l AD ɐ BA b AG ɛ AM ɾ BE d AI ɛ AM
villavicencio	b AG ɪ AM l AD l AD ɐ BA b AG ɪ AM s AH ɛ AM n AF ʃ AH o BA
villegas	b AG ɪ AM l AD l AD ɛ AM ɰ AB ɐ BA s AH
vinoya	b AG ɪ AM n AF o BA j AB ɐ BA
virata	b AG ɪ AM ɾ BE ɐ BA t AI ɐ BA
virrey	b AG ɪ AM ɾ BE ɾ BE ɛ AM ɪ̯ AB
visaya	b AG ɪ AM s AH ɐ BA j AB ɐ BA ʔ AL
volante	b AG o BA l AD ɐ BA n AF t AI ɛ AM
wang	w AJ ɐ BA ŋ AK
wangis	w AJ a AM ŋ AK ɪ AM s AH
yalung	j AB ɐ BA l AD ʊ BA ŋ AK
yarda	j AB ɐ BA ɾ BE d AI ɐ BA
yasay	j AB ɐ BA s AH a AM ɪ̯ AB
yatco	j AB ɐ BA t AI k AC o BA
ybañez	ʔ AL ɪ AM b AG ɐ BA ɲ AK ɛ AM s AH
yuvienco	j AB ʊ BA b AG ɪ AM ɛ AM ŋ AK k AC o BA
yñiguez	j AB ɲ AK ɪ AM ɰ AB ɛ AM s AH
zafra	s AH ɐ BA p AG ɾ BE ɐ BA
zaide	s AH a AM ɪ̯ AB d AI ɛ AM
zapanta	s AH ɐ BA p AG ɐ BA n AF t AI ɐ BA
zavalla	s AH ɐ BA b AG ɐ BA l AD l AD ɐ BA
zoleta	s AH o BA l AD ɛ AM t AI ɐ BA
zuñiga	s AH ʊ BA ɲ AK ɪ AM ɰ AB ɐ BA
