abiye	a AH b AG i AH j AB e AH
abla	a AH b AG ɫ AD a AH
acaba	ɑ AH d AC ʒ AC ɑ AH b AG ɑː AI
acemi	a AH d AC ʒ AC e AH m AE iː AI
acı	ɑ AH d AC ʒ AC ɯ AH
acıkmak	ɑ AH d AC ʒ AC ɯ AH k AC m AE ɑ AH k AC
ada	a AH d AC a AH
adenozin	a AH d AC e AH n AF o AJ z AC i AH n AF
afiyet	aː AI f AG i AH j AB e AH t AC
afyonkarahisar	ɑ AH f AG j AB o AJ n AF k AC ɑ AH r AL ɑ AH h AA ɪ AH s AC ɑ AH r AL
ahize	aː AI h AA i AH z AC e AH
ahizeler	aː AI h AA i AH z AC e AH ɫ AD e AH ɾ AM
ahizem	aː AI h AA i AH z AC e AH m AE
ahizen	aː AI h AA i AH z AC e AH n AF
ahizenin	aː AI h AA i AH z AC e AH n AF i AH n AF
ahizesi	aː AI h AA i AH z AC e AH s AC i AH
ahizeyi	aː AI h AA i AH z AC e AH j AB i AH
ahmak	ɑ AH h AA m AE ɑ AH k AC
akbaba	ɑ AH k AC b AG ɑ AH b AG ɑ AH
akbil	ɑ AH k AC b AG i AH l AD
akrep	ɑ AH k AC ɾ AM ɛ AH p AG
akrobat	ɑ AH k AC ɾ AM o AJ b AG ɑ AH t AC
akşam	ɑ AH k AC ʃ AC ɑ AH m AE
alamet	ɑ AH l AD aː AI m AE ɛ AH t AC
alem	a AH l AD ɛ AH m AE
alemi	a AH l AD ɛ AH m AE i AH
alemler	a AH l AD ɛ AH m AE l AD ɛ AH ɾ AM
algoloji	a AH l AD ɡ AC ɔ AJ l AD ɔ AJ ʒ AC i AH
allık	ɑ AH ɫ AD ɫ AD ɯ AH k AC
alman	ɑ AH ɫ AD m AE ɑ AH n AF
almanca	ɑ AH ɫ AD m AE ɑ AH n AF d AC ʒ AC ɑ AH
almancı	ɑ AH ɫ AD m AE ɑ AH n AF d AC ʒ AC ɯ AH
almanya	ɑ AH ɫ AD m AE ɑ AH n AF j AB ɑ AH
alt	a AH ɫ AD t AC
altmış	ɑ AH ɫ AD t AC m AE ɯ AH ʃ AC
altıgen	a AH l AD t AC ɯ AH ɟ AC e AH n AF
alıç	ɑ AH ɫ AD ɯ AH t AC ʃ AC
amaç	ɑ AH m AE ɑ AH t AC ʃ AC
ambulans	ɑ AH m AE b AG u AJ l AD a AH n AF s AC
anahtarlık	a AH n AF a AH h AA t AC a AH ɾ AM ɫ AD ɯ AH k AC
anarat	ɑ AH n AF ɑ AH ɾ AM ɑ AH t AC
anarşi	a AH n AF a AH ɾ AM ʃ AC i AH
ancak	ɑ AH n AF d AC ʒ AC ɑ AH k AC
andaval	ɑ AH n AF d AC ɑ AH β AG ɑ AH ɫ AD
andavallı	ɑ AH n AF d AC ɑ AH β AG ɑ AH ɫ AD ɫ AD ɯ AH
animasyon	a AH n AF i AH m AE a AH s AC j AB o AJ n AF
anjiyografi	a AH n AF ʒ AC i AH j AB o AJ ɟ AC ɾ AM a AH f AG i AH
ankara	ɑ AH n AF k AC ɑ AH ɾ AM ɑ AH
ankaralı	ɑ AH n AF k AC ɑ AH ɾ AM ɑ AH ɫ AD ɯ AH
anlamak	a AH n AF ɫ AD a AH m AE a AH k AC
anlatmak	ɑ AH n AF ɫ AD ɑ AH t AC m AE ɑ AH k AC
anne	ɑ AH n AF n AF e AH
annelik	ɑ AH n AF n AF ɛ AH l AD i AH c AC
antakya	ɑ AH n AF t AC ɑ AH k AC j AB ɑ AH
antibiyotik	ɑ AH n AF t AC i AH b AG i AH j AB ɔ AJ t AC i AH c AC
apeninler	a AH p AG e AH n AF i AH n AF ɫ AD e AH ɾ AM
argo	a AH ɾ AM ɟ AC o AJ
arjantinli	ɑ AH ɾ AM ʒ AC ɑ AH n AF t AC i AH n AF l AD i AH
arkadaşa	a AH ɾ AM k AC a AH d AC a AH ʃ AC a AH
arkadaşlar	a AH ɾ AM k AC a AH d AC a AH ʃ AC l AD a AH ɾ AM
arkadaşlara	a AH ɾ AM k AC a AH d AC a AH ʃ AC l AD a AH ɾ AM a AH
arkadaşlarda	a AH ɾ AM k AC a AH d AC a AH ʃ AC l AD a AH ɾ AM d AC a AH
arkadaşlardan	a AH ɾ AM k AC a AH d AC a AH ʃ AC l AD a AH ɾ AM d AC a AH n AF
arkadaşların	a AH ɾ AM k AC a AH d AC a AH ʃ AC l AD a AH ɾ AM d AC a AH n AF
arkadaşlık	a AH ɾ AM k AC a AH d AC a AH ʃ AC ɫ AD ɯ AH k AC
arkadaşta	a AH ɾ AM k AC a AH d AC a AH ʃ AC t AC a AH
arkadaştan	a AH ɾ AM k AC a AH d AC a AH ʃ AC t AC a AH n AF
arkadaşı	a AH ɾ AM k AC a AH d AC a AH ʃ AC ɯ AH
arkadaşın	a AH ɾ AM k AC a AH d AC a AH ʃ AC ɯ AH n AF
artı	a AH ɾ AM t AC ɯ AH
artık	ɑ AH ɾ AM t AC ɯ AH k AC
arz	a AH ɾ AM z AC
aseksüel	ɑ AH s AC ɛ AH c AC s AC y AJ e AH l AD
aseton	ɑ AH s AC ɛ AH t AC ɔ AJ n AF
asimptot	ɑ AH s AC i AH m AE p AG t AC ɔ AJ t AC
asyalı	ɑ AH s AC j AB ɑ AH ɫ AD ɯ AH
ataşe	ɑ AH t AC ɑ AH ʃ AC ɛ AH
atina	ɑ AH t AC i AH n AF ɑ AH
atlı	ɑ AH t AC ɫ AD ɯ AH
atom	ɑ AH t AC ɔ AJ m AE
avanak	ɑ AH β AG ɑ AH n AF ɑ AH k AC
avize	ɑ AH v AG i AH z AC e AH
avizeler	aː AI v AG i AH z AC e AH ɫ AD e AH ɾ AM
avizem	aː AI v AG i AH z AC e AH m AE
avizen	aː AI v AG i AH z AC e AH n AF
avizenin	aː AI v AG i AH z AC e AH n AF i AH n AF
avizesi	aː AI v AG i AH z AC e AH s AC i AH
avizeyi	aː AI v AG i AH z AC e AH j AB i AH
avokado	ɑ AH β AG o AJ k AC ɑː AI d AC o AJ
avrasya	ɑ AH β AG ɾ AM ɑ AH s AC j AB ɑ AH
ayak	ɑ AH j AB ɑ AH k AC
ayakkabıcı	ɑ AH j AB ɑ AH k AC k AC ɑ AH b AG ɯ AH d AC ʒ AC ɯ AH
ayaz	a AH j AB a AH z AC
ayazlı	a AH j AB a AH z AC ɫ AD ɯ AH
ayazsız	a AH j AB a AH z AC s AC ɯ AH z AC
aydınlık	a AH j AB d AC ɯ AH n AF ɫ AD ɯ AH k AC
ayin	ɑː AI j AB i AH n AF
aynı	ɑ AH j AB n AF ɯ AH
ayva	a AH j AB v AG a AH
ayça	ɑ AH j AB t AC ʃ AC ɑ AH
ayı	ɑ AH j AB ɯ AH
ayşe	ɑ AH j AB ʃ AC ɛ AH
az	ɑ AH z AC
azap	ɑ AH z AC ɑː AI b AG
azrail	ɑ AH z AC ɾ AM ɑː AI i AH l AD
azınlık	a AH z AC ɯ AH n AF ɫ AD ɯ AH k AC
aç	ɑ AH t AC ʃ AC
açlık	a AH t AC ʃ AC ɫ AD ɯ AH k AC
ağa	ɑ AH ɑ AH
ağdacı	ɑː AI d AC ɑ AH d AC ʒ AC ɯ AH
ağlaşmak	aː AI ɫ AD a AH ʃ AC m AE a AH k AC
ağıt	ɑ AH ɰ AB ɯ AH t AC
ağız	a AH ɯ AH z AC
aşiret	a AH ʃ AC iː AI ɾ AM e AH t AC
aşçı	a AH ʃ AC t AC ʃ AC ɯ AH
aşık	ɑ AH ʃ AC ɯ AH k AC
babaları	b AG a AH b AG a AH l AD a AH ɾ AM ɯ AH
babalı	b AG a AH b AG a AH ɫ AD ɯ AH
babalık	b AG a AH b AG a AH ɫ AD ɯ AH k AC
babasız	b AG a AH b AG a AH s AC ɯ AH z AC
bahadır	b AG ɑ AH h AA ɑ AH d AC ɯ AH r AL
baharat	b AG a AH h AA a AH r AL a AH t AC
bahçe	b AG ɑ AH h AA t AC ʃ AC ɛ AH
bahçıvan	b AG ɑ AH h AA t AC ʃ AC ɯ AH v AG ɑ AH n AF
bakıcı	b AG ɑ AH k AC ɯ AH d AC ʒ AC ɯ AH
bakır	b AG a AH k AC ɯ AH ɾ AM
balalayka	b AG ɑ AH ɫ AD ɑ AH ɫ AD ɑ AH j AB k AC ɑ AH
baldız	b AG ɑ AH ɫ AD d AC ɯ AH z AC
balkan	b AG ɑ AH ɫ AD k AC ɑ AH n AF
balkanlar	b AG ɑ AH ɫ AD k AC ɑ AH n AF ɫ AD ɑ AH ɾ AM
baltacı	b AG ɑ AH ɫ AD t AC ɑ AH d AC ʒ AC ɯ AH
baltacılık	b AG ɑ AH ɫ AD t AC ɑ AH d AC ʒ AC ɯ AH ɫ AD ɯ AH k AC
baltalar	b AG ɑ AH ɫ AD t AC ɑ AH ɫ AD ɑ AH ɾ AM
baltam	b AG ɑ AH ɫ AD t AC ɑ AH m AE
baltan	b AG ɑ AH ɫ AD t AC ɑ AH n AF
baltanı	b AG ɑ AH ɫ AD t AC ɑ AH n AF ɯ AH
baltayı	b AG ɑ AH ɫ AD t AC ɑ AH j AB ɯ AH
balık	b AG ɑ AH ɫ AD ɯ AH k AC
balıkçı	b AG ɑ AH ɫ AD ɯ AH k AC t AC ʃ AC ɯ AH
balığı	b AG ɑ AH ɫ AD ɯ AH ɰ AB ɯ AH
bamya	b AG ɑ AH m AE j AB ɑ AH
bandaj	b AG ɑ AH n AF d AC ɑ AH ʒ AC
banka	b AG a AH n AF k AC a AH
banklar	b AG ɑ AH n AF k AC ɫ AD a AH ɾ AM
bankları	b AG ɑ AH n AF k AC ɫ AD a AH ɾ AM ɯ AH
bankı	b AG ɑ AH n AF k AC ɯ AH
bankım	b AG ɑ AH n AF k AC ɯ AH m AE
bankın	b AG ɑ AH n AF k AC ɯ AH n AF
barbar	b AG ɑ AH ɾ AM b AG ɑ AH ɾ AM
bardak	b AG ɑ AH ɾ AM d AC ɑ AH k AC
barış	b AG ɑ AH ɾ AM ɯ AH ʃ AC
basiretli	b AG a AH s AC iː AI ɾ AM e AH t AC ɫ AD i AH
basiretsiz	b AG a AH s AC iː AI ɾ AM e AH t AC s AC i AH z AC
basit	b AG ɑ AH s AC i AH t AC
baston	b AG ɑ AH s AC t AC o AJ n AF
batum	b AG ɑ AH t AC u AJ m AE
batı	b AG ɑ AH t AC ɯ AH
bayat	b AG ɑ AH j AB ɑ AH t AC
baygın	b AG ɑ AH j AB ɡ AC ɯ AH n AF
baygınlık	b AG ɑ AH j AB ɡ AC ɯ AH n AF ɫ AD ɯ AH k AC
bayram	b AG ɑ AH j AB ɾ AM ɑ AH m AE
baytar	b AG ɑ AH j AB t AC ɑ AH ɾ AM
bayılma	b AG ɑ AH j AB ɯ AH ɫ AD m AE ɑ AH
bazı	b AG ɑː AI z AC ɯ AH
bağ	b AG ɑː AI
bağcık	b AG ɑ AH ɰ AB d AC ʒ AC ɯ AH c AC
bağcıklar	b AG ɑ AH ɰ AB d AC ʒ AC ɯ AH c AC ɫ AD a AH ɾ AM
bağcığı	b AG ɑ AH ɰ AB d AC ʒ AC ɯ AH ɰ AB ɯ AH
bağcığım	b AG ɑ AH ɰ AB d AC ʒ AC ɯ AH ɰ AB ɯ AH m AE
bağcığın	b AG ɑ AH ɰ AB d AC ʒ AC ɯ AH ɰ AB ɯ AH n AF
bağlamak	b AG ɑː AI ɫ AD ɑ AH m AE a AH k AC
bağlamamak	b AG ɑ AH ɰ AB ɫ AD a AH m AE a AH m AE a AH c AC
bağlamaz	b AG ɑ AH ɰ AB ɫ AD a AH m AE a AH z AC
bağlar	b AG ɑː AI ɫ AD a AH ɾ AM
bağları	b AG ɑ AH ɰ AB ɫ AD a AH ɾ AM ɯ AH
bağı	b AG ɑ AH ɯ AH
bağım	b AG ɑ AH ɯ AH m AE
bağımsızlık	b AG a AH ɯ AH m AE s AC ɯ AH z AC ɫ AD ɯ AH k AC
bağın	b AG ɑ AH ɰ AB ɯ AH n AF
baş	b AG ɑ AH ʃ AC
başak	b AG ɑ AH ʃ AC ɑ AH k AC
başkan	b AG a AH ʃ AC k AC a AH n AF
başlama	b AG a AH ʃ AC l AD a AH m AE a AH
başlamak	b AG ɑ AH ʃ AC ɫ AD ɑ AH m AE ɑ AH k AC
başlamamak	b AG a AH ʃ AC ɫ AD a AH m AE a AH m AE a AH c AC
başlangıç	b AG a AH ʃ AC ɫ AD a AH n AF ɡ AC ɯ AH t AC ʃ AC
başlar	b AG ɑ AH ʃ AC l AD a AH ɾ AM
başparmak	b AG ɑ AH ʃ AC p AG ɑ AH ɾ AM m AE ɑ AH k AC
başı	b AG ɑ AH d AC ʃ AC ɯ AH
başıboş	b AG a AH ʃ AC ɯ AH b AG o AJ ʃ AC
bebek	b AG ɛ AH b AG ɛ AH c AC
bedevi	b AG ɛ AH d AC ɛ AH v AG iː AI
beklemek	b AG e̞ AH c AC l AD e̞ AH m AE e̞ AH c AC
bekletmek	b AG e̞ AH c AC l AD e̞ AH t AC m AE e̞ AH c AC
belarusça	b AG ɛ AH l AD a AH ɾ AM ʊ AJ s AC t AC ʃ AC ɑ AH
belçikalı	b AG e AH l AD t AC ʃ AC i AH c AC ɑ AH ɫ AD ɯ AH
bencillik	b AG e AH n AF d AC ʒ AC i AH l AD l AD i AH c AC
beraber	b AG ɛ AH ɾ AM ɑː AI b AG æ AH ɾ̝̊
bereket	b AG e AH ɾ AM e AH k AC e AH t AC
berilyum	b AG ɛ AH ɾ AM i AH l AD j AB u AJ m AE
berlinli	b AG e AH ɾ AM l AD i AH n AF l AD i AH
bermuda	b AG e AH ɾ AM m AE ʊ AJ d AC ɑ AH
beyin	b AG ɛ AH j AB i AH n AF
beyinler	b AG ɛ AH j AB i AH n AF l AD e AH ɾ AM
beyit	b AG ɛ AH j AB i AH t AC
beyni	b AG ɛ AH j AB n AF i AH
beşgen	b AG e AH ʃ AC ɟ AC e AH n AF
bikini	b AG i AH c AC i AH n AF i AH
bilek	b AG i AH ɫ AD e AH c AC
bilgisayar	b AG i AH l AD ɟ AC i AH s AC ɑ AH j AB ɑ AH ɾ AM
bilim	b AG i AH l AD i AH m AE
bilinç	b AG i AH l AD i AH n AF t AC ʃ AC
bilye	b AG i AH l AD j AB ɛ AH
bira	b AG i AH ɾ AM a AH
birce	b AG i AH ɾ AM d AC ʒ AC ɛ AH
birey	b AG i AH ɾ AM e AH j AB
birincil	b AG i AH ɾ AM i AH n AF d AC ʒ AC i AH ɫ AD
birleşik	b AG i AH ɾ AM l AD e AH ʃ AC i AH c AC
birlikte	b AG i AH ɾ AM l AD i AH c AC t AC ɛ AH
birliktelik	b AG i AH ɾ AM l AD i AH c AC t AC e AH l AD i AH c AC
birtakım	b AG i AH ɾ AM t AC ɑ AH k AC ɯ AH m AE
biseksüel	b AG i AH s AC ɛ AH c AC s AC y AJ e AH l AD
bitim	b AG i AH t AC i AH m AE
bitiş	b AG i AH t AC i AH ʃ AC
bitişik	b AG i AH t AC i AH ʃ AC i AH k AC
bitme	b AG i AH t AC m AE e AH
bizmut	b AG i AH z AC m AE u AJ t AC
bohça	b AG ɔ AJ h AA t AC ʃ AC ɑ AH
bor	b AG o AJ ɾ AM
boru	b AG o AJ ɾ AM u AJ
boy	b AG o AJ j AB
boyacı	b AG ɔ AJ j AB ɑ AH d AC ʒ AC ɯ AH
boza	b AG o AJ z AC ɑ AH
bozayı	b AG o AJ z AC ɑ AH j AB ɯ AH
bozmak	b AG o̞ AJ z AC m AE ɑ AH k AC
boşamak	b AG o̞ AJ ʃ AC a AH m AE a AH k AC
boşanma	b AG ɔ AJ ʃ AC ɑ AH n AF m AE ɑ AH
boşluk	b AG o AJ ʃ AC l AD u AJ k AC
bulaşıcı	b AG u AJ ɫ AD ɑ AH ʃ AC ɯ AH d AC ʒ AC ɯ AH
bulunmak	b AG u AJ ɫ AD u AJ n AF m AE ɑ AH k AC
burnu	b AG u AJ ɾ AM n AF u AJ
burun	b AG u AJ ɾ AM u AJ n AF
burunlar	b AG u AJ ɾ AM u AJ n AF l AD a AH ɾ AM
burçin	b AG u AJ r AL t AC ʃ AC i AH n AF
bölge	b AG ø AJ l AD ɟ AC ɛ AH
börülce	b AG ø AJ ɾ AM ʏ AJ l AD d AC ʒ AC ɛ AH
bükme	b AG y AJ k AC m AE e AH
bükmeme	b AG y AJ k AC m AE e AH m AE e AH
bülbül	b AG y AJ l AD b AG y AJ l AD
büst	b AG y AJ s AC t AC
büyü	b AG y AJ j AB y AJ
büyücü	b AG y AJ j AB y AJ d AC ʒ AC y AJ
büyük	b AG y AJ j AB y AJ c AC
cadılık	d AC ʒ AC a AH d AC ɯ AH ɫ AD ɯ AH k AC
cami	d AC ʒ AC ɑː AI m AE ɪ AH
camisi	d AC ʒ AC aː AI m AE i AH s AC i AH
canlandırma	d AC ʒ AC a AH n AF ɫ AD a AH n AF d AC ɯ AH ɾ AM m AE a AH
canlandırmak	d AC ʒ AC a AH n AF ɫ AD a AH n AF d AC ɯ AH ɾ AM m AE a AH c AC
canlandırtmak	d AC ʒ AC a AH n AF ɫ AD a AH n AF d AC ɯ AH ɾ AM t AC m AE a AH c AC
canlandırtılmak	d AC ʒ AC a AH n AF ɫ AD a AH n AF d AC ɯ AH ɾ AM t AC ɯ AH ɫ AD m AE a AH c AC
canlandırılmak	d AC ʒ AC a AH n AF ɫ AD a AH n AF d AC ɯ AH ɾ AM ɯ AH ɫ AD m AE a AH c AC
canlanmak	d AC ʒ AC a AH n AF ɫ AD a AH n AF m AE a AH c AC
canlanılmak	d AC ʒ AC a AH n AF ɫ AD a AH n AF ɯ AH ɫ AD m AE a AH c AC
casus	d AC ʒ AC a AH s AC u AJ s AC
ceviz	d AC ʒ AC ɛ AH v AG i AH z AC
cezayir	d AC ʒ AC ɛ AH z AC ɑː AI j AB i AH ɾ AM
cezayirli	d AC ʒ AC ɛ AH z AC ɑː AI j AB i AH ɾ AM l AD i AH
ciddi	d AC ʒ AC i AH d AC d AC iː AI
cihan	d AC ʒ AC i AH h AA a AH n AF
cihanlar	d AC ʒ AC i AH h AA a AH n AF l AD a AH r AL
ciklet	d AC ʒ AC i AH c AC l AD ɛ AH t AC
cin	d AC ʒ AC i AH n AF
civciv	d AC ʒ AC i AH β AG d AC ʒ AC i AH β AG
coşku	d AC ʒ AC o̞ AJ ʃ AC k AC ʊ AJ
cüce	d AC ʒ AC ʏ AJ d AC ʒ AC ɛ AH
cümle	d AC ʒ AC y AJ m AE l AD ɛ AH
dadaş	d AC ɑ AH d AC ɑ AH ʃ AC
dadı	d AC ɑ AH d AC ɯ AH
daktilo	d AC ɑ AH k AC t AC i AH ɫ AD ɔ AJ
dalak	d AC ɑ AH ɫ AD ɑ AH k AC
dalgın	d AC a AH ɫ AD ɟ AC ɯ AH n AF
dalgınlık	d AC a AH ɫ AD ɟ AC ɯ AH n AF ɫ AD ɯ AH k AC
dalgıç	d AC ɑ AH ɫ AD ɡ AC ɯ AH t AC ʃ AC
dalmak	d AC ɑ AH ɫ AD m AE ɑ AH k AC
damatlık	d AC aː AI m AE a AH t AC ɫ AD ɯ AH k AC
davranışçılık	d AC ɑ AH v AG ɾ AM ɑ AH n AF ɯ AH ʃ AC t AC ʃ AC ɯ AH ɫ AD ɯ AH k AC
dayı	d AC a AH j AB ɯ AH
dağ	d AC aː AI
dede	d AC e AH d AC e AH
dedeağaç	d AC ɛ AH d AC ɛ AH ɑ AH ɰ AB ɑ AH t AC ʃ AC
dedikoducu	d AC ɛ AH d AC i AH k AC ɔ AJ d AC u AJ d AC ʒ AC u AJ
defter	d AC e AH f AG t AC e AH ɾ AM
dehşet	d AC e AH h AA ʃ AC ɛ AH t AC
deltoid	d AC e AH l AD t AC o AJ j AB i AH d AC
denizanası	d AC e AH n AF i AH z AC a AH n AF a AH s AC ɯ AH
depresyon	d AC e AH p AG ɾ AM e AH s AC j AB o AJ n AF
derece	d AC e AH ɾ AM ɛ AH d AC ʒ AC ɛ AH
dergi	d AC e AH ɾ AM ɟ AC i AH
derin	d AC e AH ɾ AM i AH n AF
dernek	d AC e AH ɾ AM n AF e AH c AC
dertli	d AC e AH ɾ AM t AC l AD i AH
derviş	d AC e AH ɾ AM v AG i AH ʃ AC
derya	d AC e AH ɾ AM j AB ɑː AI
destan	d AC ɛ AH s AC t AC ɑ AH n AF
dev	d AC ɛ AH β AG
devam	d AC e AH v AG ɑ AH m AE
devrim	d AC ɛ AH v AG ɾ AM i AH m AE
deyn	d AC e AH j AB n AF
değildir	d AC e AH ɰ AB ɫ AD i AH d AC i AH ɾ AM
değilim	d AC e AH ɰ AB ɫ AD i AH m AE
değiliz	d AC e AH ɰ AB i AH ɫ AD i AH z AC
değiller	d AC e AH ɰ AB i AH ɫ AD ɫ AD e AH ɾ AM
değilsin	d AC e AH ɰ AB ɫ AD s AC i AH n AF
değilsiniz	d AC e AH ɰ AB i AH ɫ AD s AC i AH n AF i AH z AC
değişik	d AC ɛ AH i AH ʃ AC i AH c AC
değişmek	d AC e AH j AB i AH ʃ AC m AE e AH c AC
değişmez	d AC e AH j AB i AH ʃ AC m AE e AH z AC
değiştirmek	d AC e AH j AB i AH ʃ AC t AC i AH ɾ AM m AE e AH c AC
didaktik	d AC i AH d AC a AH k AC t AC i AH c AC
dijital	d AC i AH ʒ AC i AH t AC a AH l AD
dikdörtgen	d AC i AH k AC d AC œ AJ ɾ AM t AC ɟ AC e AH n AF
dikey	d AC i AH c AC ɛ AH j AB
dilbilim	d AC i AH l AD b AG i AH l AD i AH m AE
dildo	d AC i AH l AD d AC o AJ
dilenci	d AC i AH l AD ɛ AH n AF d AC ʒ AC ɪ AH
dilim	d AC i AH l AD i AH m AE
dilimde	d AC i AH l AD i AH m AE d AC e AH
dilimden	d AC i AH l AD i AH m AE d AC e AH n AF
dilime	d AC i AH l AD i AH m AE e AH
dilimi	d AC i AH l AD i AH m AE i AH
dilimim	d AC i AH ɫ AD i AH m AE i AH m AE
dilimimi	d AC i AH ɫ AD i AH m AE i AH m AE i AH
dilimimin	d AC i AH ɫ AD i AH m AE i AH m AE i AH n AF
dilimin	d AC i AH ɫ AD i AH m AE i AH n AF
dilimini	d AC i AH ɫ AD i AH m AE i AH n AF i AH
diliminin	d AC i AH ɫ AD i AH m AE i AH n AF i AH n AF
dilimler	d AC i AH ɫ AD i AH m AE ɫ AD e AH ɾ AM
dilimleri	d AC i AH ɫ AD i AH m AE ɫ AD e AH ɾ AM i AH
dilinde	d AC i AH l AD i AH n AF d AC e AH
dilinden	d AC i AH l AD i AH n AF d AC e AH n AF
diline	d AC i AH l AD i AH n AF e AH
dilini	d AC i AH l AD i AH n AF i AH
dilinin	d AC i AH l AD i AH n AF i AH n AF
dimetoka	d AC i AH m AE ɛ AH t AC ɔ AJ k AC ɑ AH
dinamit	d AC i AH n AF ɑ AH m AE i AH t AC
dindar	d AC i AH n AF d AC a AH r AL
dindarlık	d AC i AH n AF d AC a AH r AL ɫ AD ɯ AH c AC
dini	d AC iː AI n AF i AH
dinlememek	d AC i AH n AF l AD e AH m AE e AH m AE e AH c AC
dinlenme	d AC i AH n AF l AD e AH n AF m AE e AH
dinlenmeme	d AC i AH n AF l AD e AH n AF m AE e AH m AE e AH
dinlerde	d AC i AH n AF ɫ AD e AH ɾ AM d AC e AH
dinlerden	d AC i AH n AF ɫ AD e AH ɾ AM d AC e AH n AF
dinlere	d AC i AH n AF ɫ AD e AH ɾ AM e AH
dinleri	d AC i AH n AF ɫ AD e AH ɾ AM i AH
dinlerin	d AC i AH n AF ɫ AD e AH ɾ AM i AH n AF
dinli	d AC i AH n AF ɫ AD i AH
dinlilik	d AC i AH n AF ɫ AD i AH ɫ AD i AH c AC
dinsiz	d AC i AH n AF s AC i AH z AC
dinsizlik	d AC i AH n AF s AC i AH z AC ɫ AD i AH c AC
dinç	d AC i AH n AF t AC ʃ AC
dirilmek	d AC i AH ɾ AM i AH ɫ AD i AH ɾ AM m AE e AH k AC
disko	d AC i AH s AC k AC ɔ AJ
diskotek	d AC i AH s AC k AC ɔ AJ t AC ɛ AH c AC
disleksi	d AC i AH s AC ɫ AD e AH k AC s AC i AH
diye	d AC i AH j AB ɛ AH
dize	d AC i AH z AC e AH
dizemi	d AC i AH z AC e AH m AE i AH
dizemim	d AC i AH z AC e AH m AE i AH m AE
dizemin	d AC i AH z AC e AH m AE i AH n AF
dizemler	d AC i AH z AC e AH m AE ɫ AD e AH ɾ AM
diş	d AC i AH ʃ AC
dişil	d AC i AH ʃ AC i AH ɫ AD
dokuzgen	d AC o AJ k AC u AJ z AC ɟ AC e AH n AF
dolaşan	d AC o AJ ɫ AD a AH ʃ AC a AH n AF
dolaşmayan	d AC o AJ ɫ AD a AH ʃ AC m AE a AH j AB a AH n AF
dolmuş	d AC ɔ AJ ɫ AD m AE ʊ AJ ʃ AC
doymak	d AC ɔ AJ j AB m AE ɑ AH k AC
doğa	d AC o AJ a AH
doğu	d AC ɔ AJ ɰ AB ʊ AJ
dudak	d AC u AJ d AC ɑ AH k AC
dudu	d AC u AJ d AC u AJ
duy	d AC u AJ j AB
duyma	d AC u AJ j AB m AE a AH
duymak	d AC u AJ j AB m AE a AH k AC
duymama	d AC u AJ j AB m AE a AH m AE a AH
duyun	d AC u AJ j AB uː AK n AF
dönmek	d AC œ AJ n AF m AE e AH c AC
dönüş	d AC ø AJ n AF y AJ ʃ AC
dönüşlü	d AC ø AJ n AF y AJ ʃ AC l AD y AJ
dönüşmek	d AC œ AJ n AF y AJ ʃ AC m AE e AH c AC
dönüşsüz	d AC ø AJ n AF y AJ ʃ AC s AC y AJ z AC
dörtgen	d AC œ AJ ɾ AM t AC ɟ AC e AH n AF
dövme	d AC œ AJ v AG m AE ɛ AH
dük	d AC y AJ c AC
dünür	d AC ʏ AJ n AF ʏ AJ ɾ̝̊
dürbün	d AC y AJ ɾ AM b AG y AJ n AF
dürüm	d AC y AJ ɾ AM y AJ m AE
düyun	d AC y AJ j AB uː AK n AF
düğün	d AC y AJ y AJ n AF
düşes	d AC y AJ ʃ AC e AH s AC
düşkün	d AC y AJ ʃ AC c AC y AJ n AF
düşman	d AC y AJ ʃ AC m AE ɑ AH n AF
dılak	d AC ɯ AH ɫ AD a AH k AC
dış	d AC ɯ AH ʃ AC
dışkı	d AC ɯ AH ʃ AC k AC ɯ AH
ebe	ɛ AH b AG ɛ AH
ecel	ɛ AH d AC ʒ AC e AH l AD
edat	e AH d AC a AH t AC
efsanevi	ɛ AH f AG s AC ɑː AI n AF ɛ AH v AG iː AI
egoizm	e AH ɡ AC o AJ iː AI z AC m AE
ekimi	e AH k AC i AH m AE i AH
ekimler	e AH k AC i AH m AE ɫ AD e AH ɾ AM
ekin	e AH k AC i AH n AF
ekini	e AH k AC i AH n AF i AH
ekinim	e AH k AC i AH n AF i AH m AE
ekinin	e AH k AC i AH n AF i AH n AF
ekinler	e AH k AC i AH n AF ɫ AD e AH ɾ AM
ekran	e AH k AC ɾ AM a AH n AF
ekranlar	e AH k AC ɾ AM a AH n AF ɫ AD a AH ɾ AM
ekranı	e AH k AC ɾ AM a AH n AF ɯ AH
ekranım	e AH k AC ɾ AM a AH n AF ɯ AH m AE
ekranın	e AH k AC ɾ AM a AH n AF ɯ AH n AF
eksen	e AH k AC s AC e AH n AF
ekseni	e AH k AC s AC e AH n AF i AH
eksenim	e AH k AC s AC e AH n AF i AH m AE
eksenin	e AH k AC s AC e AH n AF i AH n AF
eksenler	e AH k AC s AC e AH n AF ɫ AD e AH ɾ AM
eksenleri	e AH k AC s AC e AH n AF ɫ AD e AH ɾ AM i AH
eksiklik	ɛ AH c AC s AC i AH c AC l AD i AH c AC
ekstremum	ɛ AH c AC s AC t AC ɾ AM ɛ AH m AE u AJ m AE
ekşimek	ɛ AH c AC ʃ AC i AH m AE ɛ AH c AC
ekşitmek	ɛ AH c AC ʃ AC i AH t AC m AE ɛ AH c AC
elastik	e AH l AD a AH s AC t AC i AH k AC
elbise	e AH l AD b AG i AH s AC ɛ AH
elbiseler	e AH l AD b AG i AH s AC ɛ AH l AD ɛ AH ɾ AM
elbiseyi	e AH l AD b AG i AH s AC ɛ AH j AB i AH
element	ɛ AH l AD e AH m AE e AH n AF t AC
elemli	ɛ AH l AD e AH m AE l AD i AH
elips	ɛ AH l AD i AH p AG s AC
elma	e AH l AD m AE ɑ AH
elmacı	e AH l AD m AE ɑ AH d AC ʒ AC ɯ AH
elmalar	e AH l AD m AE a AH l AD a AH ɾ AM
elçi	e AH l AD t AC ʃ AC i AH
embriyo	ɛ AH m AE b AG ɾ AM i AH j AB ɔ AJ
emir	e AH m AE i AH ɾ AM
emir'e	e AH m AE i AH ɾ AM e AH
emir'i	e AH m AE i AH ɾ AM i AH
emir'im	e AH m AE i AH ɾ AM i AH m AE
emir'ime	e AH m AE i AH ɾ AM i AH m AE e AH
emir'in	e AH m AE i AH ɾ AM i AH n AF
emir'ler	e AH m AE i AH ɾ AM ɫ AD e AH ɾ AM
emire	e AH m AE i AH ɾ AM e AH
emiri	e AH m AE i AH ɾ AM i AH
emirim	e AH m AE i AH ɾ AM i AH m AE
emirime	e AH m AE i AH ɾ AM i AH m AE e AH
emirin	e AH m AE i AH ɾ AM i AH n AF
emirler	e AH m AE i AH ɾ AM ɫ AD e AH ɾ AM
emlak	e AH m AE ɫ AD a AH c AC
emlakçı	e AH m AE ɫ AD a AH c AC t AC ʃ AC ɯ AH
emlakçılık	e AH m AE ɫ AD a AH c AC t AC ʃ AC ɯ AH ɫ AD ɯ AH k AC
emniyet	e AH m AE n AF i AH j AB e AH t AC
emre	e AH m AE ɾ AM ɛ AH
emri	e AH m AE ɾ AM i AH
emrim	e AH m AE ɾ AM i AH m AE
emrin	e AH m AE ɾ AM i AH n AF
endülüs	ɛ AH n AF d AC y AJ l AD y AJ s AC
engizisyon	e AH n AF ɡ AC i AH z AC i AH s AC j AB o AJ n AF
enişte	ɛ AH n AF i AH ʃ AC t AC ɛ AH
entrika	e AH n AF t AC ɾ AM i AH k AC a AH
entrikalar	e AH n AF t AC ɾ AM i AH k AC a AH ɫ AD a AH ɾ AM
entrikanın	e AH n AF t AC ɾ AM i AH k AC a AH n AF ɯ AH n AF
entrikayı	e AH n AF t AC ɾ AM i AH k AC a AH j AB ɯ AH
erdoğan	æ AH ɾ AM d AC o AJ a AH n AF
ergenlik	e AH ɾ AM ɟ AC e AH n AF l AD i AH c AC
erik	e AH ɾ AM i AH c AC
eril	e AH ɾ AM i AH ɫ AD
erivan	ɛ AH ɾ AM i AH v AG ɑ AH n AF
erkeksi	e AH ɾ AM c AC ɛ AH c AC s AC i AH
ermenistan	æ AH ɾ AM m AE e AH n AF i AH s AC t AC a AH n AF
erotik	ɛ AH ɾ AM ɔ AJ t AC i AH c AC
ertelenebilir	e AH ɾ AM t AC e AH ɫ AD e AH n AF e AH b AG i AH ɫ AD i AH ɾ AM
ertelenemez	e AH ɾ AM t AC e AH ɫ AD e AH n AF e AH m AE e AH z AC
esas	e AH s AC a AH s AC
esen	e AH s AC e AH n AF
esenlik	e AH s AC e AH n AF ɫ AD i AH k AC
esrar	ɛ AH s AC ɾ AM ɑ AH ɾ AM
esrarlar	ɛ AH s AC ɾ AM ɑ AH ɾ AM l AD ɑ AH ɾ AM
esrarı	ɛ AH s AC ɾ AM ɑ AH ɾ AM ɯ AH
etek	ɛ AH t AC ɛ AH c AC
etkin	e AH t AC k AC i AH n AF
etmek	e AH t AC m AE e AH c AC
ev	ɛ AH v AG
evcik	ɛ AH v AG d AC ʒ AC i AH k AC
evim	e AH v AG i AH m AE
evine	ɛ AH v AG i AH n AF ɛ AH
evlatlık	e AH β AG ɫ AD a AH t AC l AD ɯ AH k AC
evlilik	e AH β AG l AD i AH l AD i AH c AC
evrim	ɛ AH v AG ɾ AM i AH m AE
eğlence	e AH j AB l AD æ AH n AF d AC ʒ AC e AH
eşcinsel	ɛ AH ʃ AC d AC ʒ AC i AH n AF s AC e AH l AD
eşya	ɛ AH ʃ AC j AB ɑː AI
eşzamansız	e AH ʃ AC z AC a AH m AE a AH n AF s AC ɯ AH z AC
fagot	f AG ɑ AH ɡ AC o AJ t AC
fahişelik	f AG ɑː AI h AA i AH ʃ AC ɛ AH l AD i AH c AC
faks	f AG a AH k AC s AC
fare	f AG aː AI ɾ AM ɛ AH
farklı	f AG ɑ AH ɾ AM k AC ɫ AD ɯ AH
faslı	f AG ɑ AH s AC ɫ AD ɯ AH
fazlalık	f AG a AH z AC ɫ AD a AH ɫ AD ɯ AH k AC
feci	f AG e AH d AC ʒ AC iː AI
fikoloji	f AG i AH k AC ɔ AJ l AD ɔ AJ ʒ AC i AH
filiz	f AG i AH l AD i AH z AC
finiş	f AG i AH n AF i AH ʃ AC
fizik	f AG i AH z AC i AH c AC
fizyoloji	f AG i AH z AC j AB o AJ l AD o AJ ʒ AC i AH
fişek	f AG i AH ʃ AC ɛ AH c AC
flaş	f AG l AD a AH ʃ AC
flor	f AG l AD o AJ ɾ AM
fren	f AG ɾ AM e AH n AF
frende	f AG ɾ AM e AH n AF d AC e AH
frenden	f AG ɾ AM e AH n AF d AC e AH n AF
frene	f AG ɾ AM e AH n AF e AH
freni	f AG ɾ AM e AH n AF i AH
frenim	f AG ɾ AM e AH n AF i AH m AE
frenin	f AG ɾ AM e AH n AF i AH n AF
frenler	f AG ɾ AM e AH n AF ɫ AD e AH ɾ AM
frigya	f AG ɾ AM i AH ɟ AC j AB ɑ AH
fulya	f AG ʊ AJ l AD j AB ɑ AH
fâni	f AG aː AI n AF iː AI
füze	f AG y AJ z AC e AH
fırtına	f AG ɯ AH ɾ AM t AC ɯ AH n AF ɑ AH
fırtınalı	f AG ɯ AH ɾ AM t AC ɯ AH n AF ɑ AH ɫ AD ɯ AH
fıstık	f AG ɯ AH s AC t AC ɯ AH k AC
gaf	ɡ AC a AH f AG
gaflet	ɡ AC a AH f AG l AD e̞ AH t AC
galeri	ɡ AC ɑ AH l AD ɛ AH ɾ AM i AH
galiba	ɡ AC ɑː AI l AD i AH b AG ɑː AI
galiçyaca	ɡ AC ɑ AH l AD i AH t AC ʃ AC j AB ɑ AH d AC ʒ AC ɑ AH
gamlı	ɡ AC ɑ AH m AE ɫ AD ɯ AH
gayda	ɟ AC a AH j AB d AC a AH
gayzer	ɟ AC a AH j AB z AC e AH ɾ AM
gazel	ɡ AC ɑ AH z AC e AH l AD
gece	ɟ AC e̞ AH d AC ʒ AC ɛ AH
gecelik	ɟ AC ɛ AH d AC ʒ AC ɛ AH l AD i AH k AC
gel	ɟ AC æ AH l AD
gelinlik	ɟ AC ɛ AH l AD i AH n AF l AD i AH c AC
gelir	ɡ AC e AH l AD i AH ɾ AM
gemi	ɟ AC e AH m AE i AH
genelev	ɟ AC ɛ AH n AF ɛ AH l AD ɛ AH v AG
gençlik	ɟ AC ɛ AH n AF t AC ʃ AC l AD i AH c AC
geri	ɡ AC e AH ɾ AM i AH
geriler	ɡ AC e AH ɾ AM i AH ɫ AD e AH ɾ AM
getmek	ɡ AC e AH t AC m AE e AH c AC
gezmek	ɟ AC e AH z AC m AE e AH c AC
geçmek	ɟ AC e AH t AC ʃ AC m AE e AH c AC
geçmiş	ɟ AC ɛ AH t AC ʃ AC m AE i AH ʃ AC
gider	ɡ AC i AH d AC e AH ɾ AM
giysi	ɟ AC i AH j AB s AC i AH
gol	ɡ AC o AJ l AD
gurbet	ɡ AC u AJ ɾ AM b AG ɛ AH t AC
gurbetçi	ɡ AC u AJ ɾ AM b AG ɛ AH t AC t AC ʃ AC i AH
gökdelen	ɟ AC œ AJ k AC d AC e AH l AD ɛ AH n AF
gölge	ɟ AC œ AJ l AD ɟ AC ɛ AH
gönül	ɟ AC œ AJ n AF y AJ l AD
göre	ɟ AC ø AJ ɾ AM ɛ AH
görmek	ɟ AC œ AJ ɾ AM m AE ɛ AH c AC
gösteri	ɡ AC œ AJ s AC t AC ɛ AH r AL i AH
göstermek	ɟ AC œ AJ s AC t AC ɛ AH ɾ AM m AE ɛ AH c AC
göt	ɟ AC œ AJ t AC
gövde	ɟ AC ø AJ v AG d AC ɛ AH
gözbebeği	ɟ AC ø AJ z AC b AG e AH b AG e AH j AB i AH
gözlem	ɟ AC œ AJ z AC l AD ɛ AH m AE
gözlemci	ɟ AC œ AJ z AC l AD ɛ AH m AE d AC ʒ AC ɪ AH
gözleme	ɟ AC ø AJ z AC l AD e AH m AE ɛ AH
gözlük	ɟ AC œ AJ z AC l AD y AJ c AC
gözyaşı	ɟ AC œ AJ z AC j AB a AH ʃ AC ɯ AH
göçmek	ɟ AC œ AJ t AC ʃ AC m AE ɛ AH c AC
göğüs	ɟ AC œ AJ y AJ s AC
gübre	ɟ AC y AJ b AG ɾ AM ɛ AH
gül	ɟ AC y AJ l AD
güldürmek	ɟ AC ʏ AJ l AD d AC ʏ AJ ɾ AM m AE ɛ AH c AC
güllacı	ɟ AC y AJ l AD l AD a AH d AC ʒ AC ɯ AH
güllaç	ɟ AC y AJ l AD l AD a AH t AC ʃ AC
güllaçlar	ɟ AC y AJ l AD l AD a AH t AC ʃ AC l AD a AH ɾ AM
güllaçtan	ɟ AC y AJ l AD l AD a AH t AC ʃ AC t AC a AH n AF
gülünç	ɡ AC y AJ l AD y AJ n AF t AC ʃ AC
gülünçleşmek	ɡ AC y AJ l AD y AJ n AF t AC ʃ AC l AD ɛ AH ʃ AC m AE ɛ AH c AC
gülüş	ɟ AC y AJ l AD y AJ ʃ AC
gümülcine	ɟ AC ʏ AJ m AE ʏ AJ l AD d AC ʒ AC i AH n AF ɛ AH
gümüş	ɟ AC y AJ m AE y AJ ʃ AC
gün	ɟ AC y AJ n AF
günah	ɟ AC y AJ n AF ɑ AH h AA
gündüz	ɟ AC y AJ n AF d AC y AJ z AC
günebakan	ɟ AC y AJ n AF ɛ AH b AG ɑ AH k AC ɑ AH n AF
güneş	ɟ AC y AJ n AF e AH ʃ AC
günler	ɟ AC y AJ n AF l AD æ AH ɾ̝̊
günü	ɟ AC y AJ n AF ʏ AJ
gürcistanlı	ɟ AC y AJ ɾ AM d AC ʒ AC i AH s AC t AC ɑ AH n AF ɫ AD ɯ AH
güreş	ɟ AC y AJ ɾ AM ɛ AH ʃ AC
güven	ɟ AC ʏ AJ v AG e AH n AF
güzelleştirmek	ɟ AC y AJ z AC e AH l AD l AD ɛ AH ʃ AC t AC i AH ɾ AM m AE ɛ AH c AC
güç	ɟ AC y AJ t AC ʃ AC
hadis	h AA a AH d AC i AH s AC
hadisi	h AA a AH d AC iː AI s AC i AH
hadisler	h AA a AH d AC i AH s AC ɫ AD e AH ɾ AM
hadım	h AA a AH d AC ɯ AH m AE
haham	h AA ɑ AH h AA ɑ AH m AE
hain	h AA aː AI i AH n AF
haince	h AA aː AI i AH n AF d AC ʒ AC e AH
hamam	h AA ɑ AH m AE ɑ AH m AE
hamburger	h AA ɑ AH m AE b AG ʊ AJ ɾ AM ɟ AC e AH ɾ AM
hamster	h AA a AH m AE s AC t AC e AH ɾ AM
hamt	h AA a AH m AE t AC
hançer	h AA ɑ AH n AF t AC ʃ AC e AH ɾ AM
hapis	h AA a AH p AG i AH s AC
harap	h AA ɑ AH ɾ AM ɑ AH p AG
hararet	h AA ɑ AH ɾ AM ɑː AI ɾ AM e AH t AC
harput	h AA ɑ AH ɾ AM p AG u AJ t AC
harç	h AA a AH ɾ AM t AC ʃ AC
harçlık	h AA a AH ɾ AM t AC ʃ AC ɫ AD ɯ AH c AC
hastalanmak	h AA ɑ AH s AC t AC ɑ AH ɫ AD ɑ AH n AF m AE ɑ AH k AC
hastalık	h AA ɑ AH s AC t AC ɑ AH ɫ AD ɯ AH k AC
hastane	h AA ɑ AH s AC t AC ɑː AI n AF ɛ AH
hastaneler	h AA ɑ AH s AC t AC ɑː AI n AF ɛ AH l AD ɛ AH ɾ AM
hastaneyi	h AA ɑ AH s AC t AC ɑː AI n AF ɛ AH j AB i AH
hata	h AA ɑ AH t AC ɑː AI
havuz	h AA ɑ AH β AG u AJ z AC
hayhay	h AA ɑ AH j AB h AA ɑ AH j AB
hayvan	h AA a AH j AB v AG a AH n AF
hayır	h AA a AH j AB ɯ AH ɾ AM
hayırsever	h AA a AH j AB ɰ AB ɾ AM s AC e AH v AG e AH ɾ AM
hayırseveri	h AA a AH j AB ɰ AB ɾ AM s AC e AH v AG e AH ɾ AM i AH
hayırseverim	h AA a AH j AB ɰ AB ɾ AM s AC e AH v AG e AH ɾ AM i AH m AE
hayırseverin	h AA a AH j AB ɰ AB ɾ AM s AC e AH v AG e AH ɾ AM i AH n AF
hayırseverler	h AA a AH j AB ɰ AB ɾ AM s AC e AH v AG e AH ɾ AM ɫ AD e AH ɾ AM
hazcı	h AA a AH z AC d AC ʒ AC ɯ AH
hazcılık	h AA a AH z AC d AC ʒ AC ɯ AH ɫ AD ɯ AH c AC
hazırlık	h AA a AH z AC ɯ AH ɾ AM ɫ AD ɯ AH k AC
haç	h AA a AH t AC ʃ AC
haça	h AA ɑ AH t AC ʃ AC ɑ AH
hece	h AA e AH d AC ʒ AC ɛ AH
hedef	h AA e AH d AC e AH f AG
hedonist	h AA e AH d AC o AJ n AF i AH s AC t AC
hedonizm	h AA e AH d AC o AJ n AF i AH z AC m AE
hele	h AA e AH l AD e AH
helsinki	h AA e AH l AD s AC i AH n AF c AC i AH
helva	h AA e AH l AD v AG ɑ AH
hemen	h AA ɛ AH m AE e AH n AF
hemhudut	h AA e AH m AE h AA u AJ d AC u AJ t AC
hesap	h AA e AH s AC a AH p AG
heteroseksüel	h AA ɛ AH t AC ɛ AH ɾ AM ɔ AJ s AC ɛ AH c AC s AC y AJ e AH l AD
heykelcik	h AA ɛ AH j AB c AC e AH l AD d AC ʒ AC i AH c AC
hiperbol	h AA i AH p AG e AH ɾ AM b AG ɔ AJ l AD
hipermetrop	h AA i AH p AG e AH ɾ AM m AE e AH t AC ɾ AM o AJ p AG
hipotalamus	h AA i AH p AG ɔ AJ t AC ɑ AH ɫ AD ɑ AH m AE u AJ s AC
his	h AA i AH s AC
hititoloji	h AA i AH t AC i AH t AC o AJ l AD o AJ ʒ AC i AH
hoca	h AA o AJ d AC ʒ AC a AH
hocadır	h AA o AJ d AC ʒ AC a AH d AC ɯ AH ɾ AM
hocalar	h AA o AJ d AC ʒ AC a AH ɫ AD a AH ɾ AM
hocanın	h AA o AJ d AC ʒ AC a AH n AF ɯ AH n AF
hocayı	h AA o AJ d AC ʒ AC a AH j AB ɯ AH
hocayım	h AA o AJ d AC ʒ AC a AH j AB ɯ AH m AE
homoseksüel	h AA ɔ AJ m AE ɔ AJ s AC ɛ AH c AC s AC y AJ e AH l AD
hudut	h AA u AJ d AC u AJ t AC
hudutlu	h AA u AJ d AC u AJ t AC ɫ AD u AJ
hudutsuz	h AA u AJ d AC u AJ t AC s AC u AJ z AC
hurma	h AA u AJ ɾ AM m AE a AH
hüzünlü	h AA y AJ z AC y AJ n AF l AD y AJ
hız	h AA ɯ AH z AC
hızlıca	h AA ɯ AH z AC ɫ AD ɯ AH d AC ʒ AC ɑ AH
iffet	i AH f AG f AG e AH t AC
iftitah	i AH f AG t AC i AH t AC a AH h AA
ikincil	i AH k AC i AH n AF d AC ʒ AC i AH ɫ AD
ileti	i AH l AD ɛ AH t AC i AH
ilgeç	i AH l AD ɟ AC e AH t AC ʃ AC
ilişki	i AH l AD i AH ʃ AC c AC i AH
ilişkisel	i AH l AD i AH ʃ AC c AC i AH s AC e AH l AD
ilke	i AH l AD c AC e AH
ilklendirme	i AH ɫ AD k AC ɫ AD e AH n AF d AC i AH r AL m AE e AH
ilklendirmek	i AH ɫ AD k AC ɫ AD e AH n AF d AC i AH r AL m AE e AH c AC
ilklendirmeme	i AH ɫ AD k AC ɫ AD e AH n AF d AC i AH r AL m AE e AH m AE e AH
imdi	i AH m AE d AC i AH
inci	i AH n AF d AC ʒ AC i AH
indi	i AH n AF d AC i AH
indirim	i AH n AF d AC i AH ɾ AM i AH m AE
inek	i AH n AF e AH c AC
insan	i AH n AF s AC ɑ AH n AF
insanlık	i AH n AF s AC a AH n AF ɫ AD ɯ AH k AC
intihar	i AH n AF t AC ɑː AI ɾ AM
ipek	i AH p AG ɛ AH c AC
iribaş	i AH ɾ AM i AH b AG ɑ AH ʃ AC
isimler	i AH s AC i AH m AE l AD e AH ɾ AM
iskender	i AH s AC c AC e AH n AF d AC e AH ɾ AM
istirahat	i AH s AC t AC i AH ɾ AM a AH h AA a AH t AC
istisna	i AH s AC t AC i AH s AC n AF ɑː AI
it	i AH t AC
itmek	i AH t AC m AE e AH c AC
ittirilmek	i AH t AC t AC i AH r AL i AH ɫ AD m AE e AH c AC
ittirmek	i AH t AC t AC i AH ɾ AM m AE e AH c AC
ittirtilmek	i AH t AC t AC i AH r AL t AC i AH ɫ AD m AE e AH c AC
ittirtmek	i AH t AC t AC i AH ɾ AM t AC m AE e AH c AC
iz	i AH z AC
izin	i AH z AC i AH n AF
izolasyon	i AH z AC o AJ l AD a AH s AC y AJ o AJ n AF
iç	i AH t AC ʃ AC
içecek	i AH t AC ʃ AC ɛ AH d AC ʒ AC ɛ AH k AC
içlik	i AH t AC ʃ AC l AD i AH k AC
işgücü	i AH ʃ AC ɟ AC y AJ d AC ʒ AC y AJ
i̇branice	i AH b AG ɾ AM aː AI n AF i AH d AC ʒ AC e AH
i̇ffet	i AH f AG f AG e AH t AC
i̇ngilizce	i AH n AF ɡ AC i AH l AD i AH z AC d AC ʒ AC ɛ AH
i̇pek	i AH p AG ɛ AH c AC
i̇skandinavya	i AH s AC k AC ɑ AH n AF d AC i AH n AF ɑ AH β AG j AB ɑ AH
i̇stanbul	i AH s AC t AC a AH n AF b AG u AJ ɫ AD
i̇stanbul'dan	i AH s AC t AC a AH n AF b AG u AJ ɫ AD d AC a AH n AF
i̇sveçli	i AH s AC v AG ɛ AH t AC ʃ AC l AD i AH
i̇zmir	i AH z AC m AE i AH ɾ AM
i̇zmirli	i AH z AC m AE i AH ɾ AM l AD i AH
jaguar	ʒ AC ɑ AH ɡ AC ʊ AJ ɑ AH ɾ AM
jartiyer	ʒ AC ɑ AH ɾ AM t AC i AH j AB e AH ɾ AM
jelatin	ʒ AC ɛ AH l AD a AH t AC i AH n AF
jilet	ʒ AC i AH ɫ AD e AH t AC
jonglör	ʒ AC ɔ AJ n AF ɡ AC l AD œ AJ ɾ AM
kaba	k AC a AH b AG a AH
kabalık	k AC a AH b AG a AH ɫ AD ɯ AH k AC
kabarık	k AC a AH b AG a AH ɾ AM ɯ AH k AC
kadınlık	k AC a AH d AC ɯ AH n AF ɫ AD ɯ AH k AC
kahve	k AC ɑ AH h AA v AG e AH
kahverengi	k AC ɑ AH h AA v AG e AH ɾ AM e AH ŋ AF ɡ AC i AH
kalamar	k AC ɑ AH ɫ AD ɑ AH m AE ɑ AH ɾ AM
kaldırım	k AC ɑ AH ɫ AD d AC ɯ AH r AL ɯ AH m AE
kale	k AC ɑ AH l AD e AH
kalleş	k AC a AH ɫ AD e AH ʃ AC
kalleşçe	k AC a AH ɫ AD e AH ʃ AC t AC ʃ AC e AH
kalp	k AC a AH l AD p AG
kalpak	k AC ɑ AH ɫ AD p AG ɑ AH k AC
kamçı	k AC ɑ AH m AE t AC ʃ AC ɯ AH
kanal	k AC a AH n AF a AH l AD
kanguru	k AC ɑ AH ŋ AF ɡ AC u AJ ɾ AM ʊ AJ
kantin	k AC ɑ AH n AF t AC i AH n AF
kanto	k AC ɑ AH n AF t AC ɔ AJ
kanun	k AC ɑː AI n AF u AJ n AF
kapakçık	k AC a AH p AG a AH k AC t AC ʃ AC ɯ AH c AC
kapasite	k AC a AH p AG a AH s AC i AH t AC e AH
kapasitede	k AC a AH p AG a AH s AC i AH t AC e AH d AC e AH
kapasiteden	k AC a AH p AG a AH s AC i AH t AC e AH d AC e AH n AF
kapasiteler	k AC a AH p AG a AH s AC i AH t AC e AH ɫ AD e AH ɾ AM
kapasitenin	k AC a AH p AG a AH s AC i AH t AC e AH n AF i AH n AF
kapasiteye	k AC a AH p AG a AH s AC i AH t AC e AH j AB e AH
kapasiteyi	k AC a AH p AG a AH s AC i AH t AC e AH j AB i AH
karadul	k AC ɑ AH ɾ AM ɑ AH d AC u AJ ɫ AD
karakalpakça	k AC ɑ AH ɾ AM ɑ AH k AC ɑ AH ɫ AD p AG ɑ AH k AC t AC ʃ AC ɑ AH
karakol	k AC ɑ AH ɾ AM ɑ AH k AC o AJ ɫ AD
karamel	k AC ɑ AH ɾ AM ɑ AH m AE e AH l AD
karanlık	k AC ɑ AH ɾ AM ɑ AH n AF ɫ AD ɯ AH k AC
kardelen	k AC ɑ AH ɾ AM d AC ɛ AH l AD e AH n AF
kardeş	k AC ɑ AH ɾ AM d AC e AH ʃ AC
kare	k AC a AH ɾ AM e AH
karides	k AC ɑ AH ɾ AM i AH d AC ɛ AH s AC
kars	k AC ɑ AH ɾ AM s AC
kartal	k AC ɑ AH ɾ AM t AC ɑ AH ɫ AD
karıncayiyen	k AC ɑ AH ɾ AM ɯ AH n AF d AC ʒ AC ɑ AH j AB i AH j AB e AH n AF
kas	k AC ɑ AH s AC
kasbilim	k AC a AH s AC b AG i AH l AD i AH m AE
kaside	k AC ɑ AH s AC iː AI d AC ɛ AH
katalog	k AC ɑ AH t AC ɑ AH ɫ AD ɔ AJ ɡ AC
katkı	k AC a AH t AC k AC ɯ AH
kavala	k AC ɑ AH v AG ɑ AH ɫ AD ɑ AH
kavim	k AC a AH v AG i AH m AE
kaya	k AC a AH j AB a AH
kaygı	k AC ɑ AH j AB ɡ AC ɯ AH
kaz	k AC ɑ AH z AC
kazak	k AC a AH z AC a AH k AC
kaçmak	k AC ɑ AH t AC ʃ AC m AE ɑ AH k AC
kaçırmak	k AC ɑ AH t AC ʃ AC ɯ AH ɾ AM m AE ɑ AH k AC
kağıt	c AC ɑ AH ɰ AB ɯ AH t AC
kaşar	k AC ɑ AH ʃ AC ɑ AH ɾ AM
kaşık	k AC a AH ʃ AC ɯ AH k AC
kederli	c AC ɛ AH d AC e AH ɾ AM l AD i AH
kefir	c AC ɛ AH f AG i AH ɾ AM
kehribar	c AC ɛ AH h AA ɾ AM i AH b AG ɑ AH ɾ AM
kelime	c AC e AH l AD i AH m AE e AH
kelimeler	c AC ɛ AH l AD i AH m AE ɛ AH l AD e AH ɾ AM
kelimenin	c AC e AH l AD i AH m AE e AH n AF i AH n AF
kelimeyi	c AC ɛ AH l AD i AH m AE ɛ AH j AB i AH
kellik	c AC e AH l AD l AD i AH c AC
keman	c AC ɛ AH m AE ɑ AH n AF
kemençe	c AC ɛ AH m AE e AH n AF t AC ʃ AC ɛ AH
kepek	c AC ɛ AH p AG ɛ AH c AC
kereviz	c AC ɛ AH ɾ AM ɛ AH β AG i AH z AC
keser	c AC e AH s AC e AH ɾ AM
keseri	c AC e AH s AC e AH ɾ AM i AH
keserler	c AC e AH s AC e AH ɾ AM l AD e AH ɾ AM
kesmek	c AC e AH s AC m AE e AH c AC
kesyap	k AC e AH s AC j AB a AH p AG
kiler	k AC i AH l AD e AH ɾ AM
kimi	c AC i AH m AE i AH
kir	c AC i AH ɾ AM
kireç	c AC i AH ɾ AM ɛ AH t AC ʃ AC
kirmen	c AC i AH ɾ AM m AE e AH n AF
kirpik	c AC ɪ AH ɾ AM p AG ɪ AH c AC
kitap	c AC i AH t AC a AH p AG
kitaplık	k AC i AH t AC a AH p AG ɫ AD ɯ AH k AC
kitapçık	k AC i AH t AC a AH p AG t AC ʃ AC ɯ AH c AC
kişi	c AC i AH ʃ AC ɪ AH
klarnet	k AC l AD a AH ɾ AM n AF ɛ AH t AC
klitoris	k AC l AD i AH t AC ɔ AJ ɾ AM i AH s AC
klişe	k AC l AD i AH ʃ AC ɛ AH
klor	k AC l AD o AJ ɾ AM
klorofil	k AC l AD o AJ ɾ AM o AJ f AG i AH l AD
kolaj	k AC o AJ ɫ AD a AH ʒ AC
kolay	k AC ɔ AJ ɫ AD ɑ AH j AB
kolaç	k AC o AJ ɫ AD a AH t AC ʃ AC
kolej	k AC o AJ l AD e AH ʒ AC
kolonya	k AC ɔ AJ l AD ɔ AJ n AF j AB ɑ AH
koltuk	k AC o AJ ɫ AD t AC u AJ k AC
komando	k AC ɔ AJ m AE ɑ AH n AF d AC o AJ
komikleşmek	k AC o AJ m AE i AH c AC l AD ɛ AH ʃ AC m AE ɛ AH c AC
konar	k AC o AJ n AF a AH ɾ AM
konmak	k AC o AJ n AF m AE a AH c AC
konmaz	k AC o AJ n AF m AE a AH z AC
konsey	k AC o AJ n AF s AC e AH j AB
konstantinopolis	k AC ɔ AJ n AF s AC t AC ɑ AH n AF t AC i AH n AF ɔ AJ p AG ɔ AJ l AD i AH s AC
kontes	k AC o AJ n AF t AC e AH s AC
konum	k AC o AJ n AF u AJ m AE
konun	k AC o AJ n AF u AJ n AF
konunun	k AC o AJ n AF u AJ n AF u AJ n AF
konusu	k AC o AJ n AF u AJ s AC u AJ
konuşmak	k AC o AJ n AF u AJ ʃ AC m AE ɑ AH k AC
koordinat	k AC o AJ o AJ ɾ AM d AC i AH n AF a AH t AC
koordinata	k AC o AJ o AJ ɾ AM d AC i AH n AF a AH t AC a AH
koordinatlar	k AC o AJ o AJ ɾ AM d AC i AH n AF a AH t AC ɫ AD a AH ɾ AM
koordinatlara	k AC o AJ o AJ ɾ AM d AC i AH n AF a AH t AC ɫ AD a AH ɾ AM a AH
koordinatlarda	k AC o AJ o AJ ɾ AM d AC i AH n AF a AH t AC ɫ AD a AH ɾ AM d AC a AH
koordinatlardan	k AC o AJ o AJ ɾ AM d AC i AH n AF a AH t AC ɫ AD a AH ɾ AM d AC a AH n AF
koordinatları	k AC o AJ o AJ ɾ AM d AC i AH n AF a AH t AC ɫ AD a AH ɾ AM ɯ AH
koordinatlarım	k AC o AJ o AJ ɾ AM d AC i AH n AF a AH t AC ɫ AD a AH ɾ AM ɯ AH m AE
koordinatların	k AC o AJ o AJ ɾ AM d AC i AH n AF a AH t AC ɫ AD a AH ɾ AM ɯ AH n AF
koordinatta	k AC o AJ o AJ ɾ AM d AC i AH n AF a AH t AC t AC a AH
koordinattan	k AC o AJ o AJ ɾ AM d AC i AH n AF a AH t AC t AC a AH n AF
koordinatı	k AC o AJ o AJ ɾ AM d AC i AH n AF a AH t AC ɯ AH
koordinatım	k AC o AJ o AJ ɾ AM d AC i AH n AF a AH t AC ɯ AH m AE
koordinatın	k AC o AJ o AJ ɾ AM d AC i AH n AF a AH t AC ɯ AH n AF
korimboz	k AC o AJ ɾ AM i AH m AE b AG o AJ z AC
korsan	k AC o AJ ɾ AM s AC a AH n AF
korse	k AC ɔ AJ ɾ AM s AC ɛ AH
kosinüs	k AC o AJ s AC i AH n AF y AJ s AC
kot	k AC ɔ AJ t AC
kotanjant	k AC o AJ t AC a AH n AF ʒ AC a AH n AF t AC
kova	k AC ɔ AJ v AG ɑ AH
koy	k AC o AJ j AB
koymak	k AC o AJ j AB m AE a AH k AC
koymamak	k AC o AJ j AB m AE a AH m AE a AH c AC
koza	k AC ɔ AJ z AC ɑ AH
koşmak	k AC ɔ AJ ʃ AC m AE ɑ AH k AC
koşturmak	k AC ɔ AJ ʃ AC t AC u AJ r AL m AE ɑ AH k AC
koşturtmak	k AC ɔ AJ ʃ AC t AC u AJ r AL m AE ɑ AH k AC
kraker	k AC ɾ AM ɑ AH k AC e AH ɾ AM
kral	k AC ɯ AH ɾ AM ɑ AH ɫ AD
kraliçe	k AC ɯ AH ɾ AM ɑ AH ɫ AD i AH t AC ʃ AC ɛ AH
krallık	k AC ɯ AH ɾ AM a AH ɫ AD ɫ AD ɯ AH k AC
kravat	k AC ɾ AM ɑ AH v AG ɑ AH t AC
krom	k AC ɾ AM o AJ m AE
kukla	k AC u AJ k AC l AD a AH
kuku	k AC u AJ k AC u AJ
kulakçık	k AC u AJ ɫ AD a AH k AC t AC ʃ AC ɯ AH c AC
kulaç	k AC u AJ ɫ AD a AH t AC ʃ AC
kulüp	k AC u AJ l AD y AJ p AG
kumanda	k AC u AJ m AE ɑ AH n AF d AC ɑ AH
kumaş	k AC u AJ m AE a AH ʃ AC
kural	k AC u AJ ɾ AM ɑ AH ɫ AD
kuram	k AC u AJ ɾ AM a AH m AE
kurban	k AC u AJ ɾ AM b AG a AH n AF
kurşun	k AC u AJ ɾ AM ʃ AC u AJ n AF
kutsallık	k AC u AJ t AC s AC a AH ɫ AD ɫ AD ɯ AH k AC
kuvantum	k AC u AJ v AG a AH n AF t AC u AJ m AE
kuvvet	k AC u AJ v AG v AG e AH t AC
kuvveti	k AC u AJ v AG v AG e AH t AC i AH
kuvvetim	k AC u AJ v AG v AG e AH t AC i AH m AE
kuvvetin	k AC u AJ v AG v AG e AH t AC i AH n AF
kuvvetler	k AC u AJ v AG v AG e AH t AC ɫ AD e AH ɾ AM
kuyruk	k AC u AJ j AB ɾ AM u AJ c AC
kuyruklu	k AC u AJ j AB r AL u AJ k AC ɫ AD u AJ
kuyruksuz	k AC u AJ j AB r AL u AJ k AC s AC u AJ z AC
kuzu	k AC u AJ z AC u AJ
kuzular	k AC u AJ z AC u AJ l AD a AH ɾ AM
kuşkonmaz	k AC u AJ ʃ AC k AC o AJ n AF m AE a AH z AC
kuşkonmazlar	k AC u AJ ʃ AC k AC o AJ n AF m AE a AH z AC ɫ AD a AH ɾ AM
kuşkonmazı	k AC u AJ ʃ AC k AC o AJ n AF m AE a AH z AC ɯ AH
kâbus	c AC aː AI b AG u AJ s AC
kâfir	c AC aː AI f AG i AH r AL
kâğıt	c AC ɑ AH ɰ AB ɯ AH t AC
köfte	c AC œ AJ f AG t AC ɛ AH
köpek	c AC ø AJ p AG e AH c AC
köpük	c AC œ AJ p AG y AJ c AC
kötüleşmek	c AC œ AJ t AC y AJ l AD ɛ AH ʃ AC m AE ɛ AH c AC
kötüleştirmek	c AC œ AJ t AC y AJ l AD ɛ AH ʃ AC t AC i AH ɾ AM m AE ɛ AH c AC
köy	k AC œ AJ j AB
köylü	k AC œ AJ j AB l AD y AJ
kükürt	c AC y AJ c AC y AJ ɾ AM t AC
külot	c AC ʏ AJ ɫ AD ɔ AJ t AC
kümes	c AC y AJ m AE ɛ AH s AC
künefe	c AC y AJ n AF e AH f AG ɛ AH
kürk	c AC y AJ ɾ AM c AC
küvet	c AC y AJ v AG ɛ AH t AC
kıble	k AC ɯ AH b AG l AD ɛ AH
kıbrıslı	k AC ɯ AH b AG ɾ AM ɯ AH s AC ɫ AD ɯ AH
kıllı	k AC ɯ AH ɫ AD ɫ AD ɯ AH
kılma	k AC ɯ AH ɫ AD m AE a AH
kılsız	k AC ɯ AH ɫ AD s AC ɯ AH z AC
kılıbık	k AC ɯ AH ɫ AD ɯ AH b AG ɯ AH k AC
kırbaç	k AC ɯ AH ɾ AM b AG ɑ AH t AC ʃ AC
kırım	k AC ɯ AH ɾ AM ɯ AH m AE
kırıtmak	k AC ɯ AH ɾ AM ɯ AH t AC m AE a AH k AC
kıyafet	k AC ɯ AH j AB ɑː AI f AG ɛ AH t AC
kıyma	k AC ɯ AH j AB m AE ɑ AH
kız	k AC ɯ AH z AC
laboratuvar	l AD a AH b AG ɔ AJ ɾ AM ɑ AH t AC u AJ β AG ɑ AH ɾ AM
lahana	l AD a AH h AA ɑ AH n AF ɑ AH
lahmacun	l AD a AH h AA m AE ɑː AI d AC ʒ AC ʊ AJ n AF
lakaytlık	l AD aː AI k AC a AH j AB t AC ɫ AD ɯ AH k AC
lala	ɫ AD ɑ AH ɫ AD ɑ AH
lastik	l AD a AH s AC t AC i AH k AC
laterna	l AD a AH t AC e AH ɾ AM n AF ɑ AH
lavaş	l AD ɑ AH v AG ɑ AH ʃ AC
layemut	ɫ AD aː AI j AB e AH m AE uː AK t AC
leblebi	l AD ɛ AH b AG l AD ɛ AH b AG i AH
leyla	l AD ɛ AH j AB ɫ AD ɑ AH
litvanca	l AD i AH t AC v AG ɑ AH n AF d AC ʒ AC ɑ AH
litvanyalı	l AD i AH t AC v AG ɑ AH n AF j AB ɑ AH ɫ AD ɯ AH
lityum	l AD i AH t AC j AB u AJ m AE
lokum	l AD ɔ AJ k AC ʊ AJ m AE
lolipop	l AD ɔ AJ l AD i AH p AG o AJ p AG
lord	ɫ AD o AJ ɾ AM d AC
lorda	ɫ AD o AJ ɾ AM d AC a AH
lordda	ɫ AD o AJ ɾ AM d AC d AC a AH
lorddan	ɫ AD o AJ ɾ AM d AC a AH n AF
lordlar	ɫ AD o AJ ɾ AM d AC ɫ AD a AH ɾ AM
lordu	ɫ AD o AJ ɾ AM d AC u AJ
lordum	ɫ AD o AJ ɾ AM d AC u AJ m AE
lordun	ɫ AD o AJ ɾ AM d AC u AJ n AF
lubunca	l AD u AJ b AG u AJ ɳ AF d AC ʒ AC ɑ AH
lubunyaca	l AD u AJ b AG u AJ ɳ AF j AB ɑ AH d AC ʒ AC ɑ AH
lunapark	l AD u AJ n AF ɑ AH p AG ɑ AH ɾ AM k AC
maalesef	m AE ɑː AI l AD e AH s AC e AH f AG
maaş	m AE ɑː AI ʃ AC
madalya	m AE a AH d AC a AH l AD j AB a AH
maden	m AE a AH d AC ɛ AH n AF
maestro	m AE aː AI e AH s AC t AC ɾ AM o AJ
magnezyum	m AE a AH ɡ AC n AF ɛ AH z AC j AB u AJ m AE
mahlep	m AE ɑ AH h AA l AD ɛ AH p AG
mahzen	m AE ɑ AH h AA z AC e AH n AF
makarna	m AE ɑ AH k AC ɑ AH ɾ AM n AF ɑ AH
makta	m AE ɑ AH k AC t AC ɑː AI
makul	m AE aː AI k AC u AJ ɫ AD
makyaj	m AE a AH k AC j AB a AH ʒ AC
malt	m AE a AH l AD t AC
mancınık	m AE ɑ AH n AF d AC ʒ AC ɯ AH n AF ɯ AH k AC
mandalina	m AE ɑ AH n AF d AC ɑ AH l AD i AH n AF ɑ AH
manganez	m AE a AH n AF ɟ AC a AH n AF e AH z AC
manyetik	m AE ɑ AH n AF j AB e AH t AC i AH k AC
marmelat	m AE a AH ɾ AM m AE e AH l AD a AH t AC
masa	m AE a AH s AC a AH
masajlar	m AE ɑ AH s AC ɑ AH ʒ AC l AD a AH ɾ AM
masajı	m AE ɑ AH s AC ɑ AH ʒ AC ɯ AH
maskara	m AE ɑ AH s AC k AC ɑ AH ɾ AM ɑ AH
maskulen	m AE ɑ AH s AC k AC ʊ AJ l AD e AH n AF
mastürbasyon	m AE a AH s AC t AC y AJ ɾ AM b AG a AH s AC j AB o AJ n AF
masumiyet	m AE ɑː AI s AC ʊ AJ m AE i AH j AB ɛ AH t AC
matla	m AE ɑ AH t AC ɫ AD ɑː AI
matruşka	m AE a AH t AC ɾ AM u AJ ʃ AC k AC a AH
mavi	m AE ɑː AI v AG i AH
maya	m AE ɑ AH j AB ɑ AH
maymun	m AE a AH j AB m AE u AJ n AF
maymunlar	m AE a AH j AB m AE u AJ n AF ɫ AD a AH ɾ AM
maymunu	m AE a AH j AB m AE u AJ n AF u AJ
mayo	m AE ɑ AH j AB ɔ AJ
mazot	m AE a AH z AC o AJ t AC
mazotlar	m AE a AH z AC o AJ t AC ɫ AD a AH ɾ AM
mazotu	m AE a AH z AC o AJ t AC u AJ
maça	m AE ɑ AH t AC ʃ AC ɑ AH
maço	m AE ɑ AH t AC ʃ AC o AJ
maşa	m AE a AH ʃ AC a AH
maşrapa	m AE a AH ʃ AC r AL a AH p AG a AH
medrese	m AE ɛ AH d AC ɾ AM ɛ AH s AC ɛ AH
mefhum	m AE e AH f AG h AA u AJ m AE
mefhumlar	m AE e AH f AG h AA u AJ m AE ɫ AD a AH ɾ AM
mefhumu	m AE e AH f AG h AA uː AK m AE u AJ
mefhumum	m AE e AH f AG h AA uː AK m AE u AJ m AE
mefhumun	m AE e AH f AG h AA uː AK m AE u AJ n AF
mekik	m AE e AH k AC i AH c AC
meksikalı	m AE ɛ AH c AC s AC i AH k AC ɑ AH ɫ AD ɯ AH
melis	m AE ɛ AH l AD i AH s AC
melisa	m AE ɛ AH l AD i AH s AC ɑ AH
menemen	m AE e AH n AF e AH m AE e AH n AF
menfi	m AE e AH n AF f AG iː AI
meni	m AE ɛ AH n AF i AH
menteşe	m AE ɛ AH n AF t AC ɛ AH ʃ AC ɛ AH
merkez	m AE e AH r AL k AC e AH z AC
mermi	m AE e AH ɾ AM m AE i AH
mesaj	m AE ɛ AH s AC ɑ AH ʒ AC
mesajlar	m AE ɛ AH s AC ɑ AH ʒ AC l AD a AH ɾ AM
mesajı	m AE ɛ AH s AC ɑ AH ʒ AC ɯ AH
metrdotel	m AE ɛ AH t AC ɾ AM d AC o AJ t AC ɛ AH l AD
meyhane	m AE ɛ AH j AB h AA ɑː AI n AF ɛ AH
meşale	m AE ɛ AH ʃ AC ɑː AI l AD ɛ AH
meşhur	m AE e AH ʃ AC h AA u AJ ɾ AM
mihrap	m AE i AH h AA ɾ AM ɑ AH p AG
mikrofon	m AE i AH k AC ɾ AM o AJ f AG o AJ n AF
mikronezyalı	m AE i AH c AC ɾ AM ɔ AJ n AF ɛ AH z AC j AB ɑ AH ɫ AD ɯ AH
minare	m AE i AH n AF ɑː AI ɾ AM ɛ AH
minber	m AE i AH n AF b AG e AH ɾ AM
misket	m AE i AH s AC c AC ɛ AH t AC
miskin	m AE i AH s AC c AC i AH n AF
miyoloji	m AE i AH j AB o AJ l AD o AJ ʒ AC i AH
miyop	m AE i AH j AB o AJ p AG
moldovalı	m AE ɔ AJ ɫ AD d AC ɔ AJ v AG ɑ AH ɫ AD ɯ AH
monarşi	m AE o AJ n AF a AH ɾ AM ʃ AC i AH
monolog	m AE o AJ n AF o AJ ɫ AD o AJ ɟ AC
monologlar	m AE o AJ n AF o AJ ɫ AD o AJ ɟ AC ɫ AD ɑ AH r AL
monoloğu	m AE o AJ n AF o AJ ɫ AD o AJ ɰ AB u AJ
monoloğum	m AE o AJ n AF o AJ ɫ AD o AJ ɰ AB u AJ m AE
monoloğun	m AE o AJ n AF o AJ ɫ AD o AJ ɰ AB u AJ n AF
moron	m AE o AJ ɾ AM o AJ n AF
moskovalı	m AE ɔ AJ s AC k AC ɔ AJ v AG ɑ AH ɫ AD ɯ AH
motorin	m AE o AJ t AC o AJ ɾ AM i AH n AF
motorini	m AE o AJ t AC o AJ r AL i AH n AF i AH
motorinler	m AE o AJ t AC o AJ r AL i AH n AF ɫ AD e AH ɾ AM
mucize	m AE uː AK d AC ʒ AC i AH z AC ɛ AH
mumluk	m AE u AJ m AE ɫ AD u AJ k AC
mumya	m AE u AJ m AE j AB ɑ AH
muson	m AE u AJ s AC o AJ n AF
mutfak	m AE u AJ t AC f AG ɑ AH k AC
mutluluk	m AE u AJ t AC ɫ AD u AJ ɫ AD u AJ k AC
muzaffer	m AE u AJ z AC a AH f AG f AG æ AH ɾ AM
müdür	m AE y AJ d AC y AJ r AL
müge	m AE y AJ ɟ AC ɛ AH
müsaade	m AE y AJ s AC ɑː AI d AC e AH
müsait	m AE ʏ AJ s AC ɑː AI i AH t AC
müspet	m AE y AJ s AC p AG e AH t AC
müttehit	m AE y AJ t AC t AC e AH h AA i AH t AC
müzik	m AE y AJ z AC ɪ AH k AC
müşteri	m AE y AJ ʃ AC t AC ɛ AH ɾ AM i AH
mıh	m AE ɯ AH h AA
mısra	m AE ɯ AH s AC ɾ AM aː AI
mısır	m AE ɯ AH s AC ɯ AH ɾ AM
nagasaki	n AF ɑ AH ɡ AC ɑ AH z AC ɑː AI c AC i AH
namaz	n AF ɑ AH m AE ɑ AH z AC
namüsait	n AF ɑː AI m AE ʏ AJ s AC ɑː AI i AH t AC
nargile	n AF ɑ AH ɾ AM ɟ AC i AH l AD ɛ AH
nasıl	n AF ɑ AH s AC ɯ AH ɫ AD
nasılsın	n AF ɑ AH s AC ɯ AH ɫ AD s AC ɯ AH n AF
nasılsınız	n AF ɑ AH s AC ɯ AH ɫ AD s AC ɯ AH n AF ɯ AH z AC
nazen	n AF a AH z AC e AH n AF
nazenin	n AF a AH z AC e AH n AF i AH n AF
neden	n AF ɛ AH d AC æ AH n AF
neon	n AF ɛ AH o AJ n AF
neredeyse	n AF e AH r AL e AH d AC e AH j AB s AC e AH
nergis	n AF e AH ɾ AM ɟ AC i AH z AC
neyse	n AF ɛ AH j AB s AC ɛ AH
nice	n AF i AH d AC ʒ AC e AH
nihayet	n AF i AH h AA ɑː AI j AB ɛ AH t AC
nikel	n AF i AH c AC ɛ AH l AD
nilüfer	n AF i AH l AD y AJ f AG e AH ɾ AM
nohut	n AF ɔ AJ h AA ʊ AJ t AC
noktürn	n AF o AJ k AC t AC y AJ r AL n AF
noktürnler	n AF o AJ k AC t AC y AJ r AL n AF ɫ AD e AH ɾ AM
noktürnü	n AF o AJ k AC t AC y AJ r AL n AF y AJ
noktürnüm	n AF o AJ k AC t AC y AJ r AL n AF y AJ m AE
noktürnün	n AF o AJ k AC t AC y AJ r AL n AF y AJ n AF
notilus	n AF ɔ AJ t AC i AH ɫ AD ʊ AJ s AC
okiya	ɔ AJ c AC ɪ AH j AB ɑ AH
okul	o AJ k AC u AJ ɫ AD
okunaklı	o AJ k AC u AJ n AF a AH k AC ɫ AD ɯ AH
okunaklılık	o AJ k AC u AJ n AF a AH k AC ɫ AD ɯ AH ɫ AD ɯ AH k AC
okunaksız	o AJ k AC u AJ n AF a AH k AC s AC ɯ AH z AC
okunaksızlık	o AJ k AC u AJ n AF a AH k AC s AC ɯ AH z AC ɫ AD ɯ AH k AC
okçu	o̞ AJ k AC t AC ʃ AC u AJ
olay	ɔ AJ ɫ AD ɑ AH j AB
oligarşi	o AJ l AD i AH ɟ AC a AH ɾ AM ʃ AC i AH
olmak	o AJ ɫ AD m AE a AH k AC
olta	ɔ AJ ɫ AD t AC ɑ AH
olumlu	o AJ ɫ AD u AJ m AE ɫ AD u AJ
olumluluk	o AJ ɫ AD u AJ m AE ɫ AD u AJ ɫ AD u AJ c AC
olumsuz	o AJ ɫ AD u AJ m AE s AC u AJ z AC
olumsuzluk	o AJ ɫ AD u AJ m AE s AC u AJ z AC ɫ AD u AJ c AC
ongen	o AJ n AF ɟ AC e AH n AF
orta	o AJ ɾ AM t AC a AH
ortam	o AJ ɾ AM t AC a AH m AE
orçun	ɔ AJ ɾ AM t AC ʃ AC u AJ n AF
ot	ɔ AJ t AC
otizm	ɔ AJ t AC i AH z AC m AE
oto	ɔ AJ t AC ɔ AJ
otocu	o AJ t AC o AJ d AC ʒ AC u AJ
otocular	o AJ t AC o AJ d AC ʒ AC u AJ ɫ AD a AH ɾ AM
otoculuk	o AJ t AC o AJ d AC ʒ AC u AJ ɫ AD u AJ c AC
otoculuklar	o AJ t AC o AJ d AC ʒ AC u AJ ɫ AD u AJ k AC ɫ AD a AH ɾ AM
otoculuğu	o AJ t AC o AJ d AC ʒ AC u AJ ɫ AD u AJ ɰ AB u AJ
otoculuğum	o AJ t AC o AJ d AC ʒ AC u AJ ɫ AD u AJ ɰ AB u AJ
otoculuğun	o AJ t AC o AJ d AC ʒ AC u AJ ɫ AD u AJ ɰ AB u AJ n AF
otocunun	o AJ t AC o AJ d AC ʒ AC u AJ n AF u AJ n AF
otocuyu	o AJ t AC o AJ d AC ʒ AC u AJ y AJ u AJ
otogar	ɔ AJ t AC ɔ AJ ɡ AC ɑ AH ɾ AM
otom	o AJ t AC o AJ m AE
otomobil	o AJ t AC o AJ m AE o AJ b AG i AH ɫ AD
otomobilci	o AJ t AC o AJ m AE o AJ b AG i AH ɫ AD d AC ʒ AC i AH
otomobilciler	o AJ t AC o AJ m AE o AJ b AG i AH ɫ AD d AC ʒ AC i AH ɫ AD e AH ɾ AM
otomobilcilik	o AJ t AC o AJ m AE o AJ b AG i AH ɫ AD d AC ʒ AC i AH ɫ AD i AH c AC
otomobilcilikler	o AJ t AC o AJ m AE o AJ b AG i AH ɫ AD d AC ʒ AC i AH ɫ AD i AH k AC ɫ AD e AH ɾ AM
otomobilciliği	o AJ t AC o AJ m AE o AJ b AG i AH ɫ AD d AC ʒ AC i AH ɫ AD i AH ɰ AB i AH
otomobilciliğim	o AJ t AC o AJ m AE o AJ b AG i AH ɫ AD d AC ʒ AC i AH ɫ AD i AH ɰ AB i AH m AE
otomobilciliğin	o AJ t AC o AJ m AE o AJ b AG i AH ɫ AD d AC ʒ AC i AH ɫ AD i AH ɰ AB i AH n AF
otomobilcim	o AJ t AC o AJ m AE o AJ b AG i AH ɫ AD d AC ʒ AC i AH m AE
otomobilcin	o AJ t AC o AJ m AE o AJ b AG i AH ɫ AD d AC ʒ AC i AH n AF
otomobilcinin	o AJ t AC o AJ m AE o AJ b AG i AH ɫ AD d AC ʒ AC i AH n AF i AH n AF
otomobilcisi	o AJ t AC o AJ m AE o AJ b AG i AH ɫ AD d AC ʒ AC i AH s AC i AH
otomobilciyi	o AJ t AC o AJ m AE o AJ b AG i AH ɫ AD d AC ʒ AC i AH ɫ AD i AH c AC j AB i AH
otomobili	o AJ t AC o AJ m AE o AJ b AG i AH ɫ AD i AH
otomobilim	o AJ t AC o AJ m AE o AJ b AG i AH ɫ AD i AH m AE
otomobilin	o AJ t AC o AJ m AE o AJ b AG i AH ɫ AD i AH n AF
otomobiller	o AJ t AC o AJ m AE o AJ b AG i AH ɫ AD ɫ AD e AH ɾ AM
oton	o AJ t AC o AJ n AF
otonun	o AJ t AC o AJ n AF u AJ n AF
otostop	ɔ AJ t AC ɔ AJ s AC t AC ɔ AJ p AG
otostopçu	ɔ AJ t AC ɔ AJ s AC t AC ɔ AJ p AG t AC ʃ AC ʊ AJ
otosu	o AJ t AC o AJ s AC u AJ
oymak	o AJ j AB m AE a AH c AC
oymamak	o AJ j AB m AE a AH m AE a AH c AC
oyun	o AJ j AB u AJ n AF
oyunculuk	o AJ j AB u AJ n AF d AC ʒ AC u AJ ɫ AD u AJ k AC
oyunlar	o AJ j AB u AJ n AF l AD a AH ɾ AM
palavra	p AG ɑ AH ɫ AD ɑ AH v AG ɾ AM ɑ AH
palikarya	p AG a AH l AD i AH k AC ɑ AH ɾ AM j AB ɑ AH
palmiye	p AG a AH l AD m AE i AH j AB ɛ AH
panamalı	p AG ɑ AH n AF ɑ AH m AE ɑ AH ɫ AD ɯ AH
pancar	p AG ɑ AH n AF d AC ʒ AC ɑ AH ɾ AM
panda	p AG a AH n AF d AC a AH
pandispanya	p AG ɑ AH n AF d AC i AH s AC p AG ɑ AH n AF j AB ɑ AH
papirüs	p AG ɑ AH p AG i AH ɾ AM y AJ s AC
papyon	p AG ɑ AH p AG j AB ɔ AJ n AF
parabol	p AG ɑ AH ɾ AM ɑ AH b AG ɔ AJ l AD
paralelkenar	p AG a AH ɾ AM a AH l AD e AH l AD k AC e AH n AF a AH ɾ AM
parasızlık	p AG a AH ɾ AM a AH s AC ɯ AH z AC ɫ AD ɯ AH k AC
paris	p AG ɑː AI ɾ AM i AH s AC
parlatmak	p AG ɑ AH ɾ AM ɫ AD ɑ AH t AC m AE ɑ AH k AC
parlatıcı	p AG ɑ AH ɾ AM ɫ AD ɑ AH t AC ɯ AH d AC ʒ AC ɯ AH
paten	p AG ɑ AH t AC e AH n AF
patik	p AG a AH t AC i AH c AC
pay	p AG a AH j AB
payda	p AG a AH j AB d AC a AH
paydalar	p AG a AH j AB d AC a AH ɫ AD a AH ɾ AM
paydayı	p AG a AH j AB d AC a AH j AB ɯ AH
paylamaz	p AG a AH j AB ɫ AD a AH m AE a AH z AC
paylar	p AG a AH j AB ɫ AD a AH ɾ AM
payı	p AG a AH j AB ɯ AH
payım	p AG a AH j AB ɯ AH m AE
payın	p AG a AH j AB ɯ AH n AF
paşa	p AG ɑ AH ʃ AC ɑ AH
peder	p AG ɛ AH d AC e AH ɾ AM
pelin	p AG e AH l AD i AH n AF
pencere	p AG e AH n AF d AC ʒ AC e AH ɾ AM e AH
perende	p AG e AH r AL æ AH n AF d AC ɛ AH
perestroyka	p AG e AH ɾ AM e AH s AC t AC ɾ AM o AJ j AB k AC ɑ AH
peynir	p AG ɛ AH j AB n AF i AH ɾ AM
pezevenk	p AG e AH z AC e AH v AG e AH ɳ AF c AC
pijama	p AG ɪ AH ʒ AC ɑ AH m AE ɑ AH
pipi	p AG i AH p AG i AH
piramit	p AG i AH ɾ AM a AH m AE i AH t AC
polinom	p AG ɔ AJ l AD i AH n AF ɔ AJ m AE
politikacı	p AG ɔ AJ l AD i AH t AC i AH k AC ɑ AH d AC ʒ AC ɯ AH
pompa	p AG o AJ m AE p AG a AH
porno	p AG o AJ ɾ AM n AF o AJ
portekizli	p AG ɔ AJ ɾ AM t AC ɛ AH c AC i AH z AC l AD i AH
post	p AG o AJ s AC t AC
prenses	p AG ɾ AM ɛ AH n AF s AC e̞ AH s AC
prensip	p AG ɾ AM e AH n AF s AC i AH p AG
psikiyatr	p AG s AC i AH k AC i AH j AB a AH t AC ɾ AM
psikiyatrist	p AG s AC i AH k AC i AH j AB a AH t AC ɾ AM i AH s AC t AC
psikolog	p AG s AC i AH k AC ɔ AJ l AD ɔ AJ ɡ AC
psikoloji	p AG s AC i AH k AC ɔ AJ l AD ɔ AJ ʒ AC i AH
psikosomatik	p AG s AC i AH c AC ɔ AJ s AC ɔ AJ m AE ɑ AH t AC i AH c AC
psikoterapi	p AG s AC i AH k AC ɔ AJ t AC ɛ AH ɾ AM ɑ AH p AG i AH
puan	p AG u AJ ɑ AH n AF
pyongyang	p AG j AB o AJ n AF ɡ AC j AB a AH n AF ɡ AC
rahat	ɾ AM ɑ AH h AA ɑ AH t AC
rakam	ɾ AM ɑ AH k AC ɑ AH m AE
raket	ɾ AM a AH k AC e AH t AC
rakı	ɾ AM ɑ AH k AC ɯ AH
ranza	r AL ɑ AH n AF z AC ɑ AH
rağmen	r AL aː AI m AE ɛ AH n AF
rebetiko	ɾ AM ɛ AH b AG ɛ AH t AC i AH k AC ɔ AJ
rehine	ɾ AM ɛ AH h AA iː AI n AF ɛ AH
renk	ɾ AM e AH ŋ AF k AC
reçel	ɾ AM e AH t AC ʃ AC e AH l AD
riboz	ɾ AM i AH b AG o AJ z AC
rimel	ɾ AM i AH m AE e AH l AD
ritüel	ɾ AM i AH t AC y AJ e AH l AD
roket	ɾ AM o AJ k AC e AH t AC
ruj	ɾ AM u AJ ʒ AC
rumca	ɾ AM ʊ AJ m AE d AC ʒ AC ɑ AH
rüya	ɾ AM ʏ AJ j AB ɑː AI
sabit	s AC ɑː AI b AG i AH t AC
sabırlı	s AC ɑ AH b AG ɯ AH ɾ AM ɫ AD ɯ AH
saga	s AC ɑ AH ɡ AC ɑ AH
sahip	s AC ɑː AI h AA i AH p AG
saka	s AC a AH k AC a AH
saksafon	s AC ɑ AH k AC s AC ɑ AH f AG ɔ AJ n AF
saksı	s AC ɑ AH k AC s AC ɯ AH
sakız	s AC a AH k AC ɯ AH z AC
salak	s AC ɑ AH l AD ɑ AH k AC
salıncak	s AC ɑ AH ɫ AD ɯ AH n AF d AC ʒ AC ɑ AH k AC
saman	s AC a AH m AE a AH n AF
samuray	s AC a AH m AE u AJ ɾ AM a AH j AB
sanat	s AC ɑ AH n AF ɑ AH t AC
sansar	s AC ɑ AH n AF s AC ɑ AH ɾ AM
sapan	s AC ɑ AH p AG ɑ AH n AF
sapıkça	s AC ɑ AH p AG ɯ AH k AC t AC ʃ AC ɑ AH
sarmal	s AC a AH ɾ AM m AE a AH ɫ AD
sarmaşık	s AC a AH ɾ AM m AE a AH ʃ AC ɯ AH k AC
sarılmak	s AC ɑ AH ɾ AM ɯ AH ɫ AD m AE ɑ AH k AC
sarımsak	s AC a AH ɾ AM ɯ AH m AE s AC a AH k AC
savaşçı	s AC ɑ AH β AG ɑ AH ʃ AC t AC ʃ AC ɯ AH
sayfa	s AC ɑ AH j AB f AG ɑ AH
saçma	s AC ɑ AH t AC ʃ AC m AE ɑ AH
saçmalık	s AC ɑ AH t AC ʃ AC m AE ɑ AH ɫ AD ɯ AH k AC
sağ	s AC aː AI
sağlam	s AC ɑ AH ɰ AB ɫ AD ɑ AH m AE
sağrı	s AC ɑ AH ɰ AB ɾ AM ɯ AH
sağım	s AC a AH ɰ AB ɯ AH m AE
seccade	s AC ɛ AH d AC ʒ AC d AC ʒ AC ɑː AI d AC ɛ AH
seher	s AC e AH h AA e AH r AL
sekizgen	s AC e AH k AC i AH z AC ɟ AC e AH n AF
sekreter	s AC e AH k AC ɾ AM e AH t AC e AH ɾ AM
selanik	s AC e AH l AD aː AI n AF i AH c AC
semer	s AC ɛ AH m AE e AH ɾ AM
semerci	s AC ɛ AH m AE e AH ɾ AM d AC ʒ AC i AH
sen	s AC æ AH n AF
senkretizm	s AC ɛ AH n AF k AC ɾ AM ɛ AH t AC i AH z AC m AE
sepet	s AC ɛ AH p AG ɛ AH t AC
serçe	s AC e AH ɾ AM t AC ʃ AC ɛ AH
sessizlik	s AC ɛ AH s AC s AC i AH z AC l AD i AH c AC
sevda	s AC e AH β AG d AC ɑ AH
sevdalinka	s AC ɛ AH v AG d AC ɑː AI l AD i AH ɳ AF k AC ɑ AH
seven	s AC e AH v AG e AH n AF
sevgili	s AC e AH β AG ɟ AC i AH l AD i AH
sevilen	s AC e AH v AG i AH ɫ AD e AH n AF
sevilmek	s AC e AH v AG i AH ɫ AD m AE e AH c AC
sevilmemek	s AC e AH v AG i AH ɫ AD m AE e AH m AE e AH c AC
sevilmeyen	s AC e AH v AG i AH ɫ AD m AE e AH j AB e AH n AF
sevinmek	s AC e AH v AG i AH n AF m AE e AH c AC
sevişmek	s AC e AH v AG i AH ʃ AC m AE e AH c AC
sevmek	s AC e AH v AG m AE e AH c AC
seyahat	s AC e AH j AB ɑ AH h AA ɑ AH t AC
seçer	s AC e AH t AC ʃ AC e AH r AL
seçilebilir	s AC e AH t AC ʃ AC i AH ɫ AD e AH b AG i AH ɫ AD i AH ɾ AM
seçilemez	s AC e AH t AC ʃ AC i AH ɫ AD e AH m AE e AH z AC
seçilir	s AC e AH t AC ʃ AC i AH ɫ AD i AH r AL
seçilmez	s AC e AH t AC ʃ AC i AH ɫ AD m AE e AH z AC
seçmek	s AC e AH t AC ʃ AC m AE e AH c AC
seçmemek	s AC e AH t AC ʃ AC m AE e AH m AE e AH c AC
seçmez	s AC e AH t AC ʃ AC m AE e AH z AC
sidik	s AC i AH d AC i AH c AC
sigara	s AC ɪ AH ɡ AC ɑ AH ɾ AM ɑ AH
sik	s AC i AH c AC
sikilmek	s AC i AH c AC i AH l AD m AE ɛ AH c AC
sikmek	s AC i AH c AC m AE ɛ AH c AC
silgi	s AC i AH l AD ɟ AC i AH
silindir	s AC i AH l AD i AH n AF d AC i AH ɾ AM
silisyum	s AC i AH l AD i AH s AC j AB u AJ m AE
simya	s AC i AH m AE j AB aː AI
sincap	s AC i AH n AF d AC ʒ AC ɑ AH p AG
sindirim	s AC i AH n AF d AC i AH ɾ AM i AH m AE
sinem	s AC i AH n AF e AH m AE
singapurlu	s AC i AH ɳ AF ɡ AC ɑ AH p AG u AJ ɾ AM ɫ AD u AJ
sinir	s AC i AH n AF i AH ɾ AM
sinirlendirici	s AC i AH n AF i AH ɾ AM ɫ AD e AH n AF d AC i AH ɾ AM i AH d AC ʒ AC i AH
sinirlendirmeyici	s AC i AH n AF i AH ɾ AM ɫ AD e AH n AF d AC i AH ɾ AM m AE e AH j AB i AH d AC ʒ AC i AH
sinirli	s AC i AH n AF i AH r AL l AD i AH
sinirsiz	s AC i AH n AF i AH r AL s AC i AH z AC
sinüs	s AC i AH n AF y AJ s AC
sistemi	s AC i AH s AC t AC e AH m AE i AH
sistemim	s AC i AH s AC t AC e AH m AE i AH m AE
sistemin	s AC i AH s AC t AC e AH m AE i AH n AF
sistemini	s AC i AH s AC t AC e AH m AE i AH n AF i AH
sistemler	s AC i AH s AC t AC e AH ɫ AD e AH ɾ AM
sistemli	s AC i AH s AC t AC e AH m AE ɫ AD i AH
sistemsiz	s AC i AH s AC t AC e AH m AE s AC i AH z AC
site	s AC i AH t AC e AH
sivil	s AC i AH v AG i AH l AD
sivilce	s AC i AH v AG i AH l AD d AC ʒ AC ɛ AH
sivrisinek	s AC i AH v AG ɾ AM i AH s AC i AH n AF ɛ AH c AC
siyasetçi	s AC i AH j AB ɑː AI s AC ɛ AH t AC t AC ʃ AC i AH
skrotum	s AC ɯ AH k AC ɾ AM o AJ t AC u AJ m AE
smiley	s AC m AE a AH j AB l AD e AH j AB
sofyalı	s AC ɔ AJ f AG j AB ɑ AH ɫ AD ɯ AH
sokak	s AC ɔ AJ k AC ɑ AH k AC
sol	s AC ɔ AJ ɫ AD
solmak	s AC ɔ AJ ɫ AD m AE ɑ AH k AC
sonbahar	s AC ɔ AJ n AF b AG ɑ AH h AA ɑ AH ɾ AM
sonsuzluk	s AC o AJ n AF s AC u AJ z AC ɫ AD u AJ k AC
sormak	s AC o AJ ɾ AM m AE a AH k AC
sorumlu	s AC o AJ ɾ AM u AJ m AE ɫ AD u AJ
sorumluluk	s AC o AJ ɾ AM u AJ m AE ɫ AD u AJ ɫ AD u AJ k AC
sorumsuz	s AC o AJ ɾ AM u AJ m AE s AC u AJ z AC
sorumsuzluk	s AC o AJ ɾ AM u AJ m AE s AC u AJ z AC ɫ AD u AJ k AC
sosyolog	s AC o AJ s AC j AB o AJ ɫ AD o AJ ɟ AC
sosyoloji	s AC o AJ s AC j AB o AJ l AD o AJ ʒ AC i AH
soygaz	s AC ɔ AJ j AB ɡ AC ɑ AH z AC
soylu	s AC o AJ j AB l AD u AJ
spam	s AC p AG a AH m AE
spamcıl	s AC p AG a AH m AE d AC ʒ AC ɯ AH ɫ AD
sporcu	s AC p AG ɔ AJ ɾ AM d AC ʒ AC ʊ AJ
sporcular	s AC p AG ɔ AJ ɾ AM d AC ʒ AC ʊ AJ ɫ AD a AH ɾ AM
sporcum	s AC p AG ɔ AJ ɾ AM d AC ʒ AC ʊ AJ m AE
sporcun	s AC p AG ɔ AJ ɾ AM d AC ʒ AC ʊ AJ n AF
sporcunun	s AC p AG ɔ AJ ɾ AM d AC ʒ AC ʊ AJ n AF ʊ AJ n AF
sporcusu	s AC p AG ɔ AJ ɾ AM d AC ʒ AC ʊ AJ s AC ʊ AJ
sporcuyu	s AC p AG ɔ AJ ɾ AM d AC ʒ AC ʊ AJ j AB ʊ AJ
stant	s AC t AC a AH n AF t AC
start	s AC t AC a AH ɾ AM t AC
su	s AC u AJ
sucuk	s AC u AJ d AC ʒ AC u AJ k AC
sucuklar	s AC u AJ d AC ʒ AC u AJ c AC l AD a AH ɾ AM
supap	s AC u AJ p AG a AH p AG
susuz	s AC u AJ s AC u AJ z AC
susuzluk	s AC u AJ s AC u AJ z AC ɫ AD u AJ k AC
sutyen	s AC u AJ t AC j AB e AH n AF
suçlamak	s AC u AJ t AC ʃ AC l AD a AH m AE a AH k AC
söyleniş	s AC ø AJ j AB l AD ɛ AH n AF i AH ʃ AC
söz	s AC ø AJ z AC
sözcük	s AC œ AJ z AC d AC ʒ AC y AJ c AC
sözlük	s AC œ AJ z AC l AD y AJ k AC
sülfür	s AC y AJ l AD f AG y AJ ɾ AM
sülük	s AC y AJ l AD y AJ c AC
sümük	s AC ʏ AJ m AE ʏ AJ c AC
sünger	s AC y AJ ɳ AF ɟ AC e AH ɾ AM
sürdürebilirlik	s AC y AJ ɾ AM d AC y AJ ɾ AM e AH b AG i AH l AD i AH ɾ AM l AD i AH c AC
sürdürmek	s AC y AJ ɾ AM d AC y AJ ɾ AM m AE e AH c AC
sürdürmemek	s AC y AJ ɾ AM d AC y AJ ɾ AM m AE e AH m AE e AH c AC
sürdürülebilirlik	s AC y AJ ɾ AM d AC y AJ ɾ AM y AJ ɫ AD e AH b AG i AH l AD i AH ɾ AM l AD i AH c AC
süreklilik	s AC y AJ ɾ AM ɛ AH c AC l AD i AH l AD i AH c AC
sürgün	s AC ʏ AJ ɾ AM ɟ AC ʏ AJ n AF
sürmemek	s AC y AJ ɾ AM m AE e AH m AE e AH c AC
sürpriz	s AC y AJ ɾ AM p AG ɾ AM i AH z AC
sürtük	s AC y AJ r AL t AC y AJ c AC
sürücü	s AC y AJ ɾ AM y AJ d AC ʒ AC y AJ
sürülmek	s AC y AJ ɾ AM y AJ l AD m AE e AH c AC
sürülmemek	s AC y AJ ɾ AM y AJ l AD m AE e AH m AE e AH c AC
sürüm	s AC y AJ ɾ AM y AJ m AE
sürümde	s AC y AJ ɾ AM y AJ m AE d AC e AH
sürümden	s AC y AJ ɾ AM y AJ m AE d AC e AH n AF
sürüme	s AC y AJ ɾ AM y AJ m AE e AH
sürümler	s AC y AJ ɾ AM y AJ m AE ɫ AD e AH ɾ AM
sürümü	s AC y AJ ɾ AM y AJ m AE y AJ
sürümüm	s AC y AJ ɾ AM y AJ m AE y AJ m AE
sürümün	s AC y AJ ɾ AM y AJ m AE y AJ n AF
sürüngen	s AC ʏ AJ ɾ AM ʏ AJ ɳ AF ɟ AC e AH n AF
süt	s AC y AJ t AC
sütyen	s AC ʏ AJ t AC j AB e AH n AF
süzme	s AC y AJ z AC m AE e AH
süzmek	s AC y AJ z AC m AE e AH c AC
sıcaklık	s AC ɯ AH d AC ʒ AC ɑ AH k AC ɫ AD ɯ AH k AC
sıfat	s AC ɯ AH f AG a AH t AC
sıfatlar	s AC ɯ AH f AG a AH t AC l AD a AH r AL
sıfatı	s AC ɯ AH f AG a AH t AC ɯ AH
sıhhi	s AC ɯ AH h AA h AA iː AI
sıkmak	s AC ɯ AH k AC m AE a AH k AC
sıkıntı	s AC ɯ AH k AC ɯ AH n AF t AC ɯ AH
sıkıntılar	s AC ɯ AH c AC ɾ AM ɯ AH n AF t AC ɯ AH l AD a AH ɾ AM
sıkıntıyı	s AC ɯ AH k AC ɯ AH n AF t AC ɯ AH j AB ɯ AH
sınav	s AC ɯ AH n AF a AH β AG
sınır	s AC ɯ AH n AF ɯ AH ɾ AM
sınırdaş	s AC ɯ AH n AF ɯ AH ɾ AM d AC a AH ʃ AC
sınırlı	s AC ɯ AH n AF ɯ AH r AL l AD ɯ AH
sınırsız	s AC ɯ AH n AF ɯ AH r AL s AC ɯ AH z AC
sıpa	s AC ɯ AH p AG a AH
sıradan	s AC ɯ AH ɾ AM ɑ AH d AC ɑ AH n AF
tabanca	t AC ɑ AH b AG ɑ AH n AF d AC ʒ AC ɑ AH
taciz	t AC aː AI d AC ʒ AC i AH z AC
tahdit	t AC a AH h AA d AC i AH t AC
taksi	t AC ɑ AH k AC s AC i AH
takvim	t AC ɑ AH k AC v AG i AH m AE
tandır	t AC ɑ AH n AF d AC ɯ AH ɾ AM
tanjant	t AC a AH n AF ʒ AC a AH n AF t AC
tanrı	t AC ɑ AH n AF ɾ AM ɯ AH
taraf	t AC ɑ AH ɾ AM ɑ AH f AG
tarihçi	t AC ɑː AI ɾ AM i AH h AA t AC ʃ AC i AH
tarzanca	t AC ɑ AH ɾ AM z AC ɑ AH n AF d AC ʒ AC ɑ AH
tarım	t AC a AH ɾ AM ɯ AH m AE
tatar	t AC a AH t AC a AH ɾ AM
taverna	t AC ɑ AH β AG e AH ɾ AM n AF ɑ AH
tavukgötü	t AC ɑ AH β AG u AJ k AC ɟ AC œ AJ t AC y AJ
tayfa	t AC ɑ AH j AB f AG ɑ AH
tayga	t AC a AH j AB ɟ AC a AH
taç	t AC ɑ AH t AC ʃ AC
taşak	t AC ɑ AH ʃ AC ɑ AH k AC
taşeron	t AC a AH ʃ AC e AH r AL o̞ AJ n AF
tecrit	t AC e AH j AB r AL i AH t AC
tehlike	t AC e AH h AA ɫ AD i AH k AC e AH
tehlikeli	t AC e AH h AA ɫ AD i AH k AC e AH ɫ AD i AH
tehlikesiz	t AC e AH h AA ɫ AD i AH k AC e AH s AC i AH z AC
tekfur	t AC ɛ AH c AC f AG ʊ AJ ɾ AM
tekrar	t AC e AH k AC ɾ AM a AH ɾ AM
tensör	t AC e AH n AF s AC ø AJ ɾ AM
tensörler	t AC e AH n AF s AC ø AJ ɾ AM ɫ AD e AH ɾ AM
tensörü	t AC e AH n AF s AC ø AJ ɾ AM y AJ
tensörüm	t AC e AH n AF s AC ø AJ ɾ AM y AJ m AE
tensörün	t AC e AH n AF s AC ø AJ ɾ AM y AJ n AF
tercih	t AC æ AH ɾ AM d AC ʒ AC i AH h AA
tercüman	t AC æ AH ɾ AM d AC ʒ AC y AJ m AE ɑ AH n AF
testine	t AC ɛ AH s AC t AC i AH n AF ɛ AH
testinin	t AC ɛ AH s AC t AC i AH n AF i AH n AF
tezene	t AC ɛ AH z AC ɛ AH n AF ɛ AH
tiflis	t AC i AH f AG l AD i AH s AC
tilde	t AC i AH l AD d AC e AH
tip	t AC i AH p AG
tipografi	t AC i AH p AG o̞ AJ ɡ AC r AL a AH f AG i AH
tipografik	t AC i AH p AG o̞ AJ ɡ AC r AL a AH f AG i AH k AC
tipografya	t AC i AH p AG o̞ AJ ɡ AC r AL a AH f AG j AB a AH
tonton	t AC o AJ n AF t AC o AJ n AF
topik	t AC ɔ AJ p AG i AH c AC
topografik	t AC ɔ AJ p AG ɔ AJ ɡ AC ɾ AM ɑ AH f AG i AH c AC
topçu	t AC o̞ AJ p AG t AC ʃ AC ʊ AJ
torun	t AC ɔ AJ ɾ AM ʊ AJ n AF
tosbağa	t AC o AJ s AC b AG aː AI
trafik	t AC ɾ AM a AH f AG i AH c AC
trajik	t AC r AL a AH j AB iː AI c AC
travma	t AC ɾ AM ɑ AH v AG m AE ɑ AH
trende	t AC ɾ AM e AH n AF d AC e AH
trenden	t AC ɾ AM e AH n AF d AC e AH n AF
trene	t AC ɾ AM e AH n AF e AH
treni	t AC ɾ AM e AH n AF i AH
trenim	t AC ɾ AM e AH n AF i AH m AE
trenimi	t AC ɾ AM e AH n AF i AH m AE i AH
trenin	t AC ɾ AM e AH n AF i AH n AF
trenini	t AC ɾ AM e AH n AF i AH n AF i AH
trenler	t AC ɾ AM e AH n AF ɫ AD e AH ɾ AM
tuvalet	t AC u AJ β AG a AH l AD e AH t AC
tuğra	t AC uː AK r AL a AH
tümce	t AC y AJ m AE d AC ʒ AC ɛ AH
türev	t AC y AJ ɾ AM ɛ AH v AG
türkiye	t AC y AJ ɾ AM c AC i AH j AB ɛ AH
türkmence	t AC y AJ ɾ AM c AC m AE e AH n AF d AC ʒ AC ɛ AH
türkân	t AC y AJ ɾ AM k AC j AB a AH n AF
tütmek	t AC y AJ t AC m AE e AH c AC
tütsü	t AC y AJ t AC s AC y AJ
tütü	t AC y AJ t AC y AJ
tütüncü	t AC y AJ t AC y AJ n AF d AC ʒ AC y AJ
tüy	t AC y AJ j AB
ugandalı	u AJ ɡ AC ɑ AH n AF d AC ɑ AH ɫ AD ɯ AH
ukraynaca	ʊ AJ k AC ɾ AM ɑ AH j AB n AF ɑ AH d AC ʒ AC ɑ AH
ukraynalı	ʊ AJ k AC ɾ AM ɑ AH j AB n AF ɑ AH ɫ AD ɯ AH
usta	u AJ s AC t AC a AH
utandırmak	u AJ t AC ɑ AH n AF d AC ɯ AH ɾ AM m AE ɑ AH k AC
utanmak	u AJ t AC ɑ AH n AF m AE ɑ AH k AC
uyanmak	u AJ j AB ɑ AH n AF m AE ɑ AH k AC
uydu	u AJ j AB d AC u AJ
uygun	u AJ j AB ɡ AC u AJ n AF
uzay	u AJ z AC a AH j AB
uçak	u AJ t AC ʃ AC a AH k AC
uçurtma	u AJ t AC ʃ AC u AJ ɾ AM t AC m AE ɑ AH
uğramak	uː AK r AL a AH m AE a AH k AC
uğratmak	u AJ ɰ AB r AL a AH t AC m AE a AH k AC
uğratılmak	u AJ ɰ AB r AL a AH t AC ɯ AH l AD m AE a AH k AC
uğur	uː AK ɾ AM
vade	v AG ɑː AI d AC ɛ AH
vaha	β AG ɑ AH h AA ɑː AI
valide	β AG aː AI l AD i AH d AC e AH
vapur	v AG ɑ AH p AG u AJ ɾ AM
varış	β AG a AH ɾ AM ɯ AH ʃ AC
vasat	v AG ɑ AH s AC ɑ AH t AC
vasiyet	β AG a AH s AC i AH j AB e AH t AC
vefat	v AG e AH f AG aː AI t AC
vefatlar	v AG e AH f AG aː AI t AC ɫ AD a AH ɾ AM
vefatı	v AG e AH f AG aː AI t AC ɯ AH
vefatın	v AG e AH f AG aː AI t AC ɯ AH n AF
velet	v AG ɛ AH l AD ɛ AH t AC
venedikli	v AG e AH n AF e AH d AC i AH k AC l AD i AH
vermek	v AG e AH ɾ AM m AE e AH c AC
veteriner	β AG ɛ AH t AC ɛ AH ɾ AM i AH n AF e AH ɾ AM
veya	v AG ɛ AH j AB ɑː AI
veyahut	v AG ɛ AH j AB ɑː AI h AA u AJ t AC
vietnamca	v AG i AH ɛ AH t AC n AF ɑ AH m AE d AC ʒ AC ɑ AH
vietnamlı	v AG i AH ɛ AH t AC n AF ɑ AH m AE ɫ AD ɯ AH
vilayet	v AG i AH l AD a AH j AB ɛ AH t AC
virgül	β AG i AH ɾ AM ɡ AC y AJ l AD
viyanalı	v AG i AH j AB ɑ AH n AF ɑ AH ɫ AD ɯ AH
voleybol	β AG o AJ l AD e AH j AB b AG o AJ ɫ AD
votka	β AG ɔ AJ t AC k AC ɑ AH
vuvuzela	v AG u AJ v AG u AJ z AC ɛ AH ɫ AD ɑ AH
yahudi	j AB ɑ AH h AA ʊ AJ d AC i AH
yahudilik	j AB ɑ AH h AA ʊ AJ d AC i AH l AD i AH c AC
yahut	j AB ɑː AI h AA u AJ t AC
yakmak	j AB a AH k AC m AE a AH k AC
yakmamak	j AB a AH k AC m AE a AH m AE a AH k AC
yakut	j AB ɑː AI k AC ʊ AJ t AC
yakın	j AB a AH k AC ɯ AH n AF
yalan	j AB a AH ɫ AD a AH n AF
yalnız	j AB a AH ɫ AD n AF ɯ AH z AC
yalnızlık	j AB a AH ɫ AD n AF ɯ AH z AC ɫ AD ɯ AH k AC
yalvarış	j AB a AH l AD β AG a AH ɾ AM ɯ AH ʃ AC
yalıtım	j AB a AH l AD ɯ AH t AC ɯ AH m AE
yamyam	j AB ɑ AH m AE j AB ɑ AH m AE
yangın	j AB ɑ AH ŋ AF ɡ AC ɯ AH n AF
yani	j AB ɑː AI n AF i AH
yanlışlık	j AB a AH n AF ɫ AD ɯ AH ʃ AC ɫ AD ɯ AH k AC
yanıtlamak	j AB ɑ AH n AF ɯ AH t AC ɫ AD ɑ AH m AE ɑ AH k AC
yaprak	j AB ɑ AH p AG ɾ AM ɑ AH k AC
yapıncak	j AB ɑ AH p AG ɯ AH n AF d AC ʒ AC ɑ AH k AC
yara	j AB ɑ AH ɾ AM ɑ AH
yarak	j AB a AH ɾ AM a AH k AC
yaraklar	j AB a AH ɾ AM a AH k AC ɫ AD a AH r AL
yaralı	j AB ɑ AH ɾ AM ɑ AH l AD ɯ AH
yarar	j AB a AH ɾ AM a AH ɾ AM
yaratıcı	j AB ɑ AH ɾ AM ɑ AH t AC ɯ AH d AC ʒ AC ɯ AH
yardımsever	j AB ɑ AH ɾ AM d AC ɯ AH m AE s AC e AH v AG e AH ɾ AM
yardımseverlik	j AB ɑ AH ɾ AM d AC ɯ AH m AE s AC e AH v AG e AH ɾ AM ɫ AD i AH c AC
yarmak	j AB a AH ɾ AM m AE a AH k AC
yarmaz	j AB a AH ɾ AM m AE a AH z AC
yarışma	j AB a AH ɾ AM ɯ AH ʃ AC m AE a AH
yasa	j AB ɑ AH s AC ɑ AH
yasak	j AB ɑ AH s AC ɑ AH k AC
yasemin	j AB ɑː AI s AC ɛ AH m AE i AH n AF
yatay	j AB ɑ AH t AC ɑ AH j AB
yavaşça	j AB ɑ AH v AG ɑ AH ʃ AC t AC ʃ AC ɑ AH
yavru	j AB a AH v AG ɾ AM u AJ
yavrulamaz	j AB a AH v AG ɾ AM u AJ ɫ AD a AH m AE a AH z AC
yavrular	j AB a AH v AG ɾ AM u AJ ɫ AD a AH ɾ AM
yavrum	j AB a AH v AG ɾ AM u AJ m AE
yavrun	j AB a AH v AG ɾ AM u AJ n AF
yavrunun	j AB a AH v AG ɾ AM u AJ n AF u AJ n AF
yavrusu	j AB a AH v AG ɾ AM u AJ s AC u AJ
yavruyu	j AB a AH v AG ɾ AM u AJ j AB u AJ
yavşak	j AB a AH v AG ʃ AC a AH k AC
yaya	j AB a AH j AB a AH
yayımcılık	j AB a AH j AB ɯ AH m AE d AC ʒ AC ɯ AH ɫ AD ɯ AH c AC
yayıncılık	j AB a AH j AB ɯ AH n AF d AC ʒ AC ɯ AH ɫ AD ɯ AH c AC
yazarım	j AB a AH z AC a AH ɾ AM ɯ AH m AE
yazma	j AB a AH z AC m AE a AH
yazmak	j AB a AH z AC m AE a AH k AC
yazmalar	j AB a AH z AC m AE a AH ɫ AD a AH ɾ AM
yazmam	j AB a AH z AC m AE a AH m AE
yazmamak	j AB a AH z AC m AE a AH m AE a AH c AC
yazmanın	j AB a AH z AC m AE a AH n AF ɯ AH n AF
yazmayı	j AB a AH z AC m AE a AH j AB ɯ AH
yağma	j AB ɑ AH ɰ AB m AE ɑ AH
yağmurlu	j AB aː AI m AE u AJ ɾ AM ɫ AD u AJ
yağış	j AB ɑ AH ɰ AB ɯ AH ʃ AC
yaşasın	j AB ɑ AH ʃ AC ɑ AH s AC ɯ AH n AF
yedigen	j AB e AH d AC i AH ɟ AC e AH n AF
yedirmek	j AB ɛ AH d AC i AH ɾ AM m AE ɛ AH k AC
yedirtmek	j AB ɛ AH d AC i AH ɾ AM t AC m AE ɛ AH k AC
yedirtmemek	j AB ɛ AH d AC i AH ɾ AM t AC m AE ɛ AH m AE ɛ AH k AC
yemek	j AB ɛ AH m AE ɛ AH c AC
yemeni	j AB ɛ AH m AE ɛ AH n AF i AH
yemiş	j AB ɛ AH m AE i AH ʃ AC
yemişi	j AB ɛ AH m AE i AH ʃ AC i AH
yemişler	j AB ɛ AH m AE i AH ʃ AC l AD e AH ɾ AM
yendirmek	j AB ɛ AH n AF d AC i AH ɾ AM m AE ɛ AH k AC
yendirtmek	j AB ɛ AH n AF d AC i AH ɾ AM t AC m AE ɛ AH k AC
yengeç	j AB ɛ AH n AF ɟ AC ɛ AH t AC ʃ AC
yenmek	j AB ɛ AH n AF m AE ɛ AH k AC
yeti	j AB e AH t AC i AH
yetmiş	j AB ɛ AH t AC m AE i AH ʃ AC
yeşim	j AB e AH ʃ AC i AH m AE
yirmigen	j AB i AH r AL m AE i AH ɟ AC e AH n AF
yiğit	j AB iː AI t AC
yol	j AB ɔ AJ ɫ AD
yolculuk	j AB ɔ AJ ɫ AD d AC ʒ AC u AJ ɫ AD u AJ k AC
yorgunluk	j AB o AJ ɾ AM ɟ AC u AJ n AF ɫ AD u AJ k AC
yoğurt	j AB o AJ ʊ AJ r AL t AC
yoğurtçu	j AB o AJ ʊ AJ r AL t AC t AC ʃ AC ʊ AJ
yoğurtçuluk	j AB o AJ ʊ AJ r AL t AC t AC ʃ AC ʊ AJ ɫ AD ʊ AJ k AC
yufka	j AB ʊ AJ f AG k AC ɑ AH
yugoslavya	j AB ɔ AJ ɡ AC ɔ AJ s AC ɫ AD ɑː AI v AG j AB ɑ AH
yumurtalık	j AB ʊ AJ m AE ʊ AJ ɾ AM t AC ɑ AH ɫ AD ɯ AH k AC
yunan	j AB u AJ n AF ɑ AH n AF
yunanca	j AB u AJ n AF ɑ AH n AF d AC ʒ AC ɑ AH
yunanistan	j AB u AJ n AF a AH n AF i AH s AC t AC a AH n AF
yutmak	j AB u AJ t AC m AE ɑ AH k AC
yöre	j AB ø AJ ɾ AM ɛ AH
yörekent	j AB ø AJ ɾ AM ɛ AH k AC ɛ AH n AF t AC
yörünge	j AB ø AJ r AL y AJ n AF ɡ AC e AH
yürek	j AB y AJ ɾ AM ɛ AH c AC
yüzde	j AB y AJ z AC d AC ɛ AH
yüzey	j AB ʏ AJ z AC ɛ AH j AB
yıldırı	j AB ɯ AH ɫ AD d AC ɯ AH ɾ AM ɯ AH
yıldızıl	j AB ɯ AH l AD d AC ɯ AH z AC ɯ AH l AD
yılmaz	j AB ɯ AH ɫ AD m AE ɑ AH z AC
zafer	z AC ɑ AH f AG e AH ɾ AM
zaferde	z AC ɑ AH f AG e AH ɾ AM d AC ɛ AH
zaferden	z AC ɑ AH f AG e AH ɾ AM d AC e AH n AF
zafere	z AC ɑ AH f AG ɛ AH ɾ AM ɛ AH
zaferi	z AC ɑ AH f AG ɛ AH ɾ AM i AH
zaferin	z AC ɑ AH f AG ɛ AH ɾ AM i AH n AF
zaferler	z AC ɑ AH f AG e AH ɾ AM l AD e AH ɾ AM
zaferlerde	z AC ɑ AH f AG e AH ɾ AM l AD e AH ɾ AM d AC ɛ AH
zaferlerden	z AC ɑ AH f AG e AH ɾ AM l AD e AH ɾ AM d AC e AH n AF
zaferlere	z AC ɑ AH f AG e AH ɾ AM l AD ɛ AH ɾ AM ɛ AH
zaferleri	z AC ɑ AH f AG e AH ɾ AM l AD ɛ AH ɾ AM i AH
zaferlerin	z AC ɑ AH f AG e AH ɾ AM l AD ɛ AH ɾ AM i AH n AF
zahmet	z AC ɑ AH h AA m AE ɛ AH t AC
zaman	z AC ɑ AH m AE ɑː AI n AF
zangoç	z AC ɑ AH ŋ AF ɡ AC o AJ t AC ʃ AC
zarf	z AC a AH ɾ AM f AG
zavallı	z AC ɑ AH v AG ɑ AH ɫ AD ɫ AD ɯ AH
zavar	z AC ɑ AH v AG ɑ AH ɾ AM
zebra	z AC e AH b AG ɾ AM ɑ AH
zehra	z AC ɛ AH h AA ɾ AM ɑː AI
zeval	z AC e AH v AG ɑ AH ɫ AD
zibidi	z AC i AH b AG i AH d AC i AH
zibidide	z AC i AH b AG i AH d AC i AH d AC e AH
zibididen	z AC i AH b AG i AH d AC i AH d AC e AH n AF
zibidiler	z AC i AH b AG i AH d AC i AH ɫ AD e AH ɾ AM
zibidilerde	z AC i AH b AG i AH d AC i AH ɫ AD e AH ɾ AM d AC e AH
zibidilerden	z AC i AH b AG i AH d AC i AH ɫ AD e AH ɾ AM d AC e AH n AF
zibidilere	z AC i AH b AG i AH d AC i AH ɫ AD e AH ɾ AM e AH
zibidileri	z AC i AH b AG i AH d AC i AH ɫ AD e AH ɾ AM i AH
zibidilerim	z AC i AH b AG i AH d AC i AH ɫ AD e AH ɾ AM i AH m AE
zibidilerin	z AC i AH b AG i AH d AC i AH ɫ AD e AH ɾ AM i AH n AF
zibidim	z AC i AH b AG i AH d AC i AH m AE
zibidin	z AC i AH b AG i AH d AC i AH n AF
zibidinin	z AC i AH b AG i AH d AC i AH n AF i AH n AF
zibidisi	z AC i AH b AG i AH d AC i AH s AC i AH
zibidiye	z AC i AH b AG i AH d AC i AH j AB e AH
zibidiyi	z AC i AH b AG i AH d AC i AH y AJ i AH
zibil	z AC i AH b AG i AH l AD
ziggurat	z AC i AH ɡ AC ɡ AC u AJ ɾ AM ɑ AH t AC
zinhar	z AC i AH n AF h AA ɑ AH ɾ AM
ziyaret	z AC i AH j AB ɑː AI ɾ AM ɛ AH t AC
ziyaretçi	z AC i AH j AB ɑː AI ɾ AM ɛ AH t AC t AC ʃ AC i AH
zorluk	z AC o AJ ɾ AM ɫ AD u AJ k AC
zulüm	z AC u AJ l AD y AJ m AE
zurna	z AC u AJ ɾ AM n AF ɑ AH
âlem	aː AI l AD ɛ AH m AE
âlemi	aː AI l AD ɛ AH m AE i AH
âlemler	aː AI l AD ɛ AH m AE l AD ɛ AH ɾ AM
âmâ	aː AI m AE aː AI
âmâdır	aː AI m AE aː AI d AC ɯ AH ɾ AM
âmâlar	aː AI m AE aː AI ɫ AD a AH ɾ AM
âmâsın	aː AI m AE aː AI s AC ɯ AH n AF
âmâyı	aː AI m AE aː AI j AB ɯ AH
âmâyım	aː AI m AE aː AI j AB ɯ AH m AE
âşık	ɑː AI ʃ AC ɯ AH k AC
çabucak	t AC ʃ AC ɑ AH b AG u AJ d AC ʒ AC ɑ AH k AC
çakal	t AC ʃ AC ɑ AH k AC ɑ AH ɫ AD
çakma	t AC ʃ AC ɑ AH k AC m AE ɑ AH
çalgı	t AC ʃ AC ɑ AH ɫ AD ɡ AC ɯ AH
çalgıcı	t AC ʃ AC ɑ AH ɫ AD ɡ AC ɯ AH d AC ʒ AC ɯ AH
çalgıç	t AC ʃ AC ɑ AH ɫ AD ɡ AC ɯ AH t AC ʃ AC
çalışma	t AC ʃ AC a AH ɫ AD ɯ AH ʃ AC m AE a AH
çalışmak	t AC ʃ AC ɑ AH ɫ AD ɯ AH ʃ AC m AE ɑ AH k AC
çalışmamak	t AC ʃ AC ɑ AH ɫ AD ɯ AH ʃ AC m AE ɑ AH m AE ɑ AH k AC
çan	t AC ʃ AC a AH n AF
çap	t AC ʃ AC ɑ AH p AG
çapa	t AC ʃ AC ɑ AH p AG ɑ AH
çarşaf	t AC ʃ AC a AH ɾ AM ʃ AC a AH f AG
çatlak	t AC ʃ AC ɑ AH t AC ɫ AD ɑ AH k AC
çavuş	t AC ʃ AC ɑ AH v AG ʊ AJ ʃ AC
çaydanlık	t AC ʃ AC a AH j AB d AC a AH n AF ɫ AD ɯ AH k AC
çağ	t AC ʃ AC ɑː AI
çağdaş	t AC ʃ AC ɑː AI d AC ɑ AH ʃ AC
çeker	t AC ʃ AC ɛ AH c AC ɛ AH ɾ AM
çekmece	t AC ʃ AC ɛ AH c AC m AE ɛ AH d AC ʒ AC ɛ AH
çekmek	t AC ʃ AC ɛ AH c AC m AE ɛ AH c AC
çekmez	t AC ʃ AC ɛ AH c AC m AE ɛ AH z AC
çelenk	t AC ʃ AC ɛ AH l AD ɛ AH ŋ AF k AC
çember	t AC ʃ AC e AH m AE b AG e AH ɾ AM
çernobil	t AC ʃ AC e AH ɾ AM n AF ɔ AJ b AG i AH l AD
çevre	t AC ʃ AC e AH v AG ɾ AM ɛ AH
çeşni	t AC ʃ AC ɛ AH ʃ AC n AF i AH
çift	t AC ʃ AC i AH f AG t AC
çiftlik	t AC ʃ AC i AH f AG t AC l AD i AH c AC
çikolata	t AC ʃ AC i AH k AC o AJ ɫ AD a AH t AC a AH
çilek	t AC ʃ AC i AH l AD ɛ AH k AC
çirkinlik	t AC ʃ AC i AH ɾ AM k AC i AH n AF l AD i AH c AC
çizgi	t AC ʃ AC i AH z AC ɟ AC i AH
çizmeci	t AC ʃ AC i AH z AC m AE ɛ AH d AC ʒ AC i AH
çiçe	t AC ʃ AC i AH t AC ʃ AC ɛ AH
çiçek	t AC ʃ AC ɪ AH t AC ʃ AC ɛ AH c AC
çocuk	t AC ʃ AC o̞ AJ d AC ʒ AC u AJ k AC
çocuklardan	t AC ʃ AC o AJ d AC ʒ AC u AJ k AC l AD a AH ɾ AM d AC a AH n AF
çocukluk	t AC ʃ AC o AJ d AC ʒ AC u AJ k AC ɫ AD u AJ k AC
çok	t AC ʃ AC ɔ AJ k AC
çokgen	t AC ʃ AC o AJ k AC ɟ AC e AH n AF
çorap	t AC ʃ AC ɔ AJ ɾ AM ɑ AH p AG
çubuk	t AC ʃ AC u AJ b AG u AJ k AC
çubuklu	t AC ʃ AC u AJ b AG u AJ k AC ɫ AD u AJ
çubuksuz	t AC ʃ AC u AJ b AG u AJ k AC s AC u AJ z AC
çökelti	t AC ʃ AC ø AJ k AC e AH ɫ AD t AC i AH
çökermek	t AC ʃ AC ø AJ k AC e AH ɾ AM m AE e AH c AC
çökerti	t AC ʃ AC ø AJ k AC e AH ɾ AM t AC i AH
çökertici	t AC ʃ AC ø AJ k AC e AH ɾ AM t AC i AH j AB i AH
çökertmek	t AC ʃ AC ø AJ k AC e AH ɾ AM t AC m AE e AH c AC
çökertmemek	t AC ʃ AC ø AJ k AC e AH ɾ AM t AC m AE e AH m AE e AH c AC
çöp	t AC ʃ AC ø AJ p AG
çürümek	t AC ʃ AC y AJ r AL y AJ m AE e AH c AC
çürümemek	t AC ʃ AC y AJ r AL y AJ m AE e AH m AE e AH c AC
çılgın	t AC ʃ AC ɯ AH ɫ AD ɟ AC ɯ AH n AF
çılgınlık	t AC ʃ AC ɯ AH ɫ AD ɟ AC ɯ AH n AF ɫ AD ɯ AH k AC
çıpa	t AC ʃ AC ɯ AH p AG ɑ AH
çıplak	t AC ʃ AC ɯ AH p AG ɫ AD ɑ AH k AC
çıplaklık	t AC ʃ AC ɯ AH p AG ɫ AD ɑ AH k AC ɫ AD ɯ AH k AC
ödev	ø AJ d AC e AH v AG
öglena	ø AJ ɟ AC l AD e AH n AF ɑ AH
öküz	ø AJ c AC y AJ z AC
öldürtmek	ø AJ ɫ AD d AC y AJ ɾ AM t AC m AE e AH k AC
öldürtülmek	ø AJ ɫ AD d AC y AJ ɾ AM t AC y AJ ɫ AD m AE e AH k AC
öldürülmek	ø AJ ɫ AD d AC y AJ ɾ AM y AJ ɫ AD m AE e AH k AC
ölmek	œ AJ l AD m AE ɛ AH c AC
ölü	ø AJ l AD y AJ
ölümlü	ø AJ ɫ AD y AJ m AE l AD y AJ
ölümlülük	œ AJ ɫ AD y AJ m AE ɫ AD y AJ ɫ AD y AJ c AC
ölümsüz	ø AJ ɫ AD y AJ m AE s AC y AJ z AC
ölümsüzlük	œ AJ ɫ AD y AJ m AE s AC y AJ z AC ɫ AD y AJ c AC
ölünmek	ø AJ ɫ AD y AJ n AF m AE e AH k AC
önce	ø AJ n AF d AC ʒ AC ɛ AH
öncelik	ø AJ n AF d AC ʒ AC ɛ AH l AD i AH c AC
önyargı	œ AJ n AF j AB a AH r AL ɡ AC ɯ AH
öpmek	ø AJ p AG m AE e AH c AC
örnek	ø AJ ɾ AM n AF e AH c AC
örümcek	œ AJ ɾ AM y AJ m AE d AC ʒ AC ɛ AH c AC
öteki	œ AJ t AC ɛ AH c AC i AH
öz	ø AJ z AC
özer	œ AJ z AC æ AH ɾ AM
özgemek	ø AJ z AC ɡ AC ɛ AH m AE ɛ AH c AC
özgü	ø AJ z AC ɟ AC y AJ
özlemek	ø AJ z AC l AD ɛ AH m AE ɛ AH c AC
özür	ø AJ z AC y AJ ɾ AM
öğretmeni	ø AJ ɰ AB ɾ AM e AH t AC m AE e AH n AF i AH
öğretmenim	ø AJ ɰ AB ɾ AM e AH t AC m AE e AH n AF i AH m AE
öğretmenin	ø AJ ɰ AB ɾ AM e AH t AC m AE e AH n AF i AH n AF
öğütücü	œ AJ ɰ AB y AJ t AC y AJ d AC ʒ AC y AJ
ücretlilik	y AJ d AC ʒ AC ɾ AM e AH t AC l AD i AH l AD i AH k AC
ücretsizlik	y AJ d AC ʒ AC ɾ AM e AH t AC s AC i AH z AC l AD i AH k AC
ünlü	y AJ n AF l AD y AJ
ünsüz	y AJ n AF s AC y AJ z AC
üretmek	y AJ ɾ AM ɛ AH t AC m AE ɛ AH c AC
ürün	y AJ ɾ AM y AJ n AF
üstünde	y AJ s AC t AC y AJ n AF d AC e AH
üstüne	y AJ s AC t AC y AJ n AF e AH
ütü	y AJ t AC y AJ
üyelik	y AJ j AB ɛ AH l AD i AH c AC
üzerinde	y AJ z AC ɛ AH ɾ AM i AH n AF d AC e AH
üzerine	y AJ z AC ɛ AH ɾ AM i AH n AF e AH
üçgen	y AJ t AC ʃ AC ɟ AC e AH n AF
üçlü	y AJ t AC ʃ AC l AD y AJ
üçüncül	y AJ t AC ʃ AC y AJ n AF d AC ʒ AC y AJ ɫ AD
ğ	ɰ AB
ıslaklık	ɯ AH s AC ɫ AD a AH k AC l AD ɯ AH k AC
ışık	ɯ AH ʃ AC ɯ AH k AC
şaban	ʃ AC aː AI b AG a AH n AF
şafak	ʃ AC ɑ AH f AG ɑ AH k AC
şahmeran	ʃ AC ɑ AH h AA m AE e AH ɾ AM ɑ AH n AF
şahmerdan	ʃ AC ɑ AH h AA m AE e AH ɾ AM d AC ɑ AH n AF
şair	ʃ AC aː AI i AH ɾ AM
şakşakçı	ʃ AC ɑ AH k AC ʃ AC ɑ AH k AC t AC ʃ AC ɯ AH
şamandıra	ʃ AC ɑ AH m AE ɑ AH n AF d AC ɯ AH ɾ AM ɑ AH
şamdan	ʃ AC ɑ AH m AE d AC ɑ AH n AF
şamisen	ʃ AC ɑ AH m AE ɪ AH s AC e AH n AF
şampiyon	ʃ AC ɑ AH m AE p AG i AH j AB ɔ AJ n AF
şampiyonluk	ʃ AC ɑ AH m AE p AG i AH j AB ɔ AJ n AF ɫ AD u AJ k AC
şapkacı	ʃ AC ɑ AH p AG k AC ɑ AH d AC ʒ AC ɯ AH
şarap	ʃ AC ɑ AH ɾ AM ɑ AH p AG
şarapçı	ʃ AC ɑ AH ɾ AM ɑ AH p AG t AC ʃ AC ɯ AH
şarkıcılık	ʃ AC a AH ɾ AM k AC ɯ AH d AC ʒ AC ɯ AH ɫ AD ɯ AH k AC
şato	ʃ AC a AH t AC o AJ
şebnem	ʃ AC ɛ AH b AG n AF æ AH m AE
şeker	ʃ AC ɛ AH c AC ɛ AH ɾ AM
şekil	ʃ AC ɛ AH c AC i AH l AD
şelale	ʃ AC ɛ AH l AD ɑː AI l AD ɛ AH
şemsiye	ʃ AC ɛ AH m AE s AC i AH j AB ɛ AH
şen	ʃ AC e AH n AF
şerbet	ʃ AC e AH ɾ AM b AG ɛ AH t AC
şerbetli	ʃ AC e AH ɾ AM b AG ɛ AH t AC l AD i AH
şerbetsiz	ʃ AC e AH ɾ AM b AG ɛ AH t AC s AC i AH z AC
şerbetçi	ʃ AC e AH ɾ AM b AG ɛ AH t AC t AC ʃ AC i AH
şerbetçilik	ʃ AC e AH ɾ AM b AG ɛ AH t AC t AC ʃ AC i AH l AD i AH c AC
şey	ʃ AC ɛ AH j AB
şifonyer	ʃ AC i AH f AG ɔ AJ n AF j AB e AH ɾ AM
şiir	ʃ AC i AH i AH ɾ AM
şive	ʃ AC iː AI β AG ɛ AH
şizofreni	ʃ AC i AH z AC o AJ f AG ɾ AM ɛ AH n AF i AH
şiş	ʃ AC i AH ʃ AC
şişlik	ʃ AC i AH ʃ AC l AD i AH c AC
şişman	ʃ AC i AH ʃ AC m AE a AH n AF
şok	ʃ AC o AJ k AC
şort	ʃ AC ɔ AJ ɾ AM t AC
şov	ʃ AC o AJ v AG
şuur	ʃ AC u AJ u AJ ɾ AM
şuurlar	ʃ AC u AJ u AJ ɾ AM ɫ AD a AH ɾ AM
şuuru	ʃ AC u AJ u AJ ɾ AM u AJ
şövalye	ʃ AC œ AJ β AG a AH l AD j AB e AH
şırınga	ʃ AC ɯ AH ɾ AM ɯ AH ŋ AF ɡ AC ɑ AH
