aba	ɑː AL b AG ɑː AL
abacı	a AK b AG a AK d AC ʒ AH ɯ AK
abacılar	a AK b AG a AK d AC ʒ AH ɯ AK l AD a AK ɾ BE
abacılık	a AK b AG a AK d AC ʒ AH ɯ AK ɫ AD ɯ AK k AC
abajur	a AK b AG a AK ʒ AH u AM ɾ BE
abajurcu	a AK b AG a AK ʒ AH u AM ɾ BE d AC ʒ AH u AM
abajurcular	a AK b AG a AK ʒ AH u AM ɾ BE d AC ʒ AH u AM l AD a AK ɾ BE
abajurculuk	a AK b AG a AK ʒ AH u AM ɾ BE d AC ʒ AH u AM ɫ AD u AM k AC
abaküs	ɑ AK b AG ɑ AK c AC y AM s AH
abalı	a AK b AG a AK ɫ AD ɯ AK
abanoz	ɑ AK b AG ɑ AK n AF o AM ʐ AH
abartı	a AK b AG a AK r BA t AC ɯ AK
abartılı	a AK b AG a AK ɾ BE t AC ɯ AK l AD ɯ AK
abece	ɑː AL b AG eː AL d AC ʒ AH eː AL
abide	aː AL b AG i AK d AC e AK
acaba	a AK d AC ʒ AH a AK b AG aː AL
ad	ɑ AK t̪ AC
adal	a AK d AC a AK ɫ AD
adalar	a AK d AC a AK l AD a AK ɾ BE
adam	ɑ AK d AC ɑ AK m AE
adamı	a AK d AC a AK m AE ɯ AK
aday	ɑ AK d AC ɑ AK j AB
adaylar	a AK d AC a AK j AB l AD a AK ɾ BE
adayı	a AK d AC a AK j AB ɯ AK
adi	aː AL d AC iː AL
adı	a AK d̪ AC ɯ AK
adım	ɑ AK d AC ɯ AK m AE
ahbap	ɑ AK h AA b AG ɑ AK p AG
ahlat	a AK h AA ɫ AD a AK t AC
ahtapotlar	ɑ AK h AA t AC ɑ AK p AG o AM t AC l AD a AK ɾ BE
ahududu	aː AL h AA u AM d AC u AM d AC u AM
ahududular	aː AL h AA u AM d AC u AM d AC u AM l AD a AK ɾ BE
aile	ɑ AK i AK l AD e AK
ajanda	ɑ AK ʒ AH ɑ AK n AF d AC ɑ AK
ak	ɑ AK k AC
akciğer	a AK k AC d AC ʒ AH iː AL e AK ɾ BE
akrabalar	a AK k AC ɾ BE a AK b AG aː AL l AD a AK ɾ BE
akrabayla	a AK k AC ɾ BE a AK b AG aː AL j AB l AD a AK
akrabayı	a AK k AC ɾ BE a AK b AG aː AL j AB ɯ AK
aksamak	ɑ AK k AC s AH ɑ AK m AE ɑ AK k AC
aksan	a AK k AC s AH a AK n AF
aksanlar	a AK k AC s AH a AK n AF l AD a AK ɾ BE
aktris	ɑ AK k AC t AC ɾ BE i AK s AH
aktör	ɑ AK k AC t AC œ AM ɾ BE
akvaryum	ɑ AK k AC v BB ɑ AK ɾ BE j AB u AM m AE
akıl	ɑ AK k AC ɯ AK ɫ AD
akın	a AK k AC ɯ AK n AF
akışkan	a AK k AC ɯ AK ʃ AH k AC a AK n AF
akışkanlar	a AK k AC ɯ AK ʃ AH k AC a AK n AF l AD a AK ɾ BE
akşamlar	a AK k AC ʃ AH a AK m AE l AD a AK ɾ BE
ala	ɑ AK ɫ AD ɑ AK
alabalık	ɑ AK ɫ AD ɑ AK b AG ɑ AK ɫ AD ɯ AK k AC
alacakaranlık	ɑ AK ɫ AD ɑ AK d AC ʒ AH ɑ AK k AC ɑ AK ɾ BE ɑ AK n AF ɫ AD ɯ AK k AC
alan	ɑ AK ɫ AD ɑ AK n AF
alaşım	ɑ AK ɫ AD ɑ AK ʃ AH ɯ AK m AE
albatros	a AK ɫ AD b AG a AK t AC r BA o AM s AH
albüm	ɑ AK l AD b AG y AM m AE
alet	ɑː AL l AD e AK t AC
alfabe	ɑ AK l AD f BB ɑ AK b AG e AK
alkol	a AK l AD k AC o AM l AD
alkış	a AK ɫ AD k AC ɯ AK ʃ AH
allah	aː AL ɫ AD aː AL h AA
alo	a AK l AD o AM
altı	ɑ AK l AD t AC ɯ̞ AK
altışar	a AK ɫ AD t AC ɯ AK ʃ AH a AK r BA
alüminyumlar	a AK l AD y AM m AE i AK n AF j AB u AM m AE l AD a AK ɾ BE
alın	ɑ AK ɫ AD ɯ AK n AF
amca	a AK m AE d AC ʒ AH a AK
amcalar	a AK m AE d AC ʒ AH a AK l AD a AK ɾ BE
amerika	a AK m AE e AK ɾ BE i AK k AC a AK
anahtarlar	a AK n AF a AK h AA t AC a AK ɾ BE ɫ AD a AK ɾ BE
anahtarları	a AK n AF a AK h AA t AC a AK ɾ BE ɫ AD a AK ɾ BE ɯ AK
anahtarların	a AK n AF a AK h AA t AC a AK ɾ BE ɫ AD a AK ɾ BE ɯ AK n AF
anahtarı	a AK n AF a AK h AA t AC a AK ɾ BE ɯ AK
anahtarım	a AK n AF a AK h AA t AC a AK ɾ BE ɯ AK m AE
anahtarın	a AK n AF a AK h AA t AC a AK ɾ BE ɯ AK n AF
analiz	a AK n AF a AK l AD i AK z AH
analizi	a AK n AF a AK l AD i AK z AH i AK
analizler	a AK n AF a AK l AD i AK z AH l AD e AK ɾ BE
andı	a AK n AF d AC ɯ AK
angolalı	a AK ŋ AF ɡ AC o AM ɫ AD a AK ɫ AD ɯ AK
anlam	ɑ AK n AF ɫ AD ɑ AK m AE
anmak	a AK n AF m AE a AK c AC
anmamak	a AK n AF m AE a AK m AE a AK c AC
ansiklopedi	a AK n AF s AH i AK k AC l AD ɔ AM p AG e AK d AC i AK
ant	a AK n AF t AC
antioksidan	a AK n AF t AC i AK o AM k AC s AH i AK d AC a AK n AF
antlar	a AK n AF t AC l AD a AK ɾ BE
antropomorfizm	a AK n AF t AC ɾ BE o AM p AG o AM m AE o AM ɾ BE f BB i AK z AH m AE
antropomorfizmi	a AK n AF t AC ɾ BE o AM p AG o AM m AE o AM ɾ BE f BB i AK z AH m AE i AK
antropomorfizmler	a AK n AF t AC ɾ BE o AM p AG o AM m AE o AM ɾ BE f BB i AK z AH m AE l AD e AK ɾ BE
apartman	a AK p AG a AK r BA t AC m AE a AK n AF
araba	a AK ɾ BE a AK b AG a AK
arabalar	a AK ɾ BE a AK b AG a AK l AD a AK ɾ BE
arabalı	a AK ɾ BE a AK b AG a AK l AD ɯ AK
arabasız	a AK ɾ BE a AK b AG a AK s AH ɯ AK z AH
arabayla	a AK ɾ BE a AK b AG a AK j AB l AD a AK
arabaysa	a AK ɾ BE a AK b AG a AK j AB s AH a AK
arabayı	a AK ɾ BE a AK b AG a AK j AB ɯ AK
araknofobi	a AK ɾ BE a AK k AC n AF o AM f BB o AM b AG i AK
arapça	a AK ɾ BE a AK p AG t AC ʃ AH a AK
arayüzler	a AK ɾ BE a AK j AB y AM z AH ɫ AD e AK ɾ BE
arayüzü	a AK ɾ BE a AK j AB y AM z AH y AM
araç	ɑ AK ɾ BE ɑ AK t AC ʃ AH
arda	ʌ AK ɾ BE d AC ʌ AK
arife	a AK ɾ BE i AK f BB e AK
arka	ɑ AK ɾ BE k AC ɑ AK
arkadaşları	a AK ɾ BE k AC a AK d AC a AK ʃ AH l AD a AK ɾ BE ɯ AK
arkeoloji	a AK r BA k AC e AK o AM l AD o AM ʒ AH i AK
armut	a AK r BA m AE u AM t AC
arnavutça	a AK ɾ BE n AF a AK v BB u AM t AC t AC ʃ AH a AK
arpa	ɑ AK ɾ BE p AG ɑ AK
arsa	ɑ AK ɾ BE s AH ɑ AK
arzu	a AK ɾ BE z AH u AM
arzuhal	ɑ AK ɾ BE z AH u AM h AA ɑ AK ɫ AD
arı	ɑ AK ɾ BE ɯ AK
arıcı	ɑ AK ɾ BE ɯ AK d AC ʒ AH ɯ AK
arıcılık	ɑ AK ɾ BE ɯ AK d AC ʒ AH ɯ AK ɫ AD ɯ AK k AC
asansör	ɑ AK s AH ɑ AK n AF s AH œ AM ɾ BE
asgari	a AK s AH ɡ AC a AK ɾ BE i AK
asistan	ɑ AK s AH i AK s AH t AC ɑ AK n AF
asker	ɑ AK s AH k AC e AK ɾ BE
asla	a AK s AH l AD a AK
aslan	ɑ̟ s AH ɫ AD ɑ̟ n AF
aslında	a AK s AH l AD ɯ AK n AF d AC a AK
asteroide	a AK s AH t AC e AK ɾ BE o AM i AK d AC e AK
asteroidi	a AK s AH t AC e AK ɾ BE o AM i AK d AC i AK
asteroidin	a AK s AH t AC e AK ɾ BE o AM i AK d AC i AK n AF
asteroit	a AK s AH t AC e AK ɾ BE o AM i AK t AC
asteroitle	a AK s AH t AC e AK ɾ BE o AM i AK t AC l AD e AK
asteroitler	a AK s AH t AC e AK ɾ BE o AM i AK t AC l AD e AK ɾ BE
asteroitse	a AK s AH t AC e AK ɾ BE o AM i AK t AC s AH e AK
asteroitte	a AK s AH t AC e AK ɾ BE o AM i AK t AC t AC e AK
asteroitten	a AK s AH t AC e AK ɾ BE o AM i AK t AC t AC e AK n AF
astronomi	ɑ AK s AH t AC ɾ BE o AM n AF o AM m AE i AK
astronot	ɑ AK s AH t AC ɾ BE o AM n AF o AM t AC
astım	ɑ AK s AH t AC ɯ AK m AE
asır	ɑ AK s AH ɯ AK ɾ BE
at	ä t̪ AC
ata	a AK t AC a AK
atalar	a AK t AC a AK l AD a AK ɾ BE
atasözleri	a AK t AC a AK s AH ø AM z AH l AD e AK ɾ BE i AK
atasözü	a AK t AC a AK s AH ø AM z AH y AM
atasözünü	a AK t AC a AK s AH ø AM z AH y AM n AF y AM
atatürk	a AK t AC a AK t AC y AM ɾ BE k AC
atayı	a AK t AC a AK j AB ɯ AK
atinalı	a AK t AC i AK n AF a AK ɫ AD ɯ AK
atmaca	ɑ AK t AC m AE ɑ AK d AC ʒ AH ɑ AK
av	a AK β BB
avantaj	a AK v BB a AK n AF t AC a AK ʒ AH
avantajlar	a AK v BB a AK n AF t AC a AK ʒ AH l AD a AK ɾ BE
avantajı	a AK v BB a AK n AF t AC a AK ʒ AH ɯ AK
avcı	a AK v BB d AC ʒ AH ɯ AK
avustralyalı	a AK v BB u AM s AH t AC ɾ BE a AK l AD j AB a AK ɫ AD ɯ AK
ay	a AK j AB
ayakkabı	ɑ AK j AB ɑ AK k AC k AC ɑ AK b AG ɯ AK
aydan	a AK j AB d AC a AK n AF
ayna	a AK j AB n AF a AK
aynasız	a AK j AB n AF a AK s AH ɯ AK z AH
aynştaynyum	a AK j AB n AF ʃ AH t AC a AK j AB n AF j AB u AM m AE
ayran	a AK j AB ɾ BE a AK n AF
azerbaycan	aː AL z AH ɛ AK ɾ BE b AG a AK j AB d AC ʒ AH a AK n AF
azerbaycanlar	aː AL z AH ə AK ɾ BE b AG a AK j AB d AC ʒ AH a AK n AF l AD a AK ɾ BE
azerice	aː AL z AH e AK ɾ BE i AK d AC ʒ AH e AK
azir	a AK z AH i AK ɾ̥ BE
açı	a AK t AC ʃ AH ɯ AK
açık	ɑ AK t AC ʃ AH ɯ AK k AC
ağa	ɑ AK ɰ AB ɑ AK
ağaç	äː t AC ʃ AH
ağır	ɑ AK ɑ AK ɾ̝̊
ağız	a AK ɰ AB ɯ AK z AH
aşk	a̟ AK ʃ AH k AC
aşure	a AK ʃ AH uː AN ɾ BE ɛ AK
b	b AG eː AL
baba	b AG ɑ AK b AG ɑ AK
babacan	b AG ɑ AK b AG ɑ AK d AC ʒ AH ɑ AK n AF
babil	b AG aː AL b AG i AK l AD
baca	b AG a AK d AC ʒ AH a AK
bacak	b AG a AK d AC ʒ AH a AK k AC
badem	b AG ɑː AL d AC ɛ AK m AE
bahar	b AG ɑ AK h AA ɑː AL ɾ BE
bakan	b AG ɑ AK k AC ɑ AK n AF
bakla	b AG a AK k AC l AD a AK
baklahorani	b AG a AK k AC ɫ AD a AK x AH o AM r BA a AK n AF i AK
baklava	b AG a AK k AC l AD a AK ʋ AI a AK
bal	b AG ɑ AK ɫ AD
balak	b AG ɑ AK ɫ AD ɑ AK k AC
baldır	b AG ɑ AK ɫ AD d AC ɯ AK ɾ BE
baldıran	b AG ɑ AK ɫ AD d AC ɯ AK ɾ BE ɑ AK n AF
baldırıkara	b AG ɑ AK ɫ AD d AC ɯ AK r BA ɯ AK k AC a AK r BA a AK
balina	b AG ɑ AK ɫ AD i AK n AF ɑ AK
balkmak	b AG ɑ AK ɫ AD k AC m AE ɑ AK k AC
balta	b AG ɑ AK l AD t AC ɑ AK
balyoz	b AG ɑ AK ɫ AD j AB o AM z AH
bankacılık	b AG a AK n AF k AC a AK d AC ʒ AH ɯ AK l AD ɯ AK k AC
barış	b AG a AK ɾ BE ɯ AK ʃ AH
bas	b AG a AK s AH
basketbolcu	b AG ʌ AK s AH k AC ɛ AK t AC b AG o AM ɫ AD d AC ʒ AH u AM
basma	b AG a AK s AH m AE a AK
basmak	b AG ɑ AK s AH m AE ɑ AK k AC
basmalar	b AG a AK s AH m AE a AK l AD a AK ɾ BE
basmamak	b AG ɑ AK s AH m AE ɑ AK m AE ɑ AK k AC
basmayı	b AG a AK s AH m AE a AK j AB ɯ AK
basmayın	b AG a AK s AH m AE a AK j AB ɯ AK n AF
bası	b AG a AK s AH ɯ AK
basılar	b AG a AK s AH ɯ AK l AD a AK ɾ BE
basın	b AG a AK s AH ɯ AK n AF
basınlar	b AG a AK s AH ɯ AK n AF l AD a AK ɾ BE
basını	b AG a AK s AH ɯ AK n AF ɯ AK
basıyı	b AG a AK s AH ɯ AK j AB ɯ AK
batmak	b AG ɑ AK t AC m AE ɑ AK k AC
batman	b AG ɑ AK t AC m AE ɑ AK n AF
bay	b AG a AK j AB
bayak	b AG ɑ AK j AB ɑ AK k AC
baykuş	b AG ɑ AK j AB k AC u AM ʃ AH
bayrak	b AG ɑ AK j AB ɾ BE ɑ AK k AC
bayraklar	b AG ɑ AK j AB ɾ BE ɑ AK k AC l AD ɑ AK ɾ BE
bayram	b AG a AK j AB ɾ BE a AK m AE
bayılmak	b AG ɑ AK j AB ɯ AK ɫ AD m AE ɑ AK k AC
bazalt	b AG a AK z AH a AK l AD t AC
bazaltlar	b AG a AK z AH a AK l AD t AC l AD a AK ɾ BE
bazaltı	b AG a AK z AH a AK l AD t AC ɯ AK
bazen	b AG aː AL z AH e AK n AF
bağımlılık	b AG ɑ AK ɯ AK m AE l AD ɯ AK l AD ɯ AK c AC
bağımlılıklar	b AG ɑ AK ɯ AK m AE l AD ɯ AK l AD ɯ AK c AC l AD a AK ɾ BE
bağımlılığı	b AG ɑ AK ɯ AK m AE l AD ɯ AK l AD ɯ AK ɯ AK
başa	b AG a AK ʃ AH a AK
başarmak	b AG a AK ʃ AH a AK ɾ BE m AE a AK k AC
başarılı	b AG ɑ AK ʃ AH ɑ AK ɾ BE ɯ AK ɫ AD ɯ AK
başka	b AG ɑ AK ʃ AH k AC ɑ AK
başla	b AG a AK ʃ AH l AD a AK
başlık	b AG ɑ AK ʃ AH ɫ AD ɯ AK k AC
başsa	b AG a AK ʃ AH s AH a AK
başvurular	b AG a AK ʃ AH v BB u AM ɾ BE u AM l AD a AK ɾ BE
başvurusu	b AG a AK ʃ AH v BB u AM ɾ BE u AM s AH u AM
başvuruya	b AG a AK ʃ AH v BB u AM ɾ BE u AM j AB a AK
başvuruyu	b AG a AK ʃ AH v BB u AM ɾ BE u AM j AB u AM
başını	b AG a AK ʃ AH ɯ AK n AF ɯ AK
beden	b AG e AK d AC æ AK n AF
bej	b AG e AK ʒ AH
bel	b AG ɛ AK l AD
belge	b AG e AK l AD ɟ AC ɛ AK
belirli	b AG e AK l AD i AK ɾ BE l AD i AK
belirsiz	b AG e AK l AD i AK ɾ BE s AH i AK z AH
belki	b AG ɛ AK l AD c AC ɪ AK
ben	b AG ɛ AK n AF
bencil	b AG e AK n AF d AC ʒ AH i AK l AD
beni	b AG e AK n AF i AK
benim	b AG e AK n AF i AK m AE
beniz	b AG e AK n AF i AK z AH
berkay	b AG e AK ɾ BE k AC a AK j AB
berker	b AG e AK ɾ BE k AC e AK ɾ BE
beslemek	b AG e AK s AH l AD e AK m AE e AK c AC
beslememek	b AG e AK s AH l AD e AK m AE e AK c AC
beslemez	b AG e AK s AH l AD e AK m AE e AK z AH
besler	b AG e AK s AH l AD e AK ɾ BE
betik	b AG ɛ AK t AC i AK c AC
betikle	b AG ɛ AK t AC i AK c AC l AD e AK
betikler	b AG ɛ AK t AC i AK c AC l AD e AK ɾ BE
betiği	b AG ɛ AK t AC i AK j AB i AK
beyaz	b AG e AK j AB ɑ AK z AH
bez	b AG e AK z AH
bezi	b AG e AK z AH i AK
bezler	b AG e AK z AH l AD e AK ɾ BE
beş	b AG e AK ʃ AH
beşer	b AG e AK ʃ AH æ AK r BA
bilet	b AG i AK l AD ɛ AK t AC
bilge	b AG i AK l AD ɟ AC e AK
bilgin	b AG i AK l AD ɟ AC i AK n AF
bilgisayarla	b AG i AK l AD ɡ AC i AK s AH a AK j AB a AK ɾ BE l AD a AK
bilgisayarlı	b AG i AK l AD ɡ AC i AK s AH a AK j AB a AK ɾ BE l AD ɯ AK
bilgisayarsa	b AG i AK l AD ɡ AC i AK s AH a AK j AB a AK ɾ BE s AH a AK
bilgisayarsız	b AG i AK l AD ɡ AC i AK s AH a AK j AB a AK ɾ BE s AH ɯ AK z AH
bin	b AG i AK n AF
bina	b AG i AK n AF ɑː AL
binyıl	b AG i AK n AF j AB ɯ AK l AD
bir	b AG i AK ɾ̝̊
birer	b AG i AK r BA æ AK r BA
birinci	b AG i AK ɾ BE i AK n AF d AC ʒ AH i AK
birçok	b AG i AK ɾ BE t AC ʃ AH o AM k AC
bisküvi	b AG i AK s AH k AC y AM v BB i AK
bit	b AG i AK t AC
biz	b AG ɪ AK z AH
bizim	b AG ɪ AK z AH i AK m AE
bişkek	b AG i AK ʃ AH c AC ɛ AK c AC
bluz	b AG l AD u AM z AH
bluza	b AG l AD u AM z AH a AK
bluzla	b AG l AD u AM z AH l AD a AK
bluzlar	b AG l AD u AM z AH l AD a AK ɾ BE
bluzlu	b AG l AD u AM z AH l AD u AM
bluzlular	b AG l AD u AM z AH l AD u AM l AD a AK ɾ BE
bluzluyu	b AG l AD u AM z AH l AD u AM j AB u AM
bluzsa	b AG l AD u AM z AH s AH a AK
bluzsuz	b AG l AD u AM z AH s AH u AM z AH
bluzsuzlar	b AG l AD u AM z AH s AH u AM z AH l AD a AK ɾ BE
bluzsuzu	b AG l AD u AM z AH s AH u AM z AH u AM
bluzu	b AG l AD u AM z AH u AM
bok	b AG o AM k AC
boklar	b AG ɔ AM k AC l AD ɑ AK ɾ BE
boksör	b AG o AM k AC s AH œ AM r BA
boz	b AG o AM z AH
bozok	b AG o AM z AH o AM k AC
boğaz	b AG o AM a AK z AH
boğazlar	b AG o AM a AK z AH l AD a AK ɾ BE
boğazı	b AG o AM a AK z AH ɯ AK
bu	b AG u AM
bugün	b AG u AM ɟ AC y AM n AF
bulgarca	b AG u AM ɫ AD ɟ AC ʌ AK ɾ BE d AC ʒ AH ʌ AK
bulgur	b AG u AM ɫ AD ɡ AC u AM ɾ BE
burak	b AG u AM ɾ BE a AK k AC
bursa	b AG u AM r BA s AH a AK
burç	b AG u AM r BA t AC ʃ AH
buz	b AG u AM z AH
buzla	b AG u AM z AH l AD a AK
buzlar	b AG u AM z AH l AD a AK ɾ BE
buzsa	b AG u AM z AH s AH a AK
buzsuz	b AG u AM z AH s AH u AM z AH
buzu	b AG u AM z AH u AM
buçuk	b AG u AM t AC ʃ AH u AM k AC
buğra	b AG u AM ɣ AH ɾ BE ʌː AL
böbrek	b AG œ AM b AG ɾ BE e AK k AC
böcek	b AG ø AM d AC ʒ AH ɛ AK c AC
bölüm	b AG ø AM l AD y AM m AE
böyle	b AG œ AM j AB l AD ɛ AK
böğür	b AG ø AM ø AM ɾ̝̊
böğürtlen	b AG œ AM ɣ AH y AM ɾ BE t AC l AD e AK n AF
bükülmem	b AG y AM k AC y AM l AD m AE e AK m AE
bütçe	b AG y AM t AC ʃ AH e AK
bütün	b AG y AM t AC y AM n AF
bıçak	b AG ɯ AK t AC ʃ AH ɑ AK k AC
c	d AC ʒ AH ɛː AL
cacık	d AC ʒ AH ɑ AK d AC ʒ AH ɯ AK c AC
cadı	d AC ʒ AH a AK d AC ɯ AK
cam	d AC ʒ AH a AK m AE
can	d AC ʒ AH a AK n AF
canberk	d AC ʒ AH a AK n AF b AG e AK ɾ BE k AC
cep	d AC ʒ AH e AK p AG
cerahatlen	d AC ʒ AH e AK ɾ BE a AK h AA a AK t AC l AD e AK n AF
cerahatlenir	d AC ʒ AH e AK ɾ BE a AK h AA a AK t AC l AD e AK n AF i AK r BA
cerahatlenme	d AC ʒ AH e AK ɾ BE a AK h AA a AK t AC l AD e AK n AF m AE e AK
cerahatlenmek	d AC ʒ AH e AK ɾ BE a AK h AA a AK t AC l AD e AK n AF m AE e AK c AC
cerahatlenmeler	d AC ʒ AH e AK ɾ BE a AK h AA a AK t AC l AD e AK n AF m AE e AK l AD e AK ɾ BE
cerahatlenmeme	d AC ʒ AH e AK ɾ BE a AK h AA a AK t AC l AD e AK n AF m AE e AK m AE e AK
cerahatlenmemek	d AC ʒ AH e AK ɾ BE a AK h AA a AK t AC l AD e AK n AF m AE e AK m AE e AK c AC
cerahatlenmemeler	d AC ʒ AH e AK ɾ BE a AK h AA a AK t AC l AD e AK n AF m AE e AK m AE e AK l AD e AK ɾ BE
cerahatlenmemeyi	d AC ʒ AH e AK ɾ BE a AK h AA a AK t AC l AD e AK n AF m AE e AK m AE e AK j AB i AK
cerahatlenmeyi	d AC ʒ AH e AK ɾ BE a AK h AA a AK t AC l AD e AK n AF m AE e AK j AB i AK
cerahatlenmez	d AC ʒ AH e AK ɾ BE a AK h AA a AK t AC l AD e AK n AF m AE e AK z AH
cibinlik	d AC ʒ AH i AK b AG i AK n AF l AD i AK c AC
cihadı	d AC ʒ AH i AK h AA a AK d AC ɯ AK
cihan	d AC ʒ AH i AK h AA a AK n AF
cihat	d AC ʒ AH i AK h AA a AK t AC
cihatlar	d AC ʒ AH i AK h AA a AK t AC l AD a AK ɾ BE
cins	d AC ʒ AH i AK n AF s AH
cinsel	d AC ʒ AH ɪ AK n AF s AH ɛ AK l AD
civara	c AC i AK v BB a AK ɾ BE a AK
civarda	c AC i AK v BB a AK ɾ BE d AC a AK
civardan	c AC i AK v BB a AK ɾ BE d AC a AK n AF
civarlara	c AC i AK v BB a AK ɾ BE l AD a AK ɾ BE a AK
civarlarda	c AC i AK v BB a AK l AD a AK ɾ BE d AC a AK
civarlardan	c AC i AK v BB a AK l AD a AK ɾ BE d AC a AK n AF
civarları	c AC i AK v BB a AK l AD a AK ɾ BE ɯ AK
civarların	c AC i AK v BB a AK l AD a AK ɾ BE ɯ AK n AF
civarı	c AC i AK v BB a AK ɾ BE ɯ AK
civarın	c AC i AK v BB a AK ɾ BE ɯ AK n AF
ciğer	d AC ʒ AH i AK j AB æ AK ɾ BE
concon	d AC ʒ AH o AM n AF d AC ʒ AH o AM n AF
conconlar	d AC ʒ AH o AM n AF d AC ʒ AH o AM n AF l AD a AK ɾ BE
conconu	d AC ʒ AH o AM n AF d AC ʒ AH o AM n AF u AM
cuma	d AC ʒ AH ʊ AM m AE ɑː AL
cumartesi	d AC ʒ AH ʊ AM m AE ɑ AK ɾ BE t AC ɛ AK s AH ɪ AK
cumhurbaşkanı	d AC ʒ AH u AM m AE h AA u AM ɾ BE b AG a AK ʃ AH k AC a AK n AF ɯ AK
cumhuriyet	d AC ʒ AH u AM m AE h AA uː AN ɾ BE i AK j AB e AK t AC
cüneyt	d AC ʒ AH y AM n AF ɛ AK j AB t AC
cık	t AC ɪ AK s AH k AC
daha	d AC a AK h AA a AK
daire	d AC a AK i AK ɾ BE e AK
daireler	d AC a AK i AK ɾ BE e AK l AD e AK ɾ BE
daireyi	d AC a AK i AK ɾ BE e AK j AB i AK
daktilo	d AC a AK k AC t AC i AK l AD ɔ AM
daktilolar	d AC a AK k AC t AC ɨ AK l AD ɔ AM l AD a AK ɾ BE
daktiloyla	d AC a AK k AC t AC ɨ AK l AD o AM j AB l AD a AK
daktiloysa	d AC a AK k AC t AC ɨ AK l AD o AM j AB s AH a AK
daktiloyu	d AC a AK k AC t AC ɨ AK l AD ɔ AM j AB u AM
dal	d AC a AK ɫ AD
dalga	d AC a AK l AD ɡ AC a AK
dalgalar	d AC a AK l AD ɡ AC a AK l AD a AK ɾ BE
dalgayı	d AC a AK l AD ɡ AC a AK j AB ɯ AK
dam	d AC ɑ AK m AE
damacana	d AC a AK m AE a AK d AC ʒ AH a AK n AF a AK
damlacık	d AC a AK m AE ɫ AD a AK d AC ʒ AH ɯ AK k AC
dansçı	d AC a AK n AF s AH t AC ʃ AH ɯ AK
danışmak	d AC ɑ AK n AF ɯ AK ʃ AH m AE ɑ AK k AC
darbe	d AC a AK ɾ BE b AG e AK
darmadağınık	d AC a AK r BA m AE a AK d AC a AK ɯ AK n AF ɯ AK k AC
darp	d AC a AK ɾ BE p AG
dağ	d AC a AK ɰ AB
dağcı	d AC ɑː AL d AC ʒ AH ɯ AK
dağcılık	d AC ɑː AL d AC ʒ AH ɯ AK ɫ AD ɯ AK k AC
dağlık	d AC ɑː AL ɫ AD ɯ AK k AC
dağınık	d AC a AK ɯ AK n AF ɯ AK k AC
define	d AC e AK f BB iː AL n AF e AK
deist	d AC e AK i AK s AH t AC
deisti	d AC e AK i AK s AH t AC i AK
deistin	d AC e AK i AK s AH t AC i AK n AF
deistler	d AC e AK i AK s AH t AC l AD e AK ɾ BE
deli	d AC ɛ AK l AD i AK
demirci	d AC ɛ AK m AE i AK ɾ BE d AC ʒ AH i AK
deneyim	d AC ɛ AK n AF ɛ AK j AB i AK m AE
denge	d AC e AK n AF ɡ AC e AK
dengeler	d AC e AK n AF ɡ AC e AK l AD e AK ɾ BE
dengeyi	d AC e AK n AF ɡ AC e AK j AB i AK
denizaltı	d AC ɛ AK n AF i AK z AH a AK ɫ AD t AC ɯ AK
ders	d AC e AK ɾ BE s AH
değer	d AC e AK j AB e AK ɾ BE
değeri	d AC e AK e AK ɾ BE i AK
değerler	d AC e AK e AK r BA ɫ AD e AK ɾ BE
değil	d AC e AK j AB i AK l AD
değmezler	d AC e AK m AE e AK z AH ɫ AD e AK ɾ BE
dil	d AC i AK l AD
dilde	d AC i AK l AD d AC e AK
dilden	d AC i AK l AD d AC e AK n AF
dile	d AC i AK l AD e AK
dili	d AC i AK l AD i AK
dilin	d AC i AK l AD i AK n AF
diller	d AC i AK l AD l AD e AK ɾ BE
dillerde	d AC i AK l AD l AD e AK ɾ BE d AC e AK
dillerden	d AC i AK l AD l AD e AK ɾ BE d AC e AK n AF
dillere	d AC i AK l AD l AD e AK ɾ BE e AK
dilleri	d AC i AK l AD l AD e AK ɾ BE i AK
dillerin	d AC i AK l AD l AD e AK ɾ BE i AK n AF
dilli	d AC i AK l AD l AD i AK
dilsiz	d AC i AK l AD s AH i AK z AH
dilsizi	d AC i AK l AD s AH i AK z AH i AK
dilsizler	d AC i AK l AD s AH i AK z AH l AD e AK ɾ BE
dilsizlik	d AC i AK l AD s AH i AK z AH l AD i AK c AC
dilsizlikler	d AC i AK l AD s AH i AK z AH l AD i AK c AC l AD e AK ɾ BE
dilsizliği	d AC i AK l AD s AH i AK z AH l AD i AK j AB i AK
dinlenmek	d AC i AK n AF l AD e AK n AF m AE e AK c AC
diyabet	d AC i AK j AB a AK b AG e AK t AC
diyalog	d AC i AK j AB ɑ AK l AD o AM ɡ AC
dizeler	d AC i AK z AH e AK ɫ AD e AK ɾ BE
dizem	d AC i AK z AH e AK m AE
dizen	d AC i AK z AH e AK n AF
dizesi	d AC i AK z AH e AK s AH i AK
dizeyi	d AC i AK z AH e AK j AB i AK
diğer	d AC i AK j AB e AK ɾ BE
dişi	d AC i AK ʃ AH i AK
dişlek	d AC i AK ʃ AH ɫ AD e AK c AC
dişleklik	d AC i AK ʃ AH ɫ AD e AK k AC ɫ AD i AK c AC
dişçi	d AC i AK ʃ AH t AC ʃ AH i AK
dok	d AC o AM k AC
dokuz	d AC o AM k AC u AM z AH
dokuzar	d AC o AM k AC u AM z AH a AK r BA
dolap	d AC o AM ɫ AD a AK p AG
donanım	d AC o AM n AF a AK n AF ɯ AK m AE
donanımlar	d AC o AM n AF a AK ɯ AK m AE l AD a AK ɾ BE
donanımları	d AC o AM n AF a AK n AF ɯ AK m AE l AD a AK ɾ BE ɯ AK
donanımı	d AC o AM n AF a AK n AF ɯ AK m AE ɯ AK
dondurma	d AC o AM n AF d AC u AM ɾ BE m AE a AK
doğmak	d AC o AM ɣ AH m AE a AK k AC
doğru	d AC o AM ɰ AB ɾ BE u AM
doğurmak	d AC o AM ɰ AB u AM ɾ BE m AE ɑ AK k AC
doğuş	d AC o AM u AM ʃ AH
durak	d AC u AM ɾ BE ɑ AK k AC
dut	d AC u AM t AC
duygu	d AC u AM j AB ɡ AC u AM
dyugudyugu	dʲ AC u AM ɡ AC u AM dʲ AC u AM ɡ AC u AM
dörder	d AC ø AM r BA d AC æ AK r BA
dört	d AC œ AM ɾ BE t AC
dükkân	d AC y AM c AC c AC a AK n AF
dümen	d AC y AM m AE e AK n AF
dünyevî	d AC y AM n AF j AB e AK v BB iː AL
dürüst	d AC y AM ɾ BE y AM s AH t AC
düğüm	d AC y AM j AB y AM m AE
düğün	d AC y AM ɰ AB y AM n AF
düş	d AC ʏ AM ʃ AH
düşünce	d AC y AM ʃ AH y AM n AF d AC ʒ AH e AK
dışarı	d AC ɯ AK ʃ AH a AK ɾ BE ɯ AK
edebiyat	e AK d AC e AK b AG i AK j AB aː AL t AC
edebiyatçı	e AK d AC e AK b AG i AK j AB a AK t AC t AC ʃ AH ɯ AK
edilmek	e AK d AC i AK l AD m AE e AK c AC
edilmemek	e AK d AC i AK ɫ AD m AE e AK m AE e AK c AC
ediz	e AK d AC i AK z AH
ediz'i	e AK d AC i AK z AH i AK
ediz'le	e AK d AC i AK z AH l AD e AK
ediz'ler	e AK d AC i AK z AH l AD e AK ɾ BE
ediz'li	e AK d AC i AK z AH l AD i AK
ediz'siz	e AK d AC i AK z AH s AH i AK z AH
edizler	e AK d AC i AK z AH l AD e AK ɾ BE
egemen	e AK ɟ AC e AK m AE ɛ AK n AF
ehliyet	e AK h AA l AD i AK j AB e AK t AC
eklemeli	e AK c AC l AD e AK m AE e AK l AD i AK
eklemesiz	e AK c AC l AD e AK m AE e AK s AH i AK z AH
ekmek	e AK c AC m AE e AK c AC
el	ə AK l AD
elhamdülillah	e AK ɫ AD h AA a AK m AE d AC y AM ɫ AD i AK l AD l AD ä h AA
elifbe	e AK l AD i AK f BB b AG eː AL
emetofobi	e AK m AE e AK t AC o AM f BB o AM b AG i AK
emir	e AK m AE i AK ɾ BE
emmi	e AK m AE m AE i AK
enfeksiyon	ɛ AK n AF f BB ɛ AK c AC s AH i AK j AB o AM n AF
engin	ɛ AK n AF ɟ AC i AK n AF
enjeksiyon	e AK n AF ʒ AH e AK c AC s AH i AK j AB o AM n AF
enjeksiyonlar	e AK n AF ʒ AH e AK c AC s AH i AK j AB o AM n AF l AD a AK ɾ BE
enjeksiyonları	e AK n AF ʒ AH e AK c AC s AH i AK j AB o AM n AF l AD a AK ɾ BE ɯ AK
enjeksiyonu	e AK n AF ʒ AH e AK c AC s AH i AK j AB o AM n AF u AM
enjeksiyonunu	e AK n AF ʒ AH e AK c AC s AH i AK j AB o AM n AF u AM n AF u AM
enç	e AK n AF t AC ʃ AH
ercan	e AK ɾ BE d AC ʒ AH a AK n AF
erdoğan	e AK ɾ BE d AC o AM ɰ AB a AK n AF
erkek	æ AK ɾ BE c AC e AK c AC
ermenice	e AK ɾ BE m AE e AK n AF i AK d AC ʒ AH e AK
ertunç	e AK ɾ BE t AC u AM n AF t AC ʃ AH
estonya	ɛ AK s AH t AC ɔ AM n AF j AB a AK
et	ɛ AK t AC
etiyopyalı	e AK t AC i AK y AM o AM p AG y AM a AK ɫ AD ɯ AK
evcil	e AK β BB d AC ʒ AH i AK l AD
evet	e AK v BB e AK t AC
evle	e AK v BB ɫ AD e AK
evlenmek	e AK v BB l AD e AK n AF m AE e AK c AC
evler	e AK v BB ɫ AD e AK ɾ BE
evli	ɛ AK v BB l AD i AK
evlilikler	e AK v BB l AD i AK l AD i AK c AC l AD æ AK r BA
evse	e AK v BB s AH e AK
evsiz	e AK v BB s AH i AK z AH
ezgi	e AK z AH ɡ AC i AK
eğer	e AK ɣ AH e AK r BA
eğitim	ɛ AK ɤ AK ɨ AK t AC ɨ AK m AE
eğlence	e AK ɰ AB l AD e AK n AF d AC ʒ AH e AK
eğlenmek	eː AL l AD e AK n AF m AE e AK c AC
eşantiyon	ɛ AK ʃ AH a AK n AF t AC i AK j AB o AM n AF
eşantiyonlar	ɛ AK ʃ AH a AK n AF t AC i AK j AB o AM n AF l AD a AK ɾ BE
eşantiyonu	ɛ AK ʃ AH a AK n AF t AC i AK j AB o AM n AF u AM
eşek	e AK ʃ AH e AK c AC
fagofobi	f BB ɑ AK ɡ AC o AM f BB o AM b AG i AK
fakir	f BB a AK c AC i AK r BA
fark	f BB a AK ɾ BE k AC
farka	f BB a AK ɾ BE c AC a AK
farklar	f BB a AK ɾ BE c AC l AD a AK ɾ BE
farkı	f BB a AK ɾ BE c AC ɯ AK
fasık	f BB ɑː AL s AH ɯ AK c AC
fasıklar	f BB ɑː AL s AH ɯ AK c AC l AD a AK ɾ BE
fasığı	f BB ɑː AL s AH ɯ AK ɯ AK
fatih	f BB aː AL t AC i AK h AA
fazla	f BB ɑ AK z AH ɫ AD ɑ AK
felsefe	f BB e AK l AD s AH e AK f BB e AK
felsefeler	f BB e AK l AD s AH e AK f BB e AK l AD e AK ɾ BE
felsefeyi	f BB e AK l AD s AH e AK f BB e AK j AB i AK
feribot	f BB e AK ɾ BE i AK b AG o AM t AC
fetva	f BB e AK t AC v BB aː AL
fetö	f BB e AK t AC œ AM
fibrinojen	f BB i AK b AG ɾ BE i AK n AF o AM ʒ AH e AK n AF
figür	f BB i AK ɟ AC y AM ɾ BE
fiil	f BB iː AL l AD
fil	f BB i AK l AD
filistin	f BB i AK l AD i AK s AH t AC i AK n AF
film	f BB i AK l AD m AE
fince	f BB i AK n AF d AC ʒ AH ɛ AK
fitil	f BB i AK t AC i AK l AD
fobofobi	f BB o AM b AG o AM f BB o AM b AG i AK
fonksiyonlar	f BB o AM n AF c AC s AH i AK j AB o AM n AF l AD a AK ɾ BE
fotoğrafçı	f BB o AM t AC oː AN ɾ BE a AK f BB t AC ʃ AH ɯ AK
frambuaz	f BB ɾ BE a AK m AE b AG uː AN a AK z AH
fukara	f BB u AM k AC a AK r BA aː AL
futbol	f BB u AM t AC b AG ɔ AM ɫ AD
futbolcu	f BB u AM t AC b AG o AM ɫ AD d AC ʒ AH u AM
fıkra	f BB ɯ AK k AC r BA a AK
gazete	ɡ AC a AK z AH ɛ AK t AC ɛ AK
gefirofobi	ɟ AC e AK f BB i AK ɾ BE o AM f BB o AM b AG i AK
gel	ɟ AC ɛ AK l AD
geldin	ɡ AC e AK l AD d AC i AK n AF
geldiniz	ɡ AC e AK l AD d AC i AK n AF i AK z AH
gelincik	ɟ AC e AK l AD i AK n AF d AC ʒ AH i AK k AC
gelinmemek	ɡ AC ɛ AK ɫ AD i AK n AF m AE ɛ AK m AE ɛ AK c AC
gelirler	ɡ AC e AK ɫ AD i AK r BA ɫ AD e AK ɾ BE
gelişme	ɡ AC e AK l AD i AK ʃ AH m AE e AK
gelişmeler	ɡ AC e AK l AD i AK ʃ AH m AE e AK l AD e AK ɾ BE
gelişmeme	ɡ AC e AK l AD i AK ʃ AH m AE e AK m AE e AK
gelişmemeler	ɡ AC e AK l AD i AK ʃ AH m AE e AK m AE e AK l AD e AK ɾ BE
gelişmemeyi	ɡ AC e AK l AD i AK ʃ AH m AE e AK m AE e AK j AB i AK
gelişmeyi	ɡ AC e AK l AD i AK ʃ AH m AE e AK j AB i AK
geliştir	ɡ AC e AK ɫ AD i AK ʃ AH t AC i AK ɾ BE
geliştirici	ɡ AC e AK l AD i AK ʃ AH t AC i AK ɾ BE i AK d AC ʒ AH i AK
geliştiriciler	ɡ AC e AK l AD i AK ʃ AH t AC i AK ɾ BE i AK d AC ʒ AH i AK j AB i AK l AD e AK ɾ BE
geliştiriciyi	ɡ AC e AK l AD i AK ʃ AH t AC i AK ɾ BE i AK d AC ʒ AH i AK j AB i AK
geliştirir	ɡ AC e AK ɫ AD i AK ʃ AH t AC i AK ɾ BE i AK ɾ BE
geliştirme	ɡ AC e AK ɫ AD i AK ʃ AH t AC i AK ɾ BE m AE e AK
geliştirmek	ɡ AC e AK ɫ AD i AK ʃ AH t AC i AK ɾ BE m AE e AK c AC
geliştirmeler	ɡ AC e AK ɫ AD i AK ʃ AH t AC i AK ɾ BE m AE e AK ɫ AD e AK ɾ BE
geliştirmemek	ɡ AC e AK ɫ AD i AK ʃ AH t AC i AK ɾ BE m AE e AK m AE e AK c AC
geliştirmeyi	ɡ AC e AK ɫ AD i AK ʃ AH t AC i AK ɾ BE m AE e AK j AB i AK
geliştirmez	ɡ AC e AK ɫ AD i AK ʃ AH t AC i AK ɾ BE m AE e AK z AH
gelmedin	ɡ AC e AK l AD m AE e AK d AC i AK n AF
gelmediniz	ɡ AC e AK l AD m AE e AK d AC i AK n AF i AK z AH
gelmemek	ɡ AC ɛ AK ɫ AD m AE ɛ AK m AE ɛ AK c AC
gelmezler	ɡ AC e AK m AE e AK z AH ɫ AD e AK ɾ BE
genofobi	ɟ AC e AK n AF o AM f BB o AM b AG i AK
gerek	ɟ AC e AK ɾ BE e AK c AC
gerçek	ɟ AC æ AK ɾ BE t AC ʃ AH e AK c AC
gerçekten	ɟ AC e AK ɾ BE t AC ʃ AH e AK c AC t AC e AK n AF
gey	ɟ AC e AK j AB
geyşa	ɟ AC ɛ AK j AB ʃ AH ɑ AK
gezegen	ɡ AC e AK z AH e AK ɡ AC e AK n AF
gezegende	ɡ AC e AK z AH e AK ɡ AC e AK n AF d AC e AK
gezegeni	ɡ AC e AK z AH e AK ɡ AC e AK n AF i AK
gezegenler	ɡ AC e AK z AH e AK ɡ AC e AK n AF l AD e AK ɾ BE
geçidi	ɡ AC e AK t AC ʃ AH i AK d AC i AK
geçidini	ɡ AC e AK t AC ʃ AH i AK d AC i AK n AF i AK
geçit	ɡ AC e AK t AC ʃ AH i AK t AC
geçitler	ɡ AC e AK t AC ʃ AH i AK t AC l AD e AK ɾ BE
geçitleri	ɡ AC e AK t AC ʃ AH i AK t AC l AD e AK ɾ BE i AK
geğirmek	ɡ AC e AK j AB i AK ɾ BE m AE e AK c AC
gibi	ɡ AC i AK b AG i AK
giderim	ɟ AC i AK d̪ AC e AK ɾ BE i AK m AE
gir	i AK r BA
git	ɡ AC i AK t AC
gitar	ɟ AC i AK t AC a AK ɾ BE
gitme	ɡ AC i AK t AC m AE e AK
gitmedin	ɡ AC i AK t AC m AE e AK d AC i AK n AF
gitmediniz	ɡ AC i AK t AC m AE e AK d AC i AK n AF i AK z AH
gittin	ɡ AC i AK t AC t AC i AK n AF
gittiniz	ɡ AC i AK t AC t AC i AK n AF i AK z AH
giz	ɟ AC i AK z AH
gişe	ɡ AC i AK ʃ AH e AK
gişeler	ɡ AC i AK ʃ AH e AK l AD e AK ɾ BE
gişeyi	ɡ AC i AK ʃ AH e AK j AB i AK
gri	ɡ AC ɾ BE iː AL
gök	ɟ AC ø AM k AC
gökhan	ɟ AC œ AM c AC h AA a AK n AF
gökkuşağı	ɟ AC œ AM c AC k AC u AM ʃ AH ʌ AK ɣ AH ɯ AK
gökler	ɡ AC ø AM c AC l AD e AK ɾ BE
göksel	ɟ AC ø AM k AC s AH e AK l AD
gökyüzü	ɡ AC œ AM c AC j AB y AM z̟ AH y AM
göl	ɟ AC œ AM l AD
göz	ɟ AC ø AM z AH
gözden	ɟ AC œ AM z AH d AC e AK n AF
gözlükçü	ɟ AC œ AM z AH l AD y AM k AC t AC ʃ AH y AM
göğüs	ɟ AC œ AM ɰ AB y AM s AH
güdüm	ɟ AC y AM d AC y AM m AE
güdümler	ɟ AC y AM d AC y AM m AE l AD e AK ɾ BE
güdümü	ɟ AC y AM d AC y AM m AE y AM
güllü	ɟ AC y AM l AD l AD y AM
gün	ɡ AC y AM n AF
günahkâr	ɡ AC y AM n AF a AK h AA k AC j AB a AK ɾ BE
günahkârlar	ɡ AC y AM n AF a AK h AA k AC j AB a AK ɾ BE l AD a AK ɾ BE
günahkârı	ɡ AC y AM n AF a AK h AA k AC j AB a AK ɾ BE ɯ AK
günaydın	ɟ AC y AM n AF a AK j AB d AC ɯ AK n AF
günlük	ɟ AC y AM n AF l AD y AM c AC
günlükler	ɟ AC y AM n AF l AD y AM c AC l AD e AK ɾ BE
günlükleri	ɟ AC y AM n AF l AD y AM c AC l AD e AK ɾ BE i AK
günlüğü	ɟ AC y AM n AF l AD y AM j AB y AM
günlüğünü	ɟ AC y AM n AF l AD y AM j AB y AM n AF y AM
gürcüce	ɟ AC y AM ɾ BE d AC ʒ AH yː AN d AC ʒ AH ɛ AK
güvercin	ɟ AC y AM v BB e AK ɾ̝̊ d AC ʒ AH i AK n AF
güzel	ɟ AC y AM z AH ɛ AK l AD
güzergâh	ɟ AC y AM z AH e AK ɾ BE ɟ AC a AK h AA
hac	h AA ɑ AK d AC ʒ AH
hacı	h AA ɑ AK d AC ʒ AH ɯ AK
hacılık	h AA ɑ AK d AC ʒ AH ɯ AK ɫ AD ɯ AK k AC
had	h AA a AK d AC
hafriyat	h AA a AK f BB ɾ BE i AK j AB a AK t AC
hak	h AA ɑ AK k AC
hakan	h AA ɑː AL k AC ɑː AL n AF
hal	h AA ɑ AK lʲ AD
hala	h AA a AK ɫ AD a AK
hale	h AA aː AL l AD e AK
halüsinasyon	h AA a AK l AD y AM s AH i AK n AF a AK s AH j AB ɔ AM n AF
halı	h AA ä ɫ AD ɯ AK
hamdolsun	h AA a AK m AE d AC o AM ɫ AD s AH u AM n AF
hamur	h AA a AK m AE u AM ɾ BE
han	h AA a AK n AF
harp	h AA ɑ AK r BA p AG
harputlu	h AA ɑ AK ɾ BE p AG u AM t AC ɫ AD u AM
has	h AA a AK s AH
hasret	h AA a AK s AH ɾ BE e AK t AC
hatun	h AA ɑː AL t AC u AM n AF
hava	h AA ɑ AK v BB ɑ AK
havlu	h AA a AK v BB ɫ AD u AM
hayat	h AA ɑ AK j AB ɑ AK t AC
haymatlos	h AA a AK j AB m AE a AK t AC l AD oː AN s AH
hayırlı	h AA a AK j AB ɯ AK ɾ BE ɫ AD ɯ AK
haziran	h AA ɑ AK z AH iː AL r BA ɑ AK n AF
haçvari	h AA a AK t AC ʃ AH v BB aː AL ɾ BE i AK
hem	h AA e AK m AE
herkes	h AA æ AK ɾ BE c AC ɛ AK z AH
heykel	h AA e AK j AB c AC e AK l AD
hidayet	h AA i AK d AC aː AL j AB e AK t AC
hidayeti	h AA i AK d AC aː AL j AB e AK t AC i AK
hidayetler	h AA i AK d AC aː AL j AB e AK t AC l AD e AK ɾ BE
hikaye	h AA i AK k AC aː AL j AB e AK
hinterlant	h AA ɪ AK n AF t AC ə AK ɹ AB l AD æ AK n AF d AC
hipopotam	h AA i AK p AG o AM p AG o AM t AC a AK m AE
hiroşima	h AA i AK ɾ BE o AM ʃ AH i AK m AE ɑ AK
hisler	h AA i AK s AH l AD e AK ɾ BE
hâl	h AA ɑː AL lʲ AD
hâli	h AA aː AL l AD i AK
hâlini	h AA aː AL ɫ AD i AK n AF i AK
hâlleri	h AA aː AL ɫ AD ɫ AD e AK r BA i AK
hâlâ	h AA aː AL lʲ AD aː AL
hücre	h AA y AM d AC ʒ AH r BA ɛ AK
hükmü	h AA y AM k AC m AE y AM
hüküm	h AA y AM k AC y AM m AE
hükümler	h AA y AM k AC y AM m AE ɫ AD e AK ɾ BE
hırsız	h AA ɯ AK ɾ BE s AH ɯ AK z AH
idare	i AK d AC aː AL ɾ BE e AK
ideal	i AK d AC e AK a AK ɫ AD
ihtiyacı	i AK h AA t AC i AK j AB a AK d AC ʒ AH ɯ AK
ihtiyaç	i AK h AA t AC i AK j AB a AK t AC ʃ AH
ihtiyaçlar	i AK h AA t AC i AK j AB a AK d AC ʒ AH l AD a AK ɾ BE
iki	i AK k AC i AK
ikinci	i AK c AC i AK n AF d AC ʒ AH i AK
ikişer	i AK c AC i AK ʃ AH æ AK r BA
ilave	i AK l AD aː AL v BB e AK
ilaç	ɪ AK l AD a AK t AC ʃ AH
ilâç	ɪ AK l AD a AK t AC ʃ AH
imambayıldı	i AK m AE ɑ AK m AE b AG ɑ AK j AB ɯ AK ɫ AD d AC ɯ AK
ince	i AK n AF d AC ʒ AH ɛ AK
intikam	i AK n AF t AC i AK k AC a AK m AE
inşa	i AK n AF ʃ AH aː AL
inşaat	i AK n AF ʃ AH a AK a AK t AC
ip	i AK p AG
irak	ɯː AL ɾ BE a AK k AC
isyan	i AK s AH j AB a AK n AF
isyanlar	i AK s AH j AB a AK n AF l AD a AK ɾ BE
isyanı	i AK s AH j AB aː AL n AF ɯ AK
itaat	i AK t AC ɑː AL t AC
itilmek	i AK t AC i AK ɫ AD m AE e AK c AC
iyi	i AK j AB i AK
iyimser	i AK j AB i AK m AE s AH e AK ɾ BE
izbandut	i AK z AH b AG ɑ AK n AF d AC u AM t AC
izlek	i AK z AH ɫ AD e AK c AC
içer	i AK t AC ʃ AH e AK r BA
içerim	i AK t AC ʃ AH e AK r BA i AK m AE
içki	i AK t AC ʃ AH c AC i AK
iğne	iː AL n AF ɛ AK
iş	i AK ʃ AH
işaret	i AK ʃ AH aː AL ɾ BE e AK t AC
işareti	i AK ʃ AH aː AL ɾ BE e AK t AC i AK
işaretler	i AK ʃ AH aː AL ɾ BE e AK t AC l AD e AK ɾ BE
işlek	i AK ʃ AH ɫ AD e AK c AC
işlem	i AK ʃ AH l AD e AK m AE
işte	i AK ʃ AH t AC ɛ AK
işçi	i AK ʃ AH t AC ʃ AH i AK
işıktan	ɯ AK ʃ AH ɯ AK k AC t AC a AK n AF
i̇brahim	ɪ AK b AG r BA ɑ AK h AA ɪ AK m AE
i̇ngilizceleştirmek	i AK n AF ɟ AC i AK l AD i AK z AH d AC ʒ AH e AK l AD e AK ʃ AH t AC i AK ɾ BE m AE e AK c AC
i̇rlandalı	i AK ɾ BE l AD ɑ AK n AF d AC ɑ AK ɫ AD ɯ AK
i̇spanya	i AK s AH p AG ɑ AK n AF j AB ɑ AK
i̇spanyolca	i AK s AH p AG a AK n AF j AB o AM ɫ AD d AC ʒ AH a AK
i̇srailli	i AK s AH ɾ BE ɑː AL i AK l AD l AD i AK
i̇stanbullu	i AK s AH t AC ɑ AK n AF b AG u AM ɫ AD ɫ AD u AM
i̇talya	i AK t AC ɑ AK l AD j AB ɑ AK
i̇zlandaca	i AK z AH ɫ AD a AK n AF d AC a AK d AC ʒ AH a AK
j	ʒ AH
jale	ʒ AH a AK l AD e AK
japon	ʒ AH ɑ AK p AG o AM n AF
japonca	ʒ AH a AK p AG o AM n AF d AC ʒ AH a AK
jeolog	ʒ AH e AK o AM ɫ AD o AM ɡ AC
jeologlar	ʒ AH e AK o AM ɫ AD o AM ɡ AC l AD a AK ɾ BE
jeologu	ʒ AH e AK o AM ɫ AD o AM ɡ AC u AM
ji̇t	ʒ AH i AK t AC
ji̇tem	ʒ AH i AK t AC e AK m AE
kabak	k AC a AK b AG a AK k AC
kabinler	c AC a AK b AG i AK n AF l AD e AK ɾ BE
kablo	k AC a AK b AG ɫ AD ɔ AM
kabul	k AC a AK b AG uː AN lʲ AD
kadar	k AC ɑ AK d AC ɑ AK r BA
kader	k AC a AK d AC e AK r BA
kadın	k AC a AK d AC ɯ AK n AF
kalbur	k AC ɑ AK ɫ AD b AG u AM ɾ BE
kalkan	k AC a AK ɫ AD k AC a AK n AF
kan	k AC ɑ AK n AF
kanadalı	k AC ɑ AK n AF ɑ AK d AC ɑ AK ɫ AD ɯ AK
kanat	k AC ɑ AK n AF ɑ AK t AC
kaniş	k AC a AK n AF i AK ʃ AH
kap	k AC a AK p AG
kapa	k AC a AK p AG a AK
kapalı	k AC a AK p AG a AK l AD ɯ AK
kapama	k AC a AK p AG a AK m AE a AK
kapamak	k AC ɑ AK p AG ɑ AK m AE ɑ AK k AC
kapamalar	k AC a AK p AG a AK m AE a AK l AD a AK ɾ BE
kapamamak	k AC a AK p AG a AK m AE a AK m AE a AK c AC
kapamayı	k AC a AK p AG a AK m AE a AK j AB ɯ AK
kapibara	k AC a AK p AG i AK b AG a AK ɾ BE a AK
kaplumbağa	k AC a AK p AG ɫ AD ʊ AM m AE b AG aː AL
kaprisli	k AC a AK p AG ɾ BE i AK s AH l AD i AK
kapsam	k AC a AK p AG s AH a AK m AE
kapsamla	k AC a AK p AG s AH a AK m AE l AD a AK
kapsamlar	k AC a AK p AG s AH a AK m AE l AD a AK ɾ BE
kapsamlı	k AC a AK p AG s AH a AK m AE l AD ɯ AK
kapsamsa	k AC a AK p AG s AH a AK m AE s AH a AK
kapsamsız	k AC a AK p AG s AH a AK m AE s AH ɯ AK z AH
kapsamı	k AC a AK p AG s AH a AK m AE ɯ AK
kapuska	k AC a AK p AG u AM s AH k AC a AK
kapı	k AC a AK p AG ɯ AK
kar	k AC a AK ɾ BE
kara	k AC ɑ AK ɾ BE ɑ AK
karaciğer	k AC a AK ɾ BE a AK d AC ʒ AH iː AL e AK ɾ BE
karamsar	k AC a AK ɾ BE a AK m AE s AH a AK ɾ BE
karanfil	k AC a AK ɾ BE a AK n AF f BB i AK l AD
karar	k AC a AK ɾ BE a AK ɾ BE
karbonat	c AC a AK ɾ BE b AG o AM n AF a AK t AC
karbonatlar	c AC a AK ɾ BE b AG o AM n AF a AK t AC l AD a AK ɾ BE
karbonatı	c AC a AK ɾ BE b AG o AM n AF a AK t AC ɯ AK
karma	k AC a AK ɾ BE m AE a AK
karne	k AC ɑ AK ɾ BE n AF ɛ AK
karpuz	k AC a AK ɾ BE p AG u AM z AH
karıştırmak	k AC a AK ɾ BE ɯ AK ʃ AH t AC ɯ AK ɾ BE m AE a AK k AC
kaslı	k AC ɑ AK s AH ɫ AD ɯ AK
kasık	k AC ɑ AK s AH ɯ AK k AC
kasım	k AC ɑ AK s AH ɯ AK m AE
katalanca	k AC ɑ AK t AC ɑ AK ɫ AD ɑ AK n AF d AC ʒ AH ɑ AK
kategori	c AC a AK t AC e AK ɡ AC o AM ɾ BE i AK
kategoriler	c AC a AK t AC e AK ɡ AC o AM ɾ BE i AK l AD e AK ɾ BE
kategoriyi	c AC a AK t AC e AK ɡ AC o AM ɾ BE i AK j AB i AK
katil	k AC ɑː AL t AC i AK l AD
kavun	k AC a AK v BB u AM n AF
kaya	k AC ɑ AK j AB ɑ AK
kaybolmak	k AC a AK j AB b AG o AM ɫ AD m AE ɑ AK k AC
kaydı	k AC a AK j AB d AC ɯ AK
kaynak	k AC a AK j AB n AF a AK k AC
kaynaklamaz	c AC a AK j AB n AF a AK c AC l AD a AK m AE a AK z AH
kaynaklar	c AC a AK j AB n AF a AK c AC l AD a AK ɾ BE
kaynağı	c AC a AK j AB n AF a AK ɯ AK
kayık	k AC ɑ AK j AB ɯ AK k AC
kayıkçı	k AC ɑ AK j AB ɯ AK k AC t AC ʃ AH ɯ AK
kayısı	k AC a AK j AB ɯ AK s AH ɯ AK
kayıt	k AC a AK j AB ɯ AK t AC
kazanmak	k AC ɑ AK z AH ɑ AK n AF m AE ɑ AK k AC
kazma	k AC a AK z AH m AE a AK
kazı	k AC a AK z AH ɯ AK
kaşağı	k AC a AK ʃ AH a AK ɰ AB ɯ AK
kaşağılamaz	k AC a AK ʃ AH a AK ɰ AB ɯ AK l AD a AK m AE a AK z AH
kaşağılar	k AC a AK ʃ AH a AK ɰ AB ɯ AK l AD a AK ɾ BE
kaşağıyı	k AC a AK ʃ AH a AK ɰ AB ɯ AK j AB ɯ AK
kaşe	k AC a AK ʃ AH e AK
kaşelemez	k AC a AK ʃ AH e AK ɫ AD e AK m AE e AK z AH
kaşeler	k AC a AK ʃ AH e AK j AB i AK
kaşeyi	k AC a AK ʃ AH e AK j AB i AK
kedi	c AC e AK d AC i AK
kefal	c AC e AK f BB a AK l AD
kel	c AC ɛ AK l AD
kelepçe	k AC e AK ɫ AD e AK p AG t AC ʃ AH e AK
kemal	c AC e AK m AE a AK l AD
kemik	c AC e AK m AE i AK c AC
kemikler	k AC e AK m AE i AK k AC l AD e AK ɾ BE
kemiği	k AC e AK m AE i AK j AB i AK
kestirme	c AC e AK s AH t AC i AK ɾ BE m AE e AK
kestirmeler	k AC e AK s AH t AC i AK ɾ BE m AE e AK l AD e AK ɾ BE
kestirmeyi	c AC e AK s AH t AC i AK ɾ BE m AE e AK j AB i AK
keş	k AC e AK ʃ AH
keşkek	c AC e AK ʃ AH c AC ɛ AK c AC
ki	c AC i AK
kibutz	k AC i AK b AG u AM t AC z AH
kibutzlar	k AC i AK b AG u AM t AC z AH l AD a AK ɾ BE
kibutzu	k AC i AK b AG u AM t AC z AH u AM
kilise	c AC i AK l AD i AK s AH ɛ AK
kim	c AC i AK m AE
kimofobi	k AC i AK m AE o AM f BB o AM b AG i AK
kimya	c AC i AK m AE j AB aː AL
kimyacı	k AC i AK m AE j AB aː AL d AC ʒ AH ɯ AK
kimyalar	c AC i AK m AE j AB aː AL l AD a AK ɾ BE
kimyayı	c AC i AK m AE j AB aː AL j AB ɯ AK
kiraz	c AC i AK ɾ BE a AK z AH
kirpi	c AC i AK ɾ BE p AG i AK
kist	c AC i AK s AH t AC
kiste	c AC i AK s AH t AC e AK
kisti	c AC i AK s AH t AC i AK
kistin	c AC i AK s AH t AC t AC i AK n AF
kistler	c AC i AK s AH t AC l AD e AK ɾ BE
kistte	c AC i AK s AH t AC t AC e AK
kistten	c AC i AK s AH t AC t AC e AK n AF
klavye	k AC l AD a AK v BB j AB ɛ AK
klostrofobi	k AC ɫ AD o AM s AH t AC ɾ BE o AM f BB o AM b AG i AK
koca	k AC ɔ AM d AC ʒ AH ɑ AK
kodak	k AC o AM d AC a AK k AC
kokarca	k AC o AM k AC ɑ AK ɾ BE d AC ʒ AH ɑ AK
koklamak	k AC o AM k AC ɫ AD ɑ AK m AE ɑ AK k AC
kokmak	k AC o AM k AC m AE ɑ AK k AC
kokteyl	k AC o AM k AC t AC e AK j AB l AD
koku	k AC o AM k AC u AM
kol	k AC o AM ɫ AD
kolye	k AC o AM l AD j AB e AK
kombinasyon	k AC o AM m AE b AG i AK n AF a AK s AH j AB o AM n AF
kombinasyonla	k AC o AM m AE b AG i AK n AF a AK s AH j AB o AM n AF l AD a AK
kombinasyonlar	k AC o AM m AE b AG i AK n AF a AK s AH j AB o AM n AF l AD a AK ɾ BE
kombinasyonlu	k AC o AM m AE b AG i AK n AF a AK s AH j AB o AM n AF l AD u AM
kombinasyonsuz	k AC o AM m AE b AG i AK n AF a AK s AH j AB o AM n AF s AH u AM z AH
kombinasyonu	k AC o AM m AE b AG i AK n AF a AK s AH j AB o AM n AF a AK
koni	k AC o AM n AF ɪ AK
koruyucu	k AC o AM ɾ BE u AM j AB u AM d AC ʒ AH u AM
kovboy	k AC o AM v BB b AG o AM j AB
kul	k AC ʊ AM l AD
kula	k AC ʊ AM l AD a AK
kulak	k AC u AM ɫ AD ɑ AK k AC
kulda	k AC ʊ AM l AD d AC a AK
kullanıcı	k AC u AM ɫ AD ɫ AD a AK n AF ɯ AK d AC ʒ AH ɯ AK
kullar	k AC ʊ AM l AD l AD a AK ɾ BE
kulu	k AC ʊ AM l AD u AM
kulun	k AC ʊ AM l AD u AM n AF
kulübe	k AC u AM l AD y AM b AG ɛ AK
kum	k AC u AM m AE
kurbağa	k AC u AM ɾ BE b AG aː AL
kurgan	k AC u AM ɾ BE ɡ AC ɑ AK n AF
kuruşla	k AC u AM ɾ BE u AM ʃ AH l AD a AK
kuruşlar	k AC u AM ɾ BE u AM ʃ AH l AD a AK ɾ BE
kuruşu	k AC u AM ɾ BE u AM ʃ AH u AM
kutlama	k AC u AM t AC l AD a AK m AE a AK
kutsal	k AC u AM t AC s AH a AK ɫ AD
kuyu	k AC u AM j AB u AM
kuyumcu	k AC u AM j AB u AM m AE d AC ʒ AH u AM
kuğu	k AC u AM ɣ AH u AM
kuşak	k AC u AM ʃ AH a AK c AC
kuşaklar	k AC u AM ʃ AH a AK c AC l AD a AK ɾ BE
kuşağı	k AC u AM ʃ AH a AK ɯ AK
kâbe	k AC j AB aː AL b AG e AK
kâr	c AC a AK ɾ BE
kâse	c AC aː AL s AH e AK
kâseler	k AC j AB aː AL s AH e AK j AB i AK
kâseyi	k AC j AB aː AL s AH e AK j AB i AK
kör	k AC ø AM ɾ BE
köstebek	k AC œ AM s AH t AC ɛ AK b AG ɛ AK c AC
kötümser	c AC œ AM t AC y AM m AE s AH e AK ɾ BE
köyün	cʰ BF œ AM j AB y AM n AF
kül	c AC ʏ AM l AD
külfet	k AC y AM l AD f BB ɛ AK t AC
kültür	k AC y AM l AD t AC y AM ɾ BE
küpe	k AC y AM p AG ɛ AK
küçük	c AC y AM t AC ʃ AH y AM c AC
kılavuz	k AC ɯ AK ɫ AD ɑ AK v BB u AM z AH
kılıç	k AC ɯ AK ɫ AD ɯ AK t AC ʃ AH
kırklareli	k AC ɯ AK ɾ BE k AC ɫ AD ɑ AK ɾ BE ɛ AK l AD i AK
kırklarelili	k AC ɯ AK ɾ BE k AC ɫ AD ɑ AK ɾ BE ɛ AK l AD i AK l AD i AK
kırmızı	k AC ɯ AK ɾ BE m AE ɯ AK z AH ɯ AK
kırtasiye	k AC ɯ AK ɾ BE t AC aː AL s AH i AK j AB e AK
kırıklar	c AC ɯ AK ɾ BE ɯ AK c AC l AD a AK ɾ BE
kırılacak	k AC ɯ AK ɾ BE ɯ AK l AD a AK d AC ʒ AH a AK k AC
kırılacaklar	k AC ɯ AK ɾ BE ɯ AK l AD a AK d AC ʒ AH a AK k AC l AD a AK ɾ BE
kırığı	k AC ɯ AK ɾ BE ɯ AK ɯ AK
kısaltma	c AC ɯ AK s AH a AK l AD t AC m AE a AK
kısaltmalar	c AC ɯ AK s AH a AK l AD t AC m AE a AK l AD a AK ɾ BE
kısaltmaya	c AC ɯ AK s AH a AK l AD t AC m AE a AK j AB a AK
kısaltmayı	c AC ɯ AK s AH a AK l AD t AC m AE a AK j AB ɯ AK
kısayol	k AC ɯ AK s AH a AK j AB o AM l AD
kısayollar	k AC ɯ AK s AH a AK j AB o AM l AD l AD a AK ɾ BE
kısayolu	k AC ɯ AK s AH a AK j AB o AM l AD u AM
kısayolum	k AC ɯ AK s AH a AK j AB o AM l AD u AM m AE
kısayolun	k AC ɯ AK s AH a AK j AB o AM l AD u AM n AF
kısmet	k AC ɯ AK s AH m AE ɛ AK t AC
kıy	k AC ɯ AK j AB
kıyamet	k AC ɯ AK j AB aː AL m AE e AK t AC
kıymayın	k AC ɯ AK j AB m AE a AK j AB ɯ AK n AF
kıymet	k AC ɯ AK j AB m AE e AK t AC
kıymeti	k AC ɯ AK j AB m AE e AK t AC i AK
kıymetler	k AC ɯ AK j AB m AE e AK t AC l AD e AK ɾ BE
kıyı	k AC ɯ AK j AB ɯ AK
kıyılar	c AC ɯ AK j AB ɯ AK l AD a AK ɾ BE
kıyın	k AC ɯ AK j AB ɯ AK n AF
kıyınlar	k AC ɯ AK j AB ɯ AK n AF l AD a AK ɾ BE
kıyını	k AC ɯ AK j AB ɯ AK n AF ɯ AK
kıyıyı	c AC ɯ AK j AB ɯ AK j AB ɯ AK
kızıl	k AC ɯ AK z AH ɯ AK ɫ AD
kışla	k AC ɯ AK ʃ AH ɫ AD ɑ AK
lacivert	l AD aː AL d AC ʒ AH i AK v BB e AK ɾ BE t AC
laik	l AD ɑ AK i AK c AC
lehçe	l AD ɛ AK h AA t AC ʃ AH ɛ AK
letonca	l AD e AK t AC o AM n AF d AC ʒ AH a AK
leş	l AD ɛ AK ʃ AH
leşi	ɫ AD e AK ʃ AH i AK
leşler	ɫ AD e AK ʃ AH ɫ AD e AK ɾ BE
limon	l AD i AK m AE o AM n AF
lipofobi	l AD i AK p AG o AM f BB o AM b AG i AK
liralar	l AD i AK ɾ BE a AK l AD a AK ɾ BE
lirayla	l AD i AK ɾ BE a AK j AB l AD a AK
lisan	l AD i AK s AH a AK n AF
lisanlar	l AD i AK s AH a AK n AF l AD a AK ɾ BE
lisanı	l AD i AK s AH aː AL n AF ɯ AK
lise	l AD i AK s AH e AK
lokma	ɫ AD o AM k AC m AE a AK
lokmalar	ɫ AD o AM k AC m AE a AK ɫ AD a AK ɾ BE
lokmam	ɫ AD o AM k AC m AE a AK m AE
lokman	ɫ AD o AM k AC m AE a AK n AF
lokmanın	ɫ AD o AM k AC m AE a AK n AF ɯ AK n AF
lokması	ɫ AD o AM k AC m AE a AK s AH ɯ AK
lokmayı	ɫ AD o AM k AC m AE a AK j AB ɯ AK
londralı	l AD o AM n AF d AC ɾ BE ɑ AK ɫ AD ɯ AK
lütfen	l AD y AM t AC f BB ɛ AK n AF
maalesef	m AE a AK a AK l AD e AK s AH e AK f BB
maaş	m AE a AK a AK ʃ AH
macarca	m AE a AK d AC ʒ AH a AK ɾ BE d AC ʒ AH a AK
madde	m AE ɑ AK d AC d AC ɛ AK
maddeler	m AE a AK d AC d AC e AK l AD e AK ɾ BE
maddeyi	m AE a AK d AC d AC e AK j AB i AK
makedonya	m AE ɑ AK k AC ɛ AK d AC ɔ AM n AF j AB ɑ AK
mal	m AE ɑ AK ɫ AD
mallar	m AE a AK l AD l AD a AK ɾ BE
malı	m AE a AK l AD ɯ AK
mamut	m AE a AK m AE u AM t AC
manen	m AE aː AL n AF e AK n AF
mantar	m AE a AK n AF t AC a AK ɾ BE
mantarlar	m AE a AK n AF t AC a AK ɾ BE l AD a AK ɾ BE
mantarı	m AE a AK n AF t AC a AK ɾ BE ɯ AK
marangoz	m AE a AK ɾ BE a AK n AF ɡ AC o AM z AH
margarin	m AE ɑ AK ɾ BE ɡ AC ɑ AK ɾ BE i AK n AF
masaj	m AE a AK s AH a AK ʒ AH
masal	m AE ɑ AK s AH ɑ AK ɫ AD
masaüstü	m AE a AK s AH a AK ʔ AJ y AM s AH t AC y AM
masum	m AE ɑː AL s AH u AM m AE
masör	m AE a AK s AH ø AM ɾ BE
masörler	m AE a AK s AH ø AM ɾ BE l AD e AK ɾ BE
masörü	m AE a AK s AH ø AM ɾ BE y AM
matematik	m AE a AK t AC e AK m AE a AK t AC i AK c AC
matematikle	m AE a AK t AC e AK m AE a AK t AC i AK c AC l AD e AK
matematikler	m AE a AK t AC e AK m AE a AK t AC i AK c AC l AD e AK ɾ BE
matematikli	m AE a AK t AC e AK m AE a AK t AC i AK c AC l AD i AK
matematiksiz	m AE a AK t AC e AK m AE a AK t AC i AK c AC s AH i AK z AH
matematiği	m AE a AK t AC e AK m AE a AK t AC i AK j AB i AK
mazı	m AE ɑ AK z AH ɯ AK
mağara	m AE a AK a AK ɾ BE a AK
mektep	m AE ɛ AK k AC t AC ɛ AK p AG
melek	m AE ɛ AK l AD ɛ AK c AC
memnuniyet	m AE e AK m AE n AF uː AN n AF i AK j AB e AK t AC
memnuniyeti	m AE e AK m AE n AF uː AN n AF i AK j AB e AK t AC i AK
memnuniyetle	m AE e AK m AE n AF uː AN n AF i AK j AB e AK t AC l AD e AK
memnuniyetler	m AE e AK m AE n AF uː AN n AF i AK j AB e AK t AC l AD e AK ɾ BE
memnuniyetse	m AE e AK m AE n AF uː AN n AF i AK j AB e AK t AC s AH e AK
mendil	m AE e AK n AF d AC i AK l AD
menekşe	m AE ɛ AK n AF ɛ AK c AC ʃ AH ɛ AK
menü	m AE e AK n AF y AM
menüler	m AE e AK n AF y AM l AD e AK ɾ BE
menüyü	m AE e AK n AF y AM j AB y AM
merhaba	m AE ɛ AK ɾ BE a AK b AG a AK
merheba	m AE ɛ AK ɾ BE a AK b AG a AK
mert	m AE ɛ AK r BA t AC
mesafe	m AE e AK s AH aː AL f BB e AK
meslek	m AE e AK s AH l AD e AK c AC
mesul	m AE e AK s AH ʔ AJ u AM ɫ AD
mesuliyetli	m AE e AK s AH ʔ AJ uː AN l AD i AK j AB e AK t AC l AD i AK
mesuliyetsiz	m AE e AK s AH ʔ AJ uː AN l AD i AK j AB e AK t AC s AH i AK z AH
metre	m AE ɛ AK t AC ɾ BE ɛ AK
metres	m AE ɛ AK t AC ɾ BE ɛ AK s AH
mezar	m AE e AK z AH a AK ɾ BE
mezarlar	m AE e AK z AH a AK ɾ BE l AD a AK ɾ BE
mezarı	m AE e AK z AH a AK ɾ BE ɯ AK
mezra	m AE e AK z AH ɾ BE aː AL
mezralar	m AE e AK z AH ɾ BE aː AL l AD a AK ɾ BE
mezrayı	m AE e AK z AH ɾ BE aː AL j AB ɯ AK
meşe	m AE e AK ʃ AH e AK
meşeler	m AE e AK ʃ AH e AK ɫ AD e AK ɾ BE
meşem	m AE e AK ʃ AH e AK m AE
meşen	m AE e AK ʃ AH e AK n AF
meşenin	m AE e AK ʃ AH e AK n AF i AK n AF
meşeyi	m AE e AK ʃ AH e AK j AB i AK
mikroskop	m AE ɪ AK k AC r BA ɔ AM s AH k AC ɔ AM p AG
mil	m AE i AK l AD
milenyum	m AE i AK l AD e AK n AF j AB u AM m AE
mimar	m AE iː AL m AE ɑ AK r BA
minder	m AE i AK n AF d AC e AK r BA
mistik	m AE i AK s AH t AC i AK c AC
miço	m AE i AK t AC ʃ AH o AM
model	m AE o AM d AC e AK l AD
mor	m AE o AM ɾ BE
muck	m AE u AM d AC ʒ AH k AC
muhafiyet	m AE u AM x AH aː AL f BB i AK j AB e AK t AC
muhallebi	m AE u AM h AA a AK l AD l AD e AK b AG i AK
muhtaç	m AE u AM h AA t AC a AK t AC ʃ AH
mum	m AE u AM m AE
murat	m AE u AM ɾ BE a AK t AC
musa	m AE uː AN s AH aː AL
mustafa	m AE u AM s AH t AC a AK f BB a AK
muz	m AE u AM z AH
muş	m AE u AM ʃ AH
muşmula	m AE u AM ʃ AH m AE u AM ɫ AD a AK
mübadele	m AE y AM b AG aː AL d AC e AK l AD e AK
mübarek	m AE ʏ AM b AG a AK ɾ BE e AK c AC
müftü	m AE y AM f BB t AC y AM
müsaade	m AE y AM s AH a AK a AK d AC e AK
müslüman	m AE y AM s AH l AD y AM m AE ɑ AK n AF
müslümanlar	m AE y AM s AH l AD y AM m AE a AK n AF l AD a AK ɾ BE
müzakere	m AE y AM z AH aː AL k AC e AK ɾ BE e AK
müzakereler	m AE y AM z AH aː AL k AC e AK ɾ BE e AK l AD e AK ɾ BE
müzakereyi	m AE y AM z AH aː AL k AC e AK ɾ BE e AK j AB i AK
mısırlı	m AE ɯ AK s AH ɯ AK ɾ BE ɫ AD ɯ AK
mısırsız	m AE ɯ AK s AH ɯ AK ɾ BE s AH ɯ AK z AH
nah	n AF ɑ AK h AA
naif	n AF ɑː AL i AK f BB
nalci	n AF ɑ AK l AD d AC ʒ AH i AK
nargileler	n AF ɑ AK ɾ BE ɟ AC i AK l AD ɛ AK l AD ɛ AK ɾ BE
nargileyi	n AF ɑ AK ɾ BE ɟ AC i AK l AD ɛ AK j AB i AK
nasır	n AF a AK s AH ɯ AK ɾ BE
nasırda	n AF a AK s AH ɯ AK ɾ BE d AC a AK
nasırdan	n AF a AK s AH ɯ AK ɾ BE d AC a AK n AF
nasırlar	n AF a AK s AH ɯ AK ɾ BE l AD a AK ɾ BE
nasırlara	n AF a AK s AH ɯ AK ɾ BE l AD a AK ɾ BE a AK
nasırlarda	n AF a AK s AH ɯ AK ɾ BE l AD a AK ɾ BE d AC a AK
nasırlardan	n AF a AK s AH ɯ AK ɾ BE l AD a AK ɾ BE d AC a AK n AF
nasırları	n AF a AK s AH ɯ AK ɾ BE l AD a AK ɾ BE ɯ AK
nasırların	n AF a AK s AH ɯ AK ɾ BE l AD a AK ɾ BE ɯ AK n AF
nasırı	n AF a AK s AH ɯ AK ɾ BE ɯ AK
nasırın	n AF a AK s AH ɯ AK ɾ BE ɯ AK n AF
nataşa	n AF ɑ AK t AC ɑ AK ʃ AH ɑ AK
nedime	n AF e AK d AC iː AL m AE e AK
neptün	n AF e AK p AG t AC y AM n AF
nezle	n AF e AK z AH l AD e AK
neşriyat	n AF e AK ʃ AH r BA i AK j AB aː AL t AC
nida	n AF i AK d AC a AK
nil	n AF i AK l AD
nimet	n AF iː AL m AE e AK t AC
ninni	n AF i AK n AF n AF i AK
niçin	n AF iː AL t AC ʃ AH i AK n AF
nişanlı	n AF i AK ʃ AH a AK n AF ɫ AD ɯ AK
nomofobi	n AF o AM m AE o AM f BB o AM b AG i AK
numaralama	n AF u AM m AE a AK ɾ BE a AK l AD a AK m AE a AK
numaralamalar	n AF u AM m AE a AK ɾ BE a AK l AD a AK m AE a AK l AD a AK ɾ BE
numaralamama	n AF u AM m AE a AK ɾ BE a AK l AD a AK m AE a AK m AE a AK
numaralamamalar	n AF u AM m AE a AK ɾ BE a AK l AD a AK m AE a AK m AE a AK l AD a AK ɾ BE
numaralamamayı	n AF u AM m AE a AK ɾ BE a AK l AD a AK m AE a AK m AE a AK j AB ɯ AK
numaralamayı	n AF u AM m AE a AK ɾ BE a AK l AD a AK m AE a AK j AB ɯ AK
nur	n AF u AM ɾ BE
nöron	n AF œ AM r BA ɔ AM n AF
o	o AM
oburluk	o AM b AG u AM ɾ BE ɫ AD u AM k AC
ocak	o AM d AC ʒ AH a AK k AC
oha	ɔː AN h AA ɑː AL
oje	o AM ʒ AH ɛ AK
oku	o AM k AC u AM
okuma	o AM k AC u AM m AE a AK
okumak	o AM k AC u AM m AE a AK k AC
okumalar	o AM k AC u AM m AE a AK l AD a AK ɾ BE
okumayı	o AM k AC u AM m AE a AK j AB ɯ AK
ol	o AM l AD
olsun	o AM ɫ AD s AH u AM n AF
oluşmak	o AM ɫ AD u AM ʃ AH m AE ɑ AK k AC
oluşturmak	o AM ɫ AD u AM ʃ AH t AC u AM ɾ BE m AE ɑ AK k AC
ombudsman	o AM m AE b AG u AM d AC s AH m AE ɑ AK n AF
onar	o AM n AF a AK r BA
onlar	o AM n AF l AD a AK r BA
onur	o AM n AF u AM ɾ BE
optimizasyon	o AM p AG t AC i AK m AE i AK z AH a AK s AH j AB o AM n AF
optimizasyonlar	o AM p AG t AC i AK m AE i AK z AH a AK s AH j AB o AM n AF l AD a AK ɾ BE
optimizasyonu	o AM p AG t AC i AK m AE i AK z AH a AK s AH j AB o AM n AF u AM
oran	o AM ɾ BE a AK n AF
oranlar	o AM ɾ BE a AK n AF l AD a AK ɾ BE
oranı	o AM ɾ BE a AK n AF ɯ AK
ortak	o AM ɾ BE t AC a AK k AC
ortaklı	o AM ɾ BE t AC ɑ AK k AC ɫ AD ɯ AK
ortaklık	o AM ɾ BE t AC ɑ AK k AC ɫ AD ɯ AK c AC
ortaksız	o AM ɾ BE t AC a AK k AC s AH ɯ AK z AH
oslo	o AM s AH ɫ AD o AM
osmanlı	o AM s AH m AE a AK n AF ɫ AD ɯ AK
otobüs	o AM t AC ɔ AM b AG y AM s AH
otofobi	o AM t AC o AM f BB o AM b AG i AK
oy	o AM j AB
oysa	o AM j AB s AH a AK
oyuncu	o AM j AB u AM n AF d AC ʒ AH u AM
oğuz	o AM ɣ AH u AM z AH
pandeist	p AG a AK n AF d AC e AK i AK s AH t AC
pandeisti	p AG a AK n AF d AC e AK i AK s AH t AC i AK
pandeistin	p AG a AK n AF d AC e AK i AK s AH t AC i AK n AF
pandeistler	p AG a AK n AF d AC e AK i AK s AH t AC l AD e AK ɾ BE
panendeist	p AG a AK n AF e AK n AF d AC e AK i AK s AH t AC
panendeisti	p AG a AK n AF e AK n AF d AC e AK i AK s AH t AC i AK
panendeistin	p AG a AK n AF e AK n AF d AC e AK i AK s AH t AC i AK n AF
panendeistler	p AG a AK n AF e AK n AF d AC e AK i AK s AH t AC l AD e AK ɾ BE
panenteizm	p AG a AK n AF e AK n AF t AC e AK i AK z AH m AE
panenteizmi	p AG a AK n AF e AK n AF t AC e AK i AK z AH m AE i AK
panenteizmler	p AG a AK n AF e AK n AF t AC e AK i AK z AH m AE l AD e AK ɾ BE
panteizm	p AG a AK n AF t AC e AK i AK z AH m AE
panteizmi	p AG a AK n AF t AC e AK i AK z AH m AE i AK
panteizmler	p AG a AK n AF t AC e AK i AK z AH m AE l AD e AK ɾ BE
panteon	p AG ɑ AK n AF t AC ɛ AK o AM n AF
papa	p AG a AK p AG a AK
papatya	p AG ɑ AK p AG ɑ AK t AC j AB ɑ AK
papatyalar	p AG ɑ AK p AG ɑ AK t AC j AB ɑ AK l AD a AK ɾ BE
papatyayı	p AG ɑ AK p AG ɑ AK t AC j AB ɑ AK j AB ɯ AK
para	p AG ɑ AK ɾ BE ɑ AK
parisli	p AG ɑː AL ɾ BE i AK s AH l AD i AK
parti	p AG ɑ AK ɾ BE t AC i AK
pas	p AG a AK s AH
patlıcan	p AG a AK t AC ɫ AD ɯ AK d AC ʒ AH a AK n AF
patron	p AG a AK t AC ɾ BE o AM n AF
paylaşmak	p AG ɑ AK j AB ɫ AD ɑ AK ʃ AH m AE ɑ AK k AC
ped	p AG e AK d AC
pedofobi	p AG e AK d AC o AM f BB o AM b AG i AK
pek	p AG ɛ AK k AC
pembe	p AG e AK m AE b AG e AK
pena	p AG ɛ AK n AF ɑ AK
perde	p AG ɛ AK ɾ BE d AC ɛ AK
permütasyon	p AG e AK ɾ BE m AE y AM t AC a AK s AH j AB o AM n AF
permütasyonla	p AG ɛ AK r BA m AE y AM t AC a AK s AH j AB o AM n AF l AD a AK
permütasyonlar	p AG e AK r BA m AE y AM t AC a AK s AH j AB o AM n AF l AD a AK ɾ BE
permütasyonlu	p AG ɛ AK ɾ BE m AE y AM t AC a AK s AH j AB o AM n AF l AD u AM
permütasyonsuz	p AG ɛ AK ɾ BE m AE y AM t AC a AK s AH j AB o AM n AF s AH u AM z AH
permütasyonu	p AG e AK ɾ BE m AE y AM t AC a AK s AH j AB o AM n AF u AM
peçete	p AG e AK t AC ʃ AH e AK t AC e AK
piknik	p AG i AK c AC n AF i AK c AC
pil	p AG ɪ AK l AD
pilav	p AG i AK l AD a AK v BB
pirinç	p AG i AK ɾ BE i AK n AF t AC ʃ AH
pis	p AG i AK s AH
pisi	p AG i AK s AH i AK
planet	p AG ɫ AD a AK n AF e AK t AC
planeti	p AG ɫ AD a AK n AF e AK t AC i AK
planetler	p AG ɫ AD a AK n AF e AK t AC l AD e AK ɾ BE
platformlararası	p AG ɫ AD a AK t AC f BB o AM ɾ BE m AE l AD a AK ɾ BE a AK ɾ BE a AK s AH ɯ AK
plüton	p AG l AD y AM t AC o AM n AF
plüton'u	p AG l AD y AM t AC o AM n AF u AM
plütonlar	p AG l AD y AM t AC o AM n AF l AD a AK ɾ BE
polis	p AG o AM l AD i AK s AH
polisi	p AG o AM l AD i AK s AH i AK
polisler	p AG o AM l AD i AK s AH l AD e AK ɾ BE
porsuk	p AG o AM ɾ BE s AH u AM k AC
program	p AG ɾ BE o AM ɡ AC ɾ BE a AK m AE
programla	p AG ɾ BE o AM ɡ AC ɾ BE a AK m AE l AD a AK
programlama	p AG ɾ BE o AM ɡ AC ɾ BE a AK m AE l AD a AK m AE a AK
programlamak	p AG ɾ BE o AM ɡ AC ɾ BE a AK m AE l AD a AK m AE a AK k AC
programlamamak	p AG ɾ BE o AM ɡ AC ɾ BE a AK m AE l AD a AK m AE a AK m AE a AK k AC
programlamaz	p AG ɾ BE o AM ɡ AC ɾ BE a AK m AE l AD a AK m AE a AK z AH
programlar	p AG ɾ BE o AM ɡ AC ɾ BE a AK m AE l AD a AK ɾ BE
programsa	p AG ɾ BE o AM ɡ AC ɾ BE a AK m AE s AH a AK
programı	p AG ɾ BE o AM ɡ AC ɾ BE a AK m AE ɯ AK
programını	p AG ɾ BE o AM ɡ AC ɾ BE a AK m AE ɯ AK n AF ɯ AK
psikoz	p AG s AH i AK k AC o AM z AH
psikozla	p AG s AH i AK k AC o AM z AH l AD a AK
psikozlar	p AG s AH i AK k AC o AM z AH l AD a AK ɾ BE
psikozlu	p AG s AH i AK k AC o AM z AH l AD u AM
psikozsa	p AG s AH i AK k AC o AM z AH s AH a AK
psikozsuz	p AG s AH i AK k AC o AM z AH s AH u AM z AH
psikozu	p AG s AH i AK k AC o AM z AH u AM
pus	p AG u AM s AH
pürüz	p AG y AM ɾ BE y AM z AH
radyo	ɾ BE a AK d AC j AB o AM
rahmi	ɾ BE a AK h AA m AE i AK
ramazan	ɾ BE ɑ AK m AE ɑ AK z AH ɑ AK n AF
rasathane	r BA a AK s AH a AK t AC h AA aː AL n AF e AK
rasathaneler	r BA a AK s AH a AK t AC h AA aː AL n AF e AK ɫ AD e AK ɾ BE
rasathaneyi	r BA a AK s AH a AK t AC h AA aː AL n AF e AK j AB i AK
rağmen	r BA a AK ɣ AH m AE e AK n AF
reform	ɾ BE ɛ AK f BB o AM ɾ BE m AE
rehber	ɾ BE ɛ AK h AA b AG e AK ɾ BE
ritim	ɾ BE i AK t AC i AK m AE
ritm	ɾ BE i AK t AC m AE
riyad	ɾ BE i AK j AB a AK d AC
romalı	ɾ BE o AM m AE a AK ɫ AD ɯ AK
roman	ɾ BE o AM m AE ɑ AK n AF
rumen	ɾ BE u AM m AE e AK n AF
rusça	ɾ BE u AM s AH t AC ʃ AH a AK
rusçalar	ɾ BE u AM s AH t AC ʃ AH a AK l AD a AK ɾ BE
röntgenyum	ʀ BA œ AM n AF t AC ɡ AC eː AL n AF j AB ʊ AM m AE
rüzgâr	r BA y AM z AH ɟ AC a AK r BA
saat	s AH a AK a AK t AC
sabit	s AH aː AL b AG i AK t AC
sabun	s AH a AK b AG u AM n AF
sabır	s AH ɑ AK b AG ɯ AK ɾ BE
sac	s AH ʌ AK d AC ʒ AH
sakin	s AH aː AL c AC i AK n AF
sakini	s AH aː AL c AC i AK n AF i AK
sakinler	s AH aː AL c AC i AK n AF l AD e AK ɾ BE
sakın	s AH a AK k AC ɯ AK n AF
salata	s AH ɑ AK ɫ AD ɑ AK t AC ɑ AK
salt	s AH a AK ɫ AD t AC
salı	s AH ɑ AK l AD ɯ AK
samur	s AH ɑ AK m AE u AM ɾ BE
sanatçı	s AH a AK n AF a AK t AC t AC ʃ AH ɯ AK
sandalye	s AH a AK n AF d AC a AK l AD j AB e AK
sandviç	s AH a AK n AF d AC v BB i AK t AC ʃ AH
sanskrit	s AH a AK n AF s AH k AC ɾ BE i AK t AC
sap	s AH ɑ AK p AG
sarı	s AH ɑ AK ɾ BE ɯ AK
satranç	s AH ɑ AK t AC ɾ BE ɑ AK n AF t AC ʃ AH
sayfalandırma	s AH a AK j AB f BB a AK l AD a AK n AF d AC ɯ AK ɾ BE m AE a AK
saç	s AH a AK t AC ʃ AH
sağ	s AH a AK ɰ AB
sağlayıcı	s AH aː AL l AD a AK j AB ɯ AK d AC ʒ AH ɯ AK
sağlayıcılar	s AH aː AL l AD a AK j AB ɯ AK d AC ʒ AH ɯ AK l AD a AK ɾ BE
sağlayıcıyı	s AH aː AL l AD a AK j AB ɯ AK d AC ʒ AH ɯ AK j AB ɯ AK
sekiz	s AH e AK c AC i AK z AH
sekizer	s AH e AK c AC i AK z AH æ AK r BA
selam	s AH e AK l AD a AK m AE
selamünaleyküm	s AH e AK l AD a AK m AE y AM n AF a AK l AD e AK j AB c AC y AM m AE
selim	s AH e AK l AD i AK m AE
sembol	s AH e AK m AE b AG ɔ AM ɫ AD
semiz	s AH e AK m AE i AK z AH
semizotu	s AH e AK m AE i AK z AH o AM t AC u AM
sempozyum	s AH e AK m AE p AG o AM z AH j AB u AM m AE
sempozyumlar	s AH e AK m AE p AG o AM z AH j AB u AM m AE l AD a AK ɾ BE
sempozyumu	s AH e AK m AE p AG o AM z AH j AB u AM m AE u AM
sen	s AH e AK n AF
sera	s AH e AK r BA ɑ AK
sercan	s AH e AK ɾ BE d AC ʒ AH ɑ AK n AF
serdar	s AH e AK ɾ BE d AC ɑ AK ɾ BE
serin	s AH e AK ɾ BE i AK n AF
server	s AH e AK ɾ BE v BB e AK ɾ BE
serverde	s AH e AK ɾ BE v BB e AK ɾ BE d AC e AK
serverden	s AH e AK ɾ BE v BB e AK ɾ BE d AC e AK n AF
servere	s AH e AK ɾ BE v BB e AK ɾ BE e AK
serveri	s AH e AK ɾ BE v BB e AK ɾ BE i AK
serverin	s AH e AK ɾ BE v BB e AK ɾ BE i AK n AF
serverler	s AH e AK ɾ BE v BB e AK ɾ BE l AD e AK ɾ BE
serverlerde	s AH e AK ɾ BE v BB e AK ɾ BE l AD e AK ɾ BE d AC e AK
serverlerden	s AH e AK ɾ BE v BB e AK ɾ BE l AD e AK ɾ BE d AC e AK n AF
serverlere	s AH e AK ɾ BE v BB e AK ɾ BE l AD e AK ɾ BE e AK
serverleri	s AH e AK ɾ BE v BB e AK ɾ BE l AD e AK ɾ BE i AK
serverlerin	s AH e AK ɾ BE v BB e AK ɾ BE l AD e AK ɾ BE i AK n AF
servi	s AH ɛ AK ɾ BE v BB i AK
ses	s AH e AK s AH
sesi	s AH e AK s AH i AK
sevda	s AH e AK v BB d AC a AK
sevgi	s AH e AK v BB ɟ AC ɪ AK
sevilla	s AH e AK v BB i AK l AD l AD a AK
seçenek	s AH ɛ AK t AC ʃ AH ɛ AK n AF ɛ AK c AC
seçilmek	s AH e AK t AC ʃ AH i AK ɫ AD m AE e AK c AC
sille	s AH i AK l AD l AD ɛ AK
simit	s AH i AK m AE i AK t AC
simyacı	s AH i AK m AE j AB aː AL d AC ʒ AH ɯ AK
sindirmek	s AH i AK n AF d AC i AK ɾ BE m AE ɛ AK c AC
sinek	s AH i AK n AF ɛ AK c AC
sineklik	s AH i AK n AF ɛ AK c AC l AD i AK c AC
sismik	s AH i AK s AH m AE i AK k AC
sistem	s AH i AK s AH t AC e AK m AE
siyah	s AH i AK j AB ɑ AK h AA
siz	s AH ɪ AK z AH
sohum	s AH o AM h AA u AM m AE
somnifobi	s AH o AM m AE n AF i AK f BB o AM b AG i AK
somon	s AH o AM m AE o AM n AF
sos	s AH o AM s AH
soy	s AH o AM ɪ AK
soykırım	s AH o AM j AB k AC ɯ AK ɾ BE ɯ AK m AE
soğuk	s AH o AM ɰ AB u AM k AC
soğukluk	s AH o AM ɰ AB u AM k AC ɫ AD u AM k AC
stokiyometri	s AH t AC o AM c AC i AK j AB o AM m AE e AK t AC ɾ BE i AK
stüdyo	s AH t AC y AM d AC j AB o AM
stüdyolar	s AH t AC y AM d AC j AB o AM l AD a AK ɾ BE
stüdyoyu	s AH t AC y AM d AC j AB o AM j AB u AM
sual	s AH u AM ʔ AJ a AK ɫ AD
suali	s AH u AM ʔ AJ a AK ɫ AD i AK
sualler	s AH u AM ʔ AJ a AK ɫ AD l AD e AK ɾ BE
sulamaz	s AH u AM l AD a AK m AE a AK z AH
sular	s AH u AM l AD a AK ɾ BE
sultan	s AH u AM ɫ AD t AC aː AL n AF
sulu	s AH u AM ɫ AD u AM
sululuk	s AH u AM ɫ AD u AM ɫ AD u AM c AC
suna	s AH u AM n AF ɑ AK
suyu	s AH u AM j AB u AM
söylemek	s AH ø AM j AB l AD ɛ AK m AE ɛ AK c AC
söylememek	s AH ø AM j AB l AD ɛ AK m AE ɛ AK m AE ɛ AK c AC
sözlükçü	s AH œ AM z AH l AD y AM k AC t AC ʃ AH y AM
söğüt	s AH œ AM y AM t AC
sü	s AH y AM
sür	s AH y AM ɾ BE
sürme	s AH y AM ɾ BE m AE e AK
sürmek	s AH y AM ɾ BE m AE e AK c AC
sürmeler	s AH y AM ɾ BE m AE e AK l AD e AK ɾ BE
sürmeyi	s AH y AM ɾ BE m AE e AK j AB i AK
sütlaç	s AH y AM t AC l AD a AK t AC ʃ AH
sütun	s AH y AM t AC u AM n AF
sütunlar	s AH y AM t AC u AM n AF l AD a AK ɾ BE
sütunlu	s AH y AM t AC u AM n AF l AD u AM
sütunsuz	s AH y AM t AC u AM n AF s AH u AM z AH
sütunu	s AH y AM t AC u AM n AF u AM
sıcak	s AH ɯ AK d AC ʒ AH ɑ AK k AC
sınıf	s AH ɯ AK n AF ɯ AK f BB
sır	s AH ɯ AK ɾ BE
sıralamak	s AH ɯ AK ɾ BE a AK l AD a AK m AE a AK c AC
sıralamamak	s AH ɯ AK ɾ BE a AK l AD a AK m AE a AK m AE a AK c AC
sıralamaz	s AH ɯ AK ɾ BE a AK l AD a AK m AE a AK z AH
sıralar	s AH ɯ AK ɾ BE a AK l AD a AK ɾ BE
sırasıyla	s AH ɯ AK ɾ BE a AK s AH ɯ AK j AB l AD a AK
sırayla	s AH ɯ AK ɾ BE a AK j AB l AD a AK
sıvı	s AH ɯ AK v BB ɯ AK
tabak	t AC ɑ AK b AG ɑ AK k AC
taban	t AC a AK b AG a AK n AF
tabanlar	t AC a AK b AG a AK n AF l AD a AK ɾ BE
tabanları	t AC a AK b AG a AK n AF l AD a AK ɾ BE ɯ AK
tabanlı	t AC a AK b AG a AK n AF l AD ɯ AK
tabansız	t AC a AK b AG a AK n AF s AH ɯ AK z AH
tabansızla	t AC a AK b AG a AK n AF s AH ɯ AK z AH l AD a AK
tabansızlar	t AC a AK b AG a AK n AF s AH ɯ AK z AH l AD a AK ɾ BE
tabansızsa	t AC a AK b AG a AK n AF s AH ɯ AK z AH s AH a AK
tabansızı	t AC a AK b AG a AK n AF s AH ɯ AK z AH ɯ AK
tabanı	t AC a AK b AG a AK n AF ɯ AK
tabanını	t AC a AK b AG a AK n AF ɯ AK n AF ɯ AK
tablo	t AC ɑ AK b AG l AD ɔ AM
tabut	t AC a AK b AG u AM t AC
tadil	t AC aː AL d AC i AK l AD
tadilat	t AC aː AL d AC i AK l AD aː AL t AC
tadı	t AC a AK d AC ɯ AK
tagalogca	t AC a AK ɡ AC a AK l AD o AM ɡ AC d AC ʒ AH a AK
tagalogcalar	t AC a AK ɡ AC a AK l AD o AM ɡ AC d AC ʒ AH a AK l AD a AK ɾ BE
tagalogcayı	t AC a AK ɡ AC a AK l AD o AM ɡ AC d AC ʒ AH a AK j AB ɯ AK
taklidi	t AC a AK k AC ɫ AD iː AL d AC i AK
taklidim	t AC a AK k AC ɫ AD iː AL d AC i AK m AE
taklidin	t AC a AK k AC ɫ AD iː AL d AC i AK n AF
taklidî	t AC a AK k AC ɫ AD iː AL d AC iː AL
taklit	t AC a AK k AC ɫ AD i AK t AC
taklitle	t AC a AK k AC ɫ AD i AK t AC ɫ AD e AK
taklitler	t AC a AK k AC ɫ AD i AK t AC ɫ AD e AK ɾ BE
taklitçi	t AC a AK k AC ɫ AD i AK t AC t AC ʃ AH i AK
taklitçidir	t AC a AK k AC ɫ AD i AK t AC t AC ʃ AH i AK d AC i AK ɾ BE
taklitçiler	t AC a AK k AC ɫ AD i AK t AC t AC ʃ AH ɫ AD e AK ɾ BE
taklitçinin	t AC a AK k AC ɫ AD i AK t AC t AC ʃ AH i AK n AF i AK n AF
taklitçisin	t AC a AK k AC ɫ AD i AK t AC t AC ʃ AH i AK s AH i AK n AF
taklitçiyi	t AC a AK k AC ɫ AD i AK t AC t AC ʃ AH i AK j AB i AK
taklitçiyim	t AC a AK k AC ɫ AD i AK t AC t AC ʃ AH i AK j AB i AK m AE
takyon	t AC ɑ AK k AC j AB o AM n AF
talep	t AC a AK l AD e AK p AG
tamlayan	t AC ɑ AK m AE ɫ AD ɑ AK j AB ɑ AK n AF
tanga	t AC ɑ AK ŋ AF ɡ AC ɑ AK
tanrıcı	t AC ɑ AK n AF ɾ BE ɯ AK d AC ʒ AH ɯ AK
tanrıcılık	t AC ɑ AK n AF ɾ BE ɯ AK d AC ʒ AH ɯ AK ɫ AD ɯ AK k AC
tanımlık	t AC a AK n AF ɯ AK m AE l AD ɯ AK c AC
tanımlıklar	t AC a AK n AF ɯ AK m AE l AD ɯ AK c AC l AD a AK ɾ BE
tanımlığı	t AC a AK n AF ɯ AK m AE l AD ɯ AK ɯ AK
tarih	t AC aː AL ɾ BE i AK ç
tarçın	t AC a AK ɾ BE t AC ʃ AH ɯ AK n AF
tat	t AC a AK t AC
tatarca	t AC a AK t AC a AK ɾ BE d AC ʒ AH a AK
tatil	t AC aː AL t AC i AK l AD
tatlar	t AC a AK t AC l AD a AK ɾ BE
tatlı	t AC ɑ AK t AC ɫ AD ɯ AK
tavan	t AC ɑ AK β BB ɑ AK n AF
tay	t AC ɑ AK j AB
taş	t AC ɑ AK ʃ AH
tebeşir	t AC e AK b AG e AK ʃ AH i AK ɾ BE
tecrübe	t AC ɛ AK d AC ʒ AH ɾ BE y AM b AG ɛ AK
tedricî	t AC e AK d AC ɾ BE iː AL d AC ʒ AH iː AL
tekdilli	t AC e AK c AC d AC i AK l AD l AD i AK
tekdillilik	t AC e AK c AC d AC i AK l AD l AD i AK l AD i AK c AC
tekdillilikler	t AC e AK c AC d AC i AK l AD l AD i AK l AD i AK c AC l AD e AK ɾ BE
tekdilliliği	t AC e AK c AC d AC i AK l AD l AD i AK l AD i AK i AK
tel	t AC ɛ AK l AD
teleskop	t AC ɛ AK l AD ɛ AK s AH k AC ɔ AM p AG
temmuz	t AC ɛ AK mː BD ʊ AM z AH
tendon	t AC ɛ AK n AF d AC ɔ AM n AF
tenis	t AC e AK n AF i AK s AH
tenisçi	t AC ɛ AK n AF i AK s AH t AC ʃ AH i AK
teodise	t AC e AK o AM d AC i AK s AH e AK
teodiseler	t AC e AK o AM d AC i AK s AH e AK l AD e AK ɾ BE
teodiseyi	t AC e AK o AM d AC i AK s AH e AK j AB i AK
teoloji	t AC e AK o AM ɫ AD o AM ʒ AH i AK
teolojiler	t AC e AK o AM ɫ AD o AM ʒ AH i AK l AD e AK ɾ BE
teolojiyi	t AC e AK o AM ɫ AD o AM ʒ AH i AK j AB i AK
tepe	t AC e AK p AG ɛ AK
terapist	t AC ɛ AK ɾ BE ɑ AK p AG i AK s AH t AC
terli	t AC e AK ɾ BE l AD i AK
terlik	t AC e AK ɾ BE l AD i AK c AC
termometre	t AC ə AK ɾ BE m AE o AM m AE ɛ AK t AC ɾ BE ɛ AK
terzi	t AC e AK ɾ BE z AH i AK
terör	t AC e AK ɾ BE ø AM ɾ BE
terörizm	t AC e AK ɾ BE œ AM ɾ BE i AK z AH m AE
terörler	t AC e AK ɾ BE ø AM ɾ BE l AD e AK ɾ BE
terörü	t AC e AK ɾ BE ø AM ɾ BE y AM
tesadüf	t AC e AK s AH aː AL d AC y AM f BB
teslim	t AC e AK s AH l AD i AK m AE
test	t AC e AK s AH t AC
teste	t AC e AK s AH t AC e AK
testi	t AC e AK s AH t AC i AK
testle	t AC e AK s AH t AC l AD e AK
testler	t AC e AK s AH t AC l AD e AK ɾ BE
testli	t AC ɛ AK s AH t AC l AD i AK
testse	t AC e AK s AH t AC s AH e AK
testsiz	t AC ɛ AK s AH t AC s AH i AK z AH
tetrafobi	t AC e AK t AC ɾ BE a AK f BB o AM b AG i AK
teyze	t AC e AK j AB z AH e AK
teyzeler	t AC e AK j AB z AH e AK l AD e AK ɾ BE
teyzeyi	t AC e AK j AB z AH e AK j AB i AK
teşkilat	t AC ɛ AK ʃ AH k AC iː AL ɫ AD a AK t AC
teşkilatlar	t AC ɛ AK ʃ AH k AC iː AL ɫ AD aː AL t AC l AD a AK ɾ BE
teşkilatı	t AC ɛ AK ʃ AH k AC iː AL ɫ AD aː AL t AC ɯ AK
tir	t AC ɯ AK ɾ BE
tiyatro	t AC i AK j AB a AK t AC ɾ BE o AM
tokmak	t AC ɔ AM k AC m AE ɑ AK k AC
tokmaklar	t AC ɔ AM k AC m AE ɑ AK k AC l AD ɑ AK ɾ BE
tokofobi	t AC o AM k AC o AM f BB o AM b AG i AK
topoloji	t AC o AM p AG o AM l AD o AM ʒ AH i AK
topolojik	t AC o AM p AG o AM l AD o AM ʒ AH i AK c AC
topolojiler	t AC o AM p AG o AM l AD o AM ʒ AH i AK l AD e AK ɾ BE
topolojiyi	t AC o AM p AG o AM l AD o AM ʒ AH i AK j AB i AK
toprak	t AC o AM p AG ɾ BE ɑ AK k AC
topraklar	t AC o AM p AG ɾ BE a AK c AC l AD a AK ɾ BE
toprağı	t AC o AM p AG ɾ BE a AK ɯ AK
torbalı	t AC o AM r BA b AG a AK l AD ɯ AK
toz	t AC o AM z AH
tren	t AC ɾ BE e AK n AF
trigonometri	t AC ɾ BE i AK ɟ AC o AM n AF o AM m AE e AK t AC ɾ BE i AK
trigonometriler	t AC ɾ BE i AK ɟ AC o AM n AF o AM m AE e AK t AC ɾ BE i AK l AD e AK ɾ BE
trigonometriyi	t AC ɾ BE i AK ɟ AC o AM n AF o AM m AE e AK t AC ɾ BE i AK j AB i AK
tuna	t AC u AM n AF a AK
tundra	t AC u AM n AF d AC ɾ BE a AK
turuncu	t AC u AM ɾ BE u AM n AF d AC ʒ AH u AM
turşu	t AC u AM ɾ BE ʃ AH u AM
tuz	t AC u AM z AH
tuza	t AC u AM z AH a AK
tuzlamaz	t AC u AM z AH l AD a AK m AE a AK z AH
tuzlar	t AC u AM z AH l AD a AK ɾ BE
tuzlu	t AC u AM z AH l AD u AM
tuzsuz	t AC u AM z AH s AH u AM z AH
tuzu	t AC u AM z AH u AM
tuzum	t AC u AM z AH u AM m AE
tuzun	t AC u AM z AH u AM n AF
tüm	t AC y AM m AE
tünaydın	t AC y AM n AF a AK j AB d AC ɯ AK n AF
tür	t AC y AM r BA
türk	t AC y AM ɾ BE c AC
türkçeleştirmek	t AC y AM ɾ BE k AC t AC ʃ AH ɛ AK l AD e AK ʃ AH t AC i AK ɾ BE m AE e AK c AC
türler	t AC y AM ɾ BE l AD e AK ɾ BE
türlü	t AC y AM ɾ BE l AD y AM
türü	t AC y AM ɾ BE y AM
tüt	t AC y AM t AC
tüter	t AC y AM t AC e AK ɾ BE
tütün	t AC y AM t AC y AM n AF
tırabzan	t AC ɯ AK ɾ BE ɑ AK b AG z AH ɑ AK n AF
ucube	u AM d AC ʒ AH uː AN b AG ɛ AK
uhrevî	u AM h AA ɾ BE e AK v BB iː AL
ulus	u AM ɫ AD u AM s AH
uluslararası	u AM ɫ AD u AM s AH ɫ AD a AK ɾ BE a AK ɾ BE a AK s AH ɯ AK
uluslarüstü	u AM ɫ AD u AM s AH ɫ AD a AK ɾ BE y AM s AH t AC y AM
umumiyet	u AM m AE uː AN m AE i AK j AB e AK t AC
umumiyeti	u AM m AE uː AN m AE i AK j AB e AK t AC i AK
umumiyetler	u AM m AE uː AN m AE i AK j AB e AK t AC l AD e AK ɾ BE
unlu	u AM n AF ɫ AD u AM
ut	u AM t AC
utku	u AM t AC k AC u AM
uyarım	ɟ AC i AK d̪ AC e AK ɾ BE i AK m AE
uygulama	u AM j AB ɡ AC u AM l AD a AK m AE a AK
uygulamalar	u AM j AB ɡ AC u AM l AD a AK m AE a AK l AD a AK ɾ BE
uygulamayı	u AM j AB ɡ AC u AM l AD a AK m AE a AK j AB ɯ AK
uzak	u AM z AH a AK k AC
uğur	u AM ɣ AH u AM r BA
vaat	v BB ɑː AL t AC
vaftiz	v BB ɑ AK f BB t AC i AK z AH
vakıf	v BB ɑ AK k AC ɯ AK f BB
valla	v BB a AK lː BC aː AL
vallahi	v BB a AK lː BC aː AL h AA i AK
van	v BB a AK n AF
var	v BB ɑ AK ɾ BE
varlık	v BB ɑ AK ɾ BE ɫ AD ɯ AK k AC
varoş	v BB a AK r BA o AM ʃ AH
vasi	v BB aː AL s AH iː AL
vasiler	v BB aː AL s AH iː AL l AD e AK ɾ BE
vasistas	v BB a AK s AH i AK s AH t AC a AK s AH
vasiyi	v BB aː AL s AH iː AL j AB i AK
vatansever	v BB a AK t AC a AK n AF s AH e AK v BB e AK ɾ BE
vaşak	v BB ɑ AK ʃ AH ɑ AK k AC
ve	v BB e AK
veda	β BB ɛ AK d AC aː AL
veriler	v BB e AK ɾ BE i AK ɫ AD e AK ɾ BE
verilmek	v BB e AK ɾ BE i AK l AD m AE ɛ AK c AC
verirler	v BB e AK ɾ BE i AK ɾ BE l AD e AK ɾ BE
veriyi	v BB e AK ɾ BE i AK j AB i AK
vermezler	v BB e AK m AE e AK z AH l AD e AK ɾ BE
veysel	β BB e AK j AB s AH e AK l AD
vida	v BB i AK d AC a AK
viyadük	v BB i AK j AB ɑ AK d AC y AM c AC
vişne	v BB i AK ʃ AH n AF e AK
voleybolcu	v BB o AM l AD ɛ AK j AB b AG o AM ɫ AD d AC ʒ AH u AM
vurmak	v BB u AM ɾ BE m AE ɑ AK k AC
web	v BB e AK b AG
wiki	v BB i AK c AC i AK
yakamoz	j AB a AK k AC a AK m AE o AM z AH
yalanlamak	j AB a AK ɫ AD a AK n AF ɫ AD a AK m AE a AK k AC
yamuk	j AB a AK m AE u AM k AC
yanak	j AB ɑ AK n AF ɑ AK k AC
yanısıra	j AB a AK n AF ɯ AK s AH ɯ AK ɾ BE a AK
yapar	j AB a AK p AG a AK ɾ BE
yapmaz	j AB a AK p AG m AE a AK z AH
yar	j AB aː AL ɾ BE
yarın	j AB a AK ɾ BE ɯ AK n AF
yastık	j AB a AK s AH t AC ɯ AK k AC
yatırımcı	j AB ä t̪ AC ɯ AK ɾ BE ɯ AK m AE d AC ʒ AH ɯ AK
yavuz	j AB a AK v BB u AM z AH
yazılmak	j AB a AK z AH ɯ AK l AD m AE a AK k AC
yazılmamak	j AB a AK z AH ɯ AK l AD m AE a AK m AE a AK c AC
yazılım	j AB a AK z AH ɯ AK l AD ɯ AK m AE
yazılımlar	j AB a AK z AH ɯ AK l AD ɯ AK m AE l AD a AK ɾ BE
yazılımları	j AB a AK z AH ɯ AK l AD ɯ AK m AE l AD a AK ɾ BE ɯ AK
yazılımı	j AB a AK z AH ɯ AK l AD ɯ AK m AE ɯ AK
yağ	j AB aː AL
yağlı	j AB a AK ɣ AH ɫ AD ɯ AK
yağmur	j AB a AK ɣ AH m AE u AM r BA
yağsız	j AB a AK ɣ AH s AH ɯ AK z AH
yaşam	j AB a AK ʃ AH a AK m AE
yaşında	j AB a AK ʃ AH ɯ AK n AF d AC a AK
ye	j AB e AK
yedi	j AB e AK d AC i AK
yedişer	j AB e AK d AC i AK ʃ AH æ AK r BA
yel	j AB ɛ AK l AD
yemenli	j AB ɛ AK m AE e AK n AF l AD i AK
yer	j AB e AK ɾ BE
yerim	j AB e AK ɾ BE i AK m AE
yerler	y AM e AK ɾ BE l AD e AK ɾ BE
yetkili	j AB e AK t AC k AC i AK l AD i AK
yetkililer	j AB e AK t AC k AC i AK l AD i AK l AD e AK ɾ BE
yetkiliyi	j AB e AK t AC k AC i AK l AD i AK j AB i AK
yetkisiz	j AB e AK t AC k AC i AK s AH i AK z AH
yeşil	j AB e AK ʃ AH i AK l AD
yiğit	j AB i AK ɰ AB i AK t AC
yok	j AB o AM k AC
yoksa	j AB o AM k AC s AH a AK
yoldaş	j AB o AM ɫ AD d AC ɑ AK ʃ AH
yorgun	j AB o AM ɾ BE ɡ AC u AM n AF
yosun	j AB o AM s AH u AM n AF
yoğurtlar	j AB o AM w AI u AM r BA t AC ɫ AD a AK r BA
yumruk	j AB u AM m AE ɾ BE u AM k AC
yumurta	j AB u AM m AE u AM ɾ BE t AC a AK
yumurtalar	j AB u AM m AE u AM ɾ BE t AC a AK l AD a AK ɾ BE
yumurtayı	j AB u AM m AE u AM ɾ BE t AC a AK j AB ɯ AK
yumuşak	j AB u AM m AE u AM ʃ AH a AK k AC
yumuşaklar	j AB u AM m AE u AM ʃ AH a AK k AC l AD a AK ɾ BE
yumuşakça	j AB u AM m AE u AM ʃ AH a AK k AC t AC ʃ AH a AK
yumuşakçalar	j AB u AM m AE u AM ʃ AH a AK k AC t AC ʃ AH a AK l AD a AK ɾ BE
yumuşakçayı	j AB u AM m AE u AM ʃ AH a AK k AC t AC ʃ AH a AK j AB ɯ AK
yumuşağı	j AB u AM m AE u AM ʃ AH a AK ɯ AK
yunus	j AB u AM n AF u AM s AH
yurtsever	j AB u AM ɾ BE t AC s AH e AK v BB e AK ɾ BE
yuva	j AB u AM v BB ɑ AK
yönelimli	j AB ø AM n AF e AK l AD i AK m AE l AD i AK
yönelimsiz	j AB ø AM n AF e AK l AD i AK m AE s AH i AK z AH
yıl	j AB ɯ AK ɫ AD
yılan	j AB ɯ AK ɫ AD ɑ AK n AF
yılanlar	j AB ɯ AK ɫ AD ɑ AK n AF ɫ AD ɑ AK ɾ BE
yılanı	j AB ɯ AK ɫ AD ɑ AK n AF ɯ AK
yıldırım	j AB ɯ AK ɫ AD d AC ɯ AK r BA ɯ AK m AE
zarflar	z AH a AK ɾ BE f BB l AD a AK ɾ BE
zarfı	z AH a AK ɾ BE f BB ɯ AK
zaten	z AH aː AL t AC e AK n AF
zemin	z AH e AK m AE i AK n AF
zenofobi	z AH e AK n AF o AM f BB o AM b AG i AK
ziraat	z AH i AK ɾ BE ä ä t AC
zona	z AH o AM n AF a AK
zorlu	z AH o AM ɾ BE ɫ AD u AM
zürafa	z AH y AM r BA aː AL f BB aː AL
ç	t AC ʃ AH
çakıl	t AC ʃ AH ɑ AK k AC ɯ AK ɫ AD
çakırkeyif	t AC ʃ AH a AK k AC ɯ AK r BA c AC e AK j AB i AK f BB
çalışkan	t AC ʃ AH ɑ AK ɫ AD ɯ AK ʃ AH k AC ɑ AK n AF
çam	t AC ʃ AH ɑ AK m AE
çanta	t AC ʃ AH a AK n AF t AC a AK
çar	t AC ʃ AH a AK ɾ BE
çarmıh	t AC ʃ AH a AK ɾ BE m AE ɯ AK h AA
çarşamba	t AC ʃ AH ɑ AK ɾ BE ʃ AH ɑ AK m AE b AG ɑ AK
çatal	t AC ʃ AH a AK t AC a AK l AD
çağ	t AC ʃ AH a AK ɰ AB
çağatay	t AC ʃ AH aː AL t AC a AK j AB
çağdaş	t AC ʃ AH a AK ɰ AB d AC a AK ʃ AH
çağırmak	t AC ʃ AH ɑː AL ɯ AK ɾ BE m AE ɑ AK k AC
çekçe	t AC ʃ AH ɛ AK k AC t AC ʃ AH ɛ AK
çemberi	t AC ʃ AH e AK m AE b AG e AK ɾ BE i AK
çemberler	t AC ʃ AH e AK m AE b AG e AK ɾ BE l AD e AK ɾ BE
çene	t AC ʃ AH e AK ŋ AF ɛ AK
çeri	t AC ʃ AH e AK ɾ BE i AK
çevirme	t AC ʃ AH ɛ AK v BB i AK ɾ BE m AE ɛ AK
çeşitli	t AC ʃ AH e AK s AH i AK t AC l AD i AK
çifte	t AC ʃ AH i AK f BB t AC e AK
çiftçi	t AC ʃ AH i AK f BB t AC t AC ʃ AH i AK
çimdik	t AC ʃ AH i AK m AE d AC i AK c AC
çimdikleme	t AC ʃ AH i AK m AE d AC i AK c AC l AD e AK m AE e AK
çimdiklemek	t AC ʃ AH i AK m AE d AC i AK c AC l AD e AK m AE e AK c AC
çimdiklememe	t AC ʃ AH i AK m AE d AC i AK c AC l AD e AK m AE e AK m AE e AK
çimdiklememek	t AC ʃ AH i AK m AE d AC i AK c AC l AD e AK m AE e AK m AE e AK c AC
çince	t AC ʃ AH i AK n AF d AC ʒ AH e AK
çingene	t AC ʃ AH i AK ŋ AF ɟ AC e AK n AF e AK
çivi	t AC ʃ AH ɪ AK v BB ɪ AK
çiçekçi	t AC ʃ AH i AK t AC ʃ AH e AK c AC t AC ʃ AH i AK
çiğdem	t AC ʃ AH iː AL d AC e AK m AE
çiş	t AC ʃ AH i AK ʃ AH
çocuklar	t AC ʃ AH o AM d AC ʒ AH u AM k AC l AD a AK ɾ BE
çokdilli	t AC ʃ AH o AM k AC d AC i AK l AD l AD i AK
çokdillilik	t AC ʃ AH o AM k AC d AC i AK l AD l AD i AK l AD i AK c AC
çokdillilikler	t AC ʃ AH o AM k AC d AC i AK l AD l AD i AK l AD i AK c AC l AD e AK ɾ BE
çokdilliliği	t AC ʃ AH o AM k AC d AC i AK l AD l AD i AK l AD i AK j AB i AK
çorba	t AC ʃ AH o AM ɾ BE b AG ɑ AK
çufçuf	t AC ʃ AH u AM f BB t AC ʃ AH u AM f BB
çuğ	t AC ʃ AH uː AN
çöl	t AC ʃ AH ø AM l AD
çörek	t AC ʃ AH ø AM ɾ BE e AK c AC
çünkü	t AC ʃ AH y AM n AF k AC y AM
çıkarmak	t AC ʃ AH ɯ AK k AC ɑ AK ɾ BE m AE ɑ AK k AC
çıkarmamak	d AC ʒ AH ɯ AK k AC a AK ɾ BE m AE a AK m AE a AK k AC
çıkarmaz	d AC ʒ AH ɯ AK k AC a AK ɾ BE m AE a AK z AH
çıkarır	d AC ʒ AH ɯ AK k AC a AK ɾ BE ɯ AK ɾ BE
çıkmak	t AC ʃ AH ɯ AK k AC m AE ɑ AK k AC
çığ	t AC ʃ AH ɯː AL
çığlık	t AC ʃ AH ɯ AK l AD ɯ AK c AC
çığlıklar	t AC ʃ AH ɯ AK l AD ɯ AK c AC l AD a AK ɾ BE
çığlığı	t AC ʃ AH ɯ AK l AD ɯ AK ɯ AK
öbür	ø AM b AG y AM ɾ BE
öl	ø AM l AD
ölüm	œ AM l AD ʏ AM m AE
ölümcül	ø AM l AD y AM m AE d AC ʒ AH y AM l AD
ömür	ø AM m AE y AM ɾ BE
önermek	ø AM n AF ɛ AK ɾ BE m AE ɛ AK c AC
öpücük	ø AM p AG y AM d AC ʒ AH y AM k AC
öpüşmek	œ AM p AG y AM ʃ AH m AE ɛ AK c AC
öykü	œ AM j AB k AC y AM
öyle	œ AM j AB l AD ɛ AK
özellik	ø AM z AH e AK lː BC i AK c AC
özellikle	ø AM z AH e AK lː BC i AK c AC l AD e AK
özgün	ø AM z AH ɡ AC y AM n AF
özil	ø AM z AH i AK l AD
özlem	ø AM z AH l AD e AK m AE
özne	ø AM z AH n AF e AK
özsüz	ø AM z AH s AH y AM z AH
öç	ø AM t AC ʃ AH
öğle	øː AN l AD e AK
öğreti	øː AN r BA e AK t AC i AK
öğütmek	œ AM ɰ AB y AM t AC m AE e AK c AC
ümit	y AM m AE i AK t AC
ün	y AM n AF
üretim	y AM ɾ BE e AK t AC i AK m AE
üssel	y AM s AH s AH e AK ɫ AD
üstel	y AM s AH t AC e AK ɫ AD
üye	y AM j AB e AK
üzere	y AM z AH e AK ɾ BE e AK
üzgün	y AM z AH ɡ AC y AM n AF
üzüm	y AM z AH y AM m AE
üzüntü	y AM z AH y AM n AF t AC y AM
üzüntüler	y AM z AH y AM n AF t AC y AM l AD e AK ɾ BE
üzüntüyü	y AM z AH y AM n AF t AC y AM j AB y AM
üçer	y AM t AC ʃ AH æ AK r BA
üçüncü	y AM t AC ʃ AH y AM n AF d AC ʒ AH y AM
ılık	ɯ AK ɫ AD ɯ AK k AC
ırk	ɯ AK ɾ BE k AC
ıstakoz	ɯ AK s AH t AC a AK k AC o AM z AH
ısı	ɯ AK s AH ɯ AK
şablon	ʃ AH a AK b AG ɫ AD o AM n AF
şahin	ʃ AH ɑː AL h AA ɪ AK n AF
şahsiyet	ʃ AH a AK h AA s AH i AK j AB e AK t AC
şahsî	ʃ AH a AK h AA s AH iː AL
şahsı	ʃ AH a AK h AA s AH ɯ AK
şahıs	ʃ AH a AK h AA ɯ AK s AH
şahıslar	ʃ AH a AK h AA ɯ AK s AH l AD a AK ɾ BE
şaka	ʃ AH a AK k AC a AK
şans	ʃ AH a AK n AF s AH
şanslar	ʃ AH a AK n AF s AH ɫ AD a AK ɾ BE
şansı	ʃ AH a AK n AF s AH ɯ AK
şarkı	ʃ AH a AK r BA k AC ɯ AK
şarkıcı	ʃ AH a AK ɾ BE k AC ɯ AK d AC ʒ AH ɯ AK
şebnem	ʃ AH ɛ AK b AG n AF ɛ AK m AE
şeftali	ʃ AH ɛ AK f BB t AC ɑː AL l AD i AK
şekerlemez	ʃ AH e AK c AC e AK ɾ BE l AD e AK m AE e AK z AH
şekerler	ʃ AH e AK c AC e AK ɾ BE l AD e AK ɾ BE
şerefe	ʃ AH e AK ɾ BE e AK f BB e AK
şerif	ʃ AH e AK ɾ BE i AK f BB
şifa	ʃ AH i AK f BB e AK
şifalı	ʃ AH i AK f BB e AK
şiirsel	ʃ AH iː AL ɾ BE s AH ɛ AK l AD
şikâyet	ʃ AH i AK c AC aː AL j AB ɛ AK t AC
şimdi	ʃ AH i AK m AE d AC i AK
şu	ʃ AH u AM
şut	ʃ AH uː AN t AC
şöyle	ʃ AH œ AM j AB l AD e AK
şükür	ʃ AH y AM c AC y AM r BA
şüphe	ʃ AH y AM p AG h AA ɛ AK
şımarık	ʃ AH ɯ AK m AE a AK ɾ BE ɯ AK k AC
