abiye	a AC b i AC j AB e AC
abla	a AC b ɫ a AC
acaba	ɑ AH d ʒ ɑ AH b ɑː AJ
acemi	a AC d ʒ e AC m iː AD
acı	ɑ AH d ʒ ɯ AH
acıkmak	ɑ AH d ʒ ɯ AH k m ɑ AH k
ada	a AC d a AC
adenozin	a AC d e AC n o AE z i AC n
afiyet	aː AD f i AC j AB e AC t
afyonkarahisar	ɑ AH f j AB o AE n k ɑ AH r ɑ AH h AA ɪ AC s ɑ AH r
ahize	aː AD h AA i AC z e AC
ahizeler	aː AD h AA i AC z e AC ɫ e AC ɾ
ahizem	aː AD h AA i AC z e AC m
ahizen	aː AD h AA i AC z e AC n
ahizenin	aː AD h AA i AC z e AC n i AC n
ahizesi	aː AD h AA i AC z e AC s i AC
ahizeyi	aː AD h AA i AC z e AC j AB i AC
ahmak	ɑ AH h AA m ɑ AH k
akbaba	ɑ AH k b ɑ AH b ɑ AH
akbil	ɑ AH k b i AC l
akrep	ɑ AH k ɾ ɛ AC p
akrobat	ɑ AH k ɾ o AE b ɑ AH t
akşam	ɑ AH k ʃ ɑ AH m
alamet	ɑ AH l aː AD m ɛ AC t
alem	a AC l ɛ AC m
alemi	a AC l ɛ AC m i AC
alemler	a AC l ɛ AC m l ɛ AC ɾ
algoloji	a AC l ɡ ɔ AE l ɔ AE ʒ i AC
allık	ɑ AH ɫ ɫ ɯ AH k
alman	ɑ AH ɫ m ɑ AH n
almanca	ɑ AH ɫ m ɑ AH n d ʒ ɑ AH
almancı	ɑ AH ɫ m ɑ AH n d ʒ ɯ AH
almanya	ɑ AH ɫ m ɑ AH n j AB ɑ AH
alt	a AC ɫ t
altmış	ɑ AH ɫ t m ɯ AH ʃ
altıgen	a AC l t ɯ AH ɟ e AC n
alıç	ɑ AH ɫ ɯ AH t ʃ
amaç	ɑ AH m ɑ AH t ʃ
ambulans	ɑ AH m b u AE l a AC n s
anahtarlık	a AC n a AC h AA t a AC ɾ ɫ ɯ AH k
anarat	ɑ AH n ɑ AH ɾ ɑ AH t
anarşi	a AC n a AC ɾ ʃ i AC
ancak	ɑ AH n d ʒ ɑ AH k
andaval	ɑ AH n d ɑ AH β ɑ AH ɫ
andavallı	ɑ AH n d ɑ AH β ɑ AH ɫ ɫ ɯ AH
animasyon	a AC n i AC m a AC s j AB o AE n
anjiyografi	a AC n ʒ i AC j AB o AE ɟ ɾ a AC f i AC
ankara	ɑ AH n k ɑ AH ɾ ɑ AH
ankaralı	ɑ AH n k ɑ AH ɾ ɑ AH ɫ ɯ AH
anlamak	a AC n ɫ a AC m a AC k
anlatmak	ɑ AH n ɫ ɑ AH t m ɑ AH k
anne	ɑ AH n n e AC
annelik	ɑ AH n n ɛ AC l i AC c
antakya	ɑ AH n t ɑ AH k j AB ɑ AH
antibiyotik	ɑ AH n t i AC b i AC j AB ɔ AE t i AC c
apeninler	a AC p e AC n i AC n ɫ e AC ɾ
argo	a AC ɾ ɟ o AE
arjantinli	ɑ AH ɾ ʒ ɑ AH n t i AC n l i AC
arkadaşa	a AC ɾ k a AC d a AC ʃ a AC
arkadaşlar	a AC ɾ k a AC d a AC ʃ l a AC ɾ
arkadaşlara	a AC ɾ k a AC d a AC ʃ l a AC ɾ a AC
arkadaşlarda	a AC ɾ k a AC d a AC ʃ l a AC ɾ d a AC
arkadaşlardan	a AC ɾ k a AC d a AC ʃ l a AC ɾ d a AC n
arkadaşların	a AC ɾ k a AC d a AC ʃ l a AC ɾ d a AC n
arkadaşlık	a AC ɾ k a AC d a AC ʃ ɫ ɯ AH k
arkadaşta	a AC ɾ k a AC d a AC ʃ t a AC
arkadaştan	a AC ɾ k a AC d a AC ʃ t a AC n
arkadaşı	a AC ɾ k a AC d a AC ʃ ɯ AH
arkadaşın	a AC ɾ k a AC d a AC ʃ ɯ AH n
artı	a AC ɾ t ɯ AH
artık	ɑ AH ɾ t ɯ AH k
arz	a AC ɾ z
aseksüel	ɑ AH s ɛ AC c s y AG e AC l
aseton	ɑ AH s ɛ AC t ɔ AE n
asimptot	ɑ AH s i AC m p t ɔ AE t
asyalı	ɑ AH s j AB ɑ AH ɫ ɯ AH
ataşe	ɑ AH t ɑ AH ʃ ɛ AC
atina	ɑ AH t i AC n ɑ AH
atlı	ɑ AH t ɫ ɯ AH
atom	ɑ AH t ɔ AE m
avanak	ɑ AH β ɑ AH n ɑ AH k
avize	ɑ AH v i AC z e AC
avizeler	aː AD v i AC z e AC ɫ e AC ɾ
avizem	aː AD v i AC z e AC m
avizen	aː AD v i AC z e AC n
avizenin	aː AD v i AC z e AC n i AC n
avizesi	aː AD v i AC z e AC s i AC
avizeyi	aː AD v i AC z e AC j AB i AC
avokado	ɑ AH β o AE k ɑː AJ d o AE
avrasya	ɑ AH β ɾ ɑ AH s j AB ɑ AH
ayak	ɑ AH j AB ɑ AH k
ayakkabıcı	ɑ AH j AB ɑ AH k k ɑ AH b ɯ AH d ʒ ɯ AH
ayaz	a AC j AB a AC z
ayazlı	a AC j AB a AC z ɫ ɯ AH
ayazsız	a AC j AB a AC z s ɯ AH z
aydınlık	a AC j AB d ɯ AH n ɫ ɯ AH k
ayin	ɑː AJ j AB i AC n
aynı	ɑ AH j AB n ɯ AH
ayva	a AC j AB v a AC
ayça	ɑ AH j AB t ʃ ɑ AH
ayı	ɑ AH j AB ɯ AH
ayşe	ɑ AH j AB ʃ ɛ AC
az	ɑ AH z
azap	ɑ AH z ɑː AJ b
azrail	ɑ AH z ɾ ɑː AJ i AC l
azınlık	a AC z ɯ AH n ɫ ɯ AH k
aç	ɑ AH t ʃ
açlık	a AC t ʃ ɫ ɯ AH k
ağa	ɑ AH ɑ AH
ağdacı	ɑː AJ d ɑ AH d ʒ ɯ AH
ağlaşmak	aː AD ɫ a AC ʃ m a AC k
ağıt	ɑ AH ɰ AI ɯ AH t
ağız	a AC ɯ AH z
aşiret	a AC ʃ iː AD ɾ e AC t
aşçı	a AC ʃ t ʃ ɯ AH
aşık	ɑ AH ʃ ɯ AH k
babaları	b a AC b a AC l a AC ɾ ɯ AH
babalı	b a AC b a AC ɫ ɯ AH
babalık	b a AC b a AC ɫ ɯ AH k
babasız	b a AC b a AC s ɯ AH z
bahadır	b ɑ AH h AA ɑ AH d ɯ AH r
baharat	b a AC h AA a AC r a AC t
bahçe	b ɑ AH h AA t ʃ ɛ AC
bahçıvan	b ɑ AH h AA t ʃ ɯ AH v ɑ AH n
bakıcı	b ɑ AH k ɯ AH d ʒ ɯ AH
bakır	b a AC k ɯ AH ɾ
balalayka	b ɑ AH ɫ ɑ AH ɫ ɑ AH j AB k ɑ AH
baldız	b ɑ AH ɫ d ɯ AH z
balkan	b ɑ AH ɫ k ɑ AH n
balkanlar	b ɑ AH ɫ k ɑ AH n ɫ ɑ AH ɾ
baltacı	b ɑ AH ɫ t ɑ AH d ʒ ɯ AH
baltacılık	b ɑ AH ɫ t ɑ AH d ʒ ɯ AH ɫ ɯ AH k
baltalar	b ɑ AH ɫ t ɑ AH ɫ ɑ AH ɾ
baltam	b ɑ AH ɫ t ɑ AH m
baltan	b ɑ AH ɫ t ɑ AH n
baltanı	b ɑ AH ɫ t ɑ AH n ɯ AH
baltayı	b ɑ AH ɫ t ɑ AH j AB ɯ AH
balık	b ɑ AH ɫ ɯ AH k
balıkçı	b ɑ AH ɫ ɯ AH k t ʃ ɯ AH
balığı	b ɑ AH ɫ ɯ AH ɰ AI ɯ AH
bamya	b ɑ AH m j AB ɑ AH
bandaj	b ɑ AH n d ɑ AH ʒ
banka	b a AC n k a AC
banklar	b ɑ AH n k ɫ a AC ɾ
bankları	b ɑ AH n k ɫ a AC ɾ ɯ AH
bankı	b ɑ AH n k ɯ AH
bankım	b ɑ AH n k ɯ AH m
bankın	b ɑ AH n k ɯ AH n
barbar	b ɑ AH ɾ b ɑ AH ɾ
bardak	b ɑ AH ɾ d ɑ AH k
barış	b ɑ AH ɾ ɯ AH ʃ
basiretli	b a AC s iː AD ɾ e AC t ɫ i AC
basiretsiz	b a AC s iː AD ɾ e AC t s i AC z
basit	b ɑ AH s i AC t
baston	b ɑ AH s t o AE n
batum	b ɑ AH t u AE m
batı	b ɑ AH t ɯ AH
bayat	b ɑ AH j AB ɑ AH t
baygın	b ɑ AH j AB ɡ ɯ AH n
baygınlık	b ɑ AH j AB ɡ ɯ AH n ɫ ɯ AH k
bayram	b ɑ AH j AB ɾ ɑ AH m
baytar	b ɑ AH j AB t ɑ AH ɾ
bayılma	b ɑ AH j AB ɯ AH ɫ m ɑ AH
bazı	b ɑː AJ z ɯ AH
bağ	b ɑː AJ
bağcık	b ɑ AH ɰ AI d ʒ ɯ AH c
bağcıklar	b ɑ AH ɰ AI d ʒ ɯ AH c ɫ a AC ɾ
bağcığı	b ɑ AH ɰ AI d ʒ ɯ AH ɰ AI ɯ AH
bağcığım	b ɑ AH ɰ AI d ʒ ɯ AH ɰ AI ɯ AH m
bağcığın	b ɑ AH ɰ AI d ʒ ɯ AH ɰ AI ɯ AH n
bağlamak	b ɑː AJ ɫ ɑ AH m a AC k
bağlamamak	b ɑ AH ɰ AI ɫ a AC m a AC m a AC c
bağlamaz	b ɑ AH ɰ AI ɫ a AC m a AC z
bağlar	b ɑː AJ ɫ a AC ɾ
bağları	b ɑ AH ɰ AI ɫ a AC ɾ ɯ AH
bağı	b ɑ AH ɯ AH
bağım	b ɑ AH ɯ AH m
bağımsızlık	b a AC ɯ AH m s ɯ AH z ɫ ɯ AH k
bağın	b ɑ AH ɰ AI ɯ AH n
baş	b ɑ AH ʃ
başak	b ɑ AH ʃ ɑ AH k
başkan	b a AC ʃ k a AC n
başlama	b a AC ʃ l a AC m a AC
başlamak	b ɑ AH ʃ ɫ ɑ AH m ɑ AH k
başlamamak	b a AC ʃ ɫ a AC m a AC m a AC c
başlangıç	b a AC ʃ ɫ a AC n ɡ ɯ AH t ʃ
başlar	b ɑ AH ʃ l a AC ɾ
başparmak	b ɑ AH ʃ p ɑ AH ɾ m ɑ AH k
başı	b ɑ AH d ʃ ɯ AH
başıboş	b a AC ʃ ɯ AH b o AE ʃ
bebek	b ɛ AC b ɛ AC c
bedevi	b ɛ AC d ɛ AC v iː AD
beklemek	b e̞ AC c l e̞ AC m e̞ AC c
bekletmek	b e̞ AC c l e̞ AC t m e̞ AC c
belarusça	b ɛ AC l a AC ɾ ʊ AE s t ʃ ɑ AH
belçikalı	b e AC l t ʃ i AC c ɑ AH ɫ ɯ AH
bencillik	b e AC n d ʒ i AC l l i AC c
beraber	b ɛ AC ɾ ɑː AJ b æ AC ɾ̝̊
bereket	b e AC ɾ e AC k e AC t
berilyum	b ɛ AC ɾ i AC l j AB u AE m
berlinli	b e AC ɾ l i AC n l i AC
bermuda	b e AC ɾ m ʊ AE d ɑ AH
beyin	b ɛ AC j AB i AC n
beyinler	b ɛ AC j AB i AC n l e AC ɾ
beyit	b ɛ AC j AB i AC t
beyni	b ɛ AC j AB n i AC
beşgen	b e AC ʃ ɟ e AC n
bikini	b i AC c i AC n i AC
bilek	b i AC ɫ e AC c
bilgisayar	b i AC l ɟ i AC s ɑ AH j AB ɑ AH ɾ
bilim	b i AC l i AC m
bilinç	b i AC l i AC n t ʃ
bilye	b i AC l j AB ɛ AC
bira	b i AC ɾ a AC
birce	b i AC ɾ d ʒ ɛ AC
birey	b i AC ɾ e AC j AB
birincil	b i AC ɾ i AC n d ʒ i AC ɫ
birleşik	b i AC ɾ l e AC ʃ i AC c
birlikte	b i AC ɾ l i AC c t ɛ AC
birliktelik	b i AC ɾ l i AC c t e AC l i AC c
birtakım	b i AC ɾ t ɑ AH k ɯ AH m
biseksüel	b i AC s ɛ AC c s y AG e AC l
bitim	b i AC t i AC m
bitiş	b i AC t i AC ʃ
bitişik	b i AC t i AC ʃ i AC k
bitme	b i AC t m e AC
bizmut	b i AC z m u AE t
bohça	b ɔ AE h AA t ʃ ɑ AH
bor	b o AE ɾ
boru	b o AE ɾ u AE
boy	b o AE j AB
boyacı	b ɔ AE j AB ɑ AH d ʒ ɯ AH
boza	b o AE z ɑ AH
bozayı	b o AE z ɑ AH j AB ɯ AH
bozmak	b o̞ AE z m ɑ AH k
boşamak	b o̞ AE ʃ a AC m a AC k
boşanma	b ɔ AE ʃ ɑ AH n m ɑ AH
boşluk	b o AE ʃ l u AE k
bulaşıcı	b u AE ɫ ɑ AH ʃ ɯ AH d ʒ ɯ AH
bulunmak	b u AE ɫ u AE n m ɑ AH k
burnu	b u AE ɾ n u AE
burun	b u AE ɾ u AE n
burunlar	b u AE ɾ u AE n l a AC ɾ
burçin	b u AE r t ʃ i AC n
bölge	b ø AG l ɟ ɛ AC
börülce	b ø AG ɾ ʏ AG l d ʒ ɛ AC
bükme	b y AG k m e AC
bükmeme	b y AG k m e AC m e AC
bülbül	b y AG l b y AG l
büst	b y AG s t
büyü	b y AG j AB y AG
büyücü	b y AG j AB y AG d ʒ y AG
büyük	b y AG j AB y AG c
cadılık	d ʒ a AC d ɯ AH ɫ ɯ AH k
cami	d ʒ ɑː AJ m ɪ AC
camisi	d ʒ aː AD m i AC s i AC
canlandırma	d ʒ a AC n ɫ a AC n d ɯ AH ɾ m a AC
canlandırmak	d ʒ a AC n ɫ a AC n d ɯ AH ɾ m a AC c
canlandırtmak	d ʒ a AC n ɫ a AC n d ɯ AH ɾ t m a AC c
canlandırtılmak	d ʒ a AC n ɫ a AC n d ɯ AH ɾ t ɯ AH ɫ m a AC c
canlandırılmak	d ʒ a AC n ɫ a AC n d ɯ AH ɾ ɯ AH ɫ m a AC c
canlanmak	d ʒ a AC n ɫ a AC n m a AC c
canlanılmak	d ʒ a AC n ɫ a AC n ɯ AH ɫ m a AC c
casus	d ʒ a AC s u AE s
ceviz	d ʒ ɛ AC v i AC z
cezayir	d ʒ ɛ AC z ɑː AJ j AB i AC ɾ
cezayirli	d ʒ ɛ AC z ɑː AJ j AB i AC ɾ l i AC
ciddi	d ʒ i AC d d iː AD
cihan	d ʒ i AC h AA a AC n
cihanlar	d ʒ i AC h AA a AC n l a AC r
ciklet	d ʒ i AC c l ɛ AC t
cin	d ʒ i AC n
civciv	d ʒ i AC β d ʒ i AC β
coşku	d ʒ o̞ AE ʃ k ʊ AE
cüce	d ʒ ʏ AG d ʒ ɛ AC
cümle	d ʒ y AG m l ɛ AC
dadaş	d ɑ AH d ɑ AH ʃ
dadı	d ɑ AH d ɯ AH
daktilo	d ɑ AH k t i AC ɫ ɔ AE
dalak	d ɑ AH ɫ ɑ AH k
dalgın	d a AC ɫ ɟ ɯ AH n
dalgınlık	d a AC ɫ ɟ ɯ AH n ɫ ɯ AH k
dalgıç	d ɑ AH ɫ ɡ ɯ AH t ʃ
dalmak	d ɑ AH ɫ m ɑ AH k
damatlık	d aː AD m a AC t ɫ ɯ AH k
davranışçılık	d ɑ AH v ɾ ɑ AH n ɯ AH ʃ t ʃ ɯ AH ɫ ɯ AH k
dayı	d a AC j AB ɯ AH
dağ	d aː AD
dede	d e AC d e AC
dedeağaç	d ɛ AC d ɛ AC ɑ AH ɰ AI ɑ AH t ʃ
dedikoducu	d ɛ AC d i AC k ɔ AE d u AE d ʒ u AE
defter	d e AC f t e AC ɾ
dehşet	d e AC h AA ʃ ɛ AC t
deltoid	d e AC l t o AE j AB i AC d
denizanası	d e AC n i AC z a AC n a AC s ɯ AH
depresyon	d e AC p ɾ e AC s j AB o AE n
derece	d e AC ɾ ɛ AC d ʒ ɛ AC
dergi	d e AC ɾ ɟ i AC
derin	d e AC ɾ i AC n
dernek	d e AC ɾ n e AC c
dertli	d e AC ɾ t l i AC
derviş	d e AC ɾ v i AC ʃ
derya	d e AC ɾ j AB ɑː AJ
destan	d ɛ AC s t ɑ AH n
dev	d ɛ AC β
devam	d e AC v ɑ AH m
devrim	d ɛ AC v ɾ i AC m
deyn	d e AC j AB n
değildir	d e AC ɰ AI ɫ i AC d i AC ɾ
değilim	d e AC ɰ AI ɫ i AC m
değiliz	d e AC ɰ AI i AC ɫ i AC z
değiller	d e AC ɰ AI i AC ɫ ɫ e AC ɾ
değilsin	d e AC ɰ AI ɫ s i AC n
değilsiniz	d e AC ɰ AI i AC ɫ s i AC n i AC z
değişik	d ɛ AC i AC ʃ i AC c
değişmek	d e AC j AB i AC ʃ m e AC c
değişmez	d e AC j AB i AC ʃ m e AC z
değiştirmek	d e AC j AB i AC ʃ t i AC ɾ m e AC c
didaktik	d i AC d a AC k t i AC c
dijital	d i AC ʒ i AC t a AC l
dikdörtgen	d i AC k d œ AG ɾ t ɟ e AC n
dikey	d i AC c ɛ AC j AB
dilbilim	d i AC l b i AC l i AC m
dildo	d i AC l d o AE
dilenci	d i AC l ɛ AC n d ʒ ɪ AC
dilim	d i AC l i AC m
dilimde	d i AC l i AC m d e AC
dilimden	d i AC l i AC m d e AC n
dilime	d i AC l i AC m e AC
dilimi	d i AC l i AC m i AC
dilimim	d i AC ɫ i AC m i AC m
dilimimi	d i AC ɫ i AC m i AC m i AC
dilimimin	d i AC ɫ i AC m i AC m i AC n
dilimin	d i AC ɫ i AC m i AC n
dilimini	d i AC ɫ i AC m i AC n i AC
diliminin	d i AC ɫ i AC m i AC n i AC n
dilimler	d i AC ɫ i AC m ɫ e AC ɾ
dilimleri	d i AC ɫ i AC m ɫ e AC ɾ i AC
dilinde	d i AC l i AC n d e AC
dilinden	d i AC l i AC n d e AC n
diline	d i AC l i AC n e AC
dilini	d i AC l i AC n i AC
dilinin	d i AC l i AC n i AC n
dimetoka	d i AC m ɛ AC t ɔ AE k ɑ AH
dinamit	d i AC n ɑ AH m i AC t
dindar	d i AC n d a AC r
dindarlık	d i AC n d a AC r ɫ ɯ AH c
dini	d iː AD n i AC
dinlememek	d i AC n l e AC m e AC m e AC c
dinlenme	d i AC n l e AC n m e AC
dinlenmeme	d i AC n l e AC n m e AC m e AC
dinlerde	d i AC n ɫ e AC ɾ d e AC
dinlerden	d i AC n ɫ e AC ɾ d e AC n
dinlere	d i AC n ɫ e AC ɾ e AC
dinleri	d i AC n ɫ e AC ɾ i AC
dinlerin	d i AC n ɫ e AC ɾ i AC n
dinli	d i AC n ɫ i AC
dinlilik	d i AC n ɫ i AC ɫ i AC c
dinsiz	d i AC n s i AC z
dinsizlik	d i AC n s i AC z ɫ i AC c
dinç	d i AC n t ʃ
dirilmek	d i AC ɾ i AC ɫ i AC ɾ m e AC k
disko	d i AC s k ɔ AE
diskotek	d i AC s k ɔ AE t ɛ AC c
disleksi	d i AC s ɫ e AC k s i AC
diye	d i AC j AB ɛ AC
dize	d i AC z e AC
dizemi	d i AC z e AC m i AC
dizemim	d i AC z e AC m i AC m
dizemin	d i AC z e AC m i AC n
dizemler	d i AC z e AC m ɫ e AC ɾ
diş	d i AC ʃ
dişil	d i AC ʃ i AC ɫ
dokuzgen	d o AE k u AE z ɟ e AC n
dolaşan	d o AE ɫ a AC ʃ a AC n
dolaşmayan	d o AE ɫ a AC ʃ m a AC j AB a AC n
dolmuş	d ɔ AE ɫ m ʊ AE ʃ
doymak	d ɔ AE j AB m ɑ AH k
doğa	d o AE a AC
doğu	d ɔ AE ɰ AI ʊ AE
dudak	d u AE d ɑ AH k
dudu	d u AE d u AE
duy	d u AE j AB
duyma	d u AE j AB m a AC
duymak	d u AE j AB m a AC k
duymama	d u AE j AB m a AC m a AC
duyun	d u AE j AB uː AF n
dönmek	d œ AG n m e AC c
dönüş	d ø AG n y AG ʃ
dönüşlü	d ø AG n y AG ʃ l y AG
dönüşmek	d œ AG n y AG ʃ m e AC c
dönüşsüz	d ø AG n y AG ʃ s y AG z
dörtgen	d œ AG ɾ t ɟ e AC n
dövme	d œ AG v m ɛ AC
dük	d y AG c
dünür	d ʏ AG n ʏ AG ɾ̝̊
dürbün	d y AG ɾ b y AG n
dürüm	d y AG ɾ y AG m
düyun	d y AG j AB uː AF n
düğün	d y AG y AG n
düşes	d y AG ʃ e AC s
düşkün	d y AG ʃ c y AG n
düşman	d y AG ʃ m ɑ AH n
dılak	d ɯ AH ɫ a AC k
dış	d ɯ AH ʃ
dışkı	d ɯ AH ʃ k ɯ AH
ebe	ɛ AC b ɛ AC
ecel	ɛ AC d ʒ e AC l
edat	e AC d a AC t
efsanevi	ɛ AC f s ɑː AJ n ɛ AC v iː AD
egoizm	e AC ɡ o AE iː AD z m
ekimi	e AC k i AC m i AC
ekimler	e AC k i AC m ɫ e AC ɾ
ekin	e AC k i AC n
ekini	e AC k i AC n i AC
ekinim	e AC k i AC n i AC m
ekinin	e AC k i AC n i AC n
ekinler	e AC k i AC n ɫ e AC ɾ
ekran	e AC k ɾ a AC n
ekranlar	e AC k ɾ a AC n ɫ a AC ɾ
ekranı	e AC k ɾ a AC n ɯ AH
ekranım	e AC k ɾ a AC n ɯ AH m
ekranın	e AC k ɾ a AC n ɯ AH n
eksen	e AC k s e AC n
ekseni	e AC k s e AC n i AC
eksenim	e AC k s e AC n i AC m
eksenin	e AC k s e AC n i AC n
eksenler	e AC k s e AC n ɫ e AC ɾ
eksenleri	e AC k s e AC n ɫ e AC ɾ i AC
eksiklik	ɛ AC c s i AC c l i AC c
ekstremum	ɛ AC c s t ɾ ɛ AC m u AE m
ekşimek	ɛ AC c ʃ i AC m ɛ AC c
ekşitmek	ɛ AC c ʃ i AC t m ɛ AC c
elastik	e AC l a AC s t i AC k
elbise	e AC l b i AC s ɛ AC
elbiseler	e AC l b i AC s ɛ AC l ɛ AC ɾ
elbiseyi	e AC l b i AC s ɛ AC j AB i AC
element	ɛ AC l e AC m e AC n t
elemli	ɛ AC l e AC m l i AC
elips	ɛ AC l i AC p s
elma	e AC l m ɑ AH
elmacı	e AC l m ɑ AH d ʒ ɯ AH
elmalar	e AC l m a AC l a AC ɾ
elçi	e AC l t ʃ i AC
embriyo	ɛ AC m b ɾ i AC j AB ɔ AE
emir	e AC m i AC ɾ
emir'e	e AC m i AC ɾ e AC
emir'i	e AC m i AC ɾ i AC
emir'im	e AC m i AC ɾ i AC m
emir'ime	e AC m i AC ɾ i AC m e AC
emir'in	e AC m i AC ɾ i AC n
emir'ler	e AC m i AC ɾ ɫ e AC ɾ
emire	e AC m i AC ɾ e AC
emiri	e AC m i AC ɾ i AC
emirim	e AC m i AC ɾ i AC m
emirime	e AC m i AC ɾ i AC m e AC
emirin	e AC m i AC ɾ i AC n
emirler	e AC m i AC ɾ ɫ e AC ɾ
emlak	e AC m ɫ a AC c
emlakçı	e AC m ɫ a AC c t ʃ ɯ AH
emlakçılık	e AC m ɫ a AC c t ʃ ɯ AH ɫ ɯ AH k
emniyet	e AC m n i AC j AB e AC t
emre	e AC m ɾ ɛ AC
emri	e AC m ɾ i AC
emrim	e AC m ɾ i AC m
emrin	e AC m ɾ i AC n
endülüs	ɛ AC n d y AG l y AG s
engizisyon	e AC n ɡ i AC z i AC s j AB o AE n
enişte	ɛ AC n i AC ʃ t ɛ AC
entrika	e AC n t ɾ i AC k a AC
entrikalar	e AC n t ɾ i AC k a AC ɫ a AC ɾ
entrikanın	e AC n t ɾ i AC k a AC n ɯ AH n
entrikayı	e AC n t ɾ i AC k a AC j AB ɯ AH
erdoğan	æ AC ɾ d o AE a AC n
ergenlik	e AC ɾ ɟ e AC n l i AC c
erik	e AC ɾ i AC c
eril	e AC ɾ i AC ɫ
erivan	ɛ AC ɾ i AC v ɑ AH n
erkeksi	e AC ɾ c ɛ AC c s i AC
ermenistan	æ AC ɾ m e AC n i AC s t a AC n
erotik	ɛ AC ɾ ɔ AE t i AC c
ertelenebilir	e AC ɾ t e AC ɫ e AC n e AC b i AC ɫ i AC ɾ
ertelenemez	e AC ɾ t e AC ɫ e AC n e AC m e AC z
esas	e AC s a AC s
esen	e AC s e AC n
esenlik	e AC s e AC n ɫ i AC k
esrar	ɛ AC s ɾ ɑ AH ɾ
esrarlar	ɛ AC s ɾ ɑ AH ɾ l ɑ AH ɾ
esrarı	ɛ AC s ɾ ɑ AH ɾ ɯ AH
etek	ɛ AC t ɛ AC c
etkin	e AC t k i AC n
etmek	e AC t m e AC c
ev	ɛ AC v
evcik	ɛ AC v d ʒ i AC k
evim	e AC v i AC m
evine	ɛ AC v i AC n ɛ AC
evlatlık	e AC β ɫ a AC t l ɯ AH k
evlilik	e AC β l i AC l i AC c
evrim	ɛ AC v ɾ i AC m
eğlence	e AC j AB l æ AC n d ʒ e AC
eşcinsel	ɛ AC ʃ d ʒ i AC n s e AC l
eşya	ɛ AC ʃ j AB ɑː AJ
eşzamansız	e AC ʃ z a AC m a AC n s ɯ AH z
fagot	f ɑ AH ɡ o AE t
fahişelik	f ɑː AJ h AA i AC ʃ ɛ AC l i AC c
faks	f a AC k s
fare	f aː AD ɾ ɛ AC
farklı	f ɑ AH ɾ k ɫ ɯ AH
faslı	f ɑ AH s ɫ ɯ AH
fazlalık	f a AC z ɫ a AC ɫ ɯ AH k
feci	f e AC d ʒ iː AD
fikoloji	f i AC k ɔ AE l ɔ AE ʒ i AC
filiz	f i AC l i AC z
finiş	f i AC n i AC ʃ
fizik	f i AC z i AC c
fizyoloji	f i AC z j AB o AE l o AE ʒ i AC
fişek	f i AC ʃ ɛ AC c
flaş	f l a AC ʃ
flor	f l o AE ɾ
fren	f ɾ e AC n
frende	f ɾ e AC n d e AC
frenden	f ɾ e AC n d e AC n
frene	f ɾ e AC n e AC
freni	f ɾ e AC n i AC
frenim	f ɾ e AC n i AC m
frenin	f ɾ e AC n i AC n
frenler	f ɾ e AC n ɫ e AC ɾ
frigya	f ɾ i AC ɟ j AB ɑ AH
fulya	f ʊ AE l j AB ɑ AH
fâni	f aː AD n iː AD
füze	f y AG z e AC
fırtına	f ɯ AH ɾ t ɯ AH n ɑ AH
fırtınalı	f ɯ AH ɾ t ɯ AH n ɑ AH ɫ ɯ AH
fıstık	f ɯ AH s t ɯ AH k
gaf	ɡ a AC f
gaflet	ɡ a AC f l e̞ AC t
galeri	ɡ ɑ AH l ɛ AC ɾ i AC
galiba	ɡ ɑː AJ l i AC b ɑː AJ
galiçyaca	ɡ ɑ AH l i AC t ʃ j AB ɑ AH d ʒ ɑ AH
gamlı	ɡ ɑ AH m ɫ ɯ AH
gayda	ɟ a AC j AB d a AC
gayzer	ɟ a AC j AB z e AC ɾ
gazel	ɡ ɑ AH z e AC l
gece	ɟ e̞ AC d ʒ ɛ AC
gecelik	ɟ ɛ AC d ʒ ɛ AC l i AC k
gel	ɟ æ AC l
gelinlik	ɟ ɛ AC l i AC n l i AC c
gelir	ɡ e AC l i AC ɾ
gemi	ɟ e AC m i AC
genelev	ɟ ɛ AC n ɛ AC l ɛ AC v
gençlik	ɟ ɛ AC n t ʃ l i AC c
geri	ɡ e AC ɾ i AC
geriler	ɡ e AC ɾ i AC ɫ e AC ɾ
getmek	ɡ e AC t m e AC c
gezmek	ɟ e AC z m e AC c
geçmek	ɟ e AC t ʃ m e AC c
geçmiş	ɟ ɛ AC t ʃ m i AC ʃ
gider	ɡ i AC d e AC ɾ
giysi	ɟ i AC j AB s i AC
gol	ɡ o AE l
gurbet	ɡ u AE ɾ b ɛ AC t
gurbetçi	ɡ u AE ɾ b ɛ AC t t ʃ i AC
gökdelen	ɟ œ AG k d e AC l ɛ AC n
gölge	ɟ œ AG l ɟ ɛ AC
gönül	ɟ œ AG n y AG l
göre	ɟ ø AG ɾ ɛ AC
görmek	ɟ œ AG ɾ m ɛ AC c
gösteri	ɡ œ AG s t ɛ AC r i AC
göstermek	ɟ œ AG s t ɛ AC ɾ m ɛ AC c
göt	ɟ œ AG t
gövde	ɟ ø AG v d ɛ AC
gözbebeği	ɟ ø AG z b e AC b e AC j AB i AC
gözlem	ɟ œ AG z l ɛ AC m
gözlemci	ɟ œ AG z l ɛ AC m d ʒ ɪ AC
gözleme	ɟ ø AG z l e AC m ɛ AC
gözlük	ɟ œ AG z l y AG c
gözyaşı	ɟ œ AG z j AB a AC ʃ ɯ AH
göçmek	ɟ œ AG t ʃ m ɛ AC c
göğüs	ɟ œ AG y AG s
gübre	ɟ y AG b ɾ ɛ AC
gül	ɟ y AG l
güldürmek	ɟ ʏ AG l d ʏ AG ɾ m ɛ AC c
güllacı	ɟ y AG l l a AC d ʒ ɯ AH
güllaç	ɟ y AG l l a AC t ʃ
güllaçlar	ɟ y AG l l a AC t ʃ l a AC ɾ
güllaçtan	ɟ y AG l l a AC t ʃ t a AC n
gülünç	ɡ y AG l y AG n t ʃ
gülünçleşmek	ɡ y AG l y AG n t ʃ l ɛ AC ʃ m ɛ AC c
gülüş	ɟ y AG l y AG ʃ
gümülcine	ɟ ʏ AG m ʏ AG l d ʒ i AC n ɛ AC
gümüş	ɟ y AG m y AG ʃ
gün	ɟ y AG n
günah	ɟ y AG n ɑ AH h AA
gündüz	ɟ y AG n d y AG z
günebakan	ɟ y AG n ɛ AC b ɑ AH k ɑ AH n
güneş	ɟ y AG n e AC ʃ
günler	ɟ y AG n l æ AC ɾ̝̊
günü	ɟ y AG n ʏ AG
gürcistanlı	ɟ y AG ɾ d ʒ i AC s t ɑ AH n ɫ ɯ AH
güreş	ɟ y AG ɾ ɛ AC ʃ
güven	ɟ ʏ AG v e AC n
güzelleştirmek	ɟ y AG z e AC l l ɛ AC ʃ t i AC ɾ m ɛ AC c
güç	ɟ y AG t ʃ
hadis	h AA a AC d i AC s
hadisi	h AA a AC d iː AD s i AC
hadisler	h AA a AC d i AC s ɫ e AC ɾ
hadım	h AA a AC d ɯ AH m
haham	h AA ɑ AH h AA ɑ AH m
hain	h AA aː AD i AC n
haince	h AA aː AD i AC n d ʒ e AC
hamam	h AA ɑ AH m ɑ AH m
hamburger	h AA ɑ AH m b ʊ AE ɾ ɟ e AC ɾ
hamster	h AA a AC m s t e AC ɾ
hamt	h AA a AC m t
hançer	h AA ɑ AH n t ʃ e AC ɾ
hapis	h AA a AC p i AC s
harap	h AA ɑ AH ɾ ɑ AH p
hararet	h AA ɑ AH ɾ ɑː AJ ɾ e AC t
harput	h AA ɑ AH ɾ p u AE t
harç	h AA a AC ɾ t ʃ
harçlık	h AA a AC ɾ t ʃ ɫ ɯ AH c
hastalanmak	h AA ɑ AH s t ɑ AH ɫ ɑ AH n m ɑ AH k
hastalık	h AA ɑ AH s t ɑ AH ɫ ɯ AH k
hastane	h AA ɑ AH s t ɑː AJ n ɛ AC
hastaneler	h AA ɑ AH s t ɑː AJ n ɛ AC l ɛ AC ɾ
hastaneyi	h AA ɑ AH s t ɑː AJ n ɛ AC j AB i AC
hata	h AA ɑ AH t ɑː AJ
havuz	h AA ɑ AH β u AE z
hayhay	h AA ɑ AH j AB h AA ɑ AH j AB
hayvan	h AA a AC j AB v a AC n
hayır	h AA a AC j AB ɯ AH ɾ
hayırsever	h AA a AC j AB ɰ AI ɾ s e AC v e AC ɾ
hayırseveri	h AA a AC j AB ɰ AI ɾ s e AC v e AC ɾ i AC
hayırseverim	h AA a AC j AB ɰ AI ɾ s e AC v e AC ɾ i AC m
hayırseverin	h AA a AC j AB ɰ AI ɾ s e AC v e AC ɾ i AC n
hayırseverler	h AA a AC j AB ɰ AI ɾ s e AC v e AC ɾ ɫ e AC ɾ
hazcı	h AA a AC z d ʒ ɯ AH
hazcılık	h AA a AC z d ʒ ɯ AH ɫ ɯ AH c
hazırlık	h AA a AC z ɯ AH ɾ ɫ ɯ AH k
haç	h AA a AC t ʃ
haça	h AA ɑ AH t ʃ ɑ AH
hece	h AA e AC d ʒ ɛ AC
hedef	h AA e AC d e AC f
hedonist	h AA e AC d o AE n i AC s t
hedonizm	h AA e AC d o AE n i AC z m
hele	h AA e AC l e AC
helsinki	h AA e AC l s i AC n c i AC
helva	h AA e AC l v ɑ AH
hemen	h AA ɛ AC m e AC n
hemhudut	h AA e AC m h AA u AE d u AE t
hesap	h AA e AC s a AC p
heteroseksüel	h AA ɛ AC t ɛ AC ɾ ɔ AE s ɛ AC c s y AG e AC l
heykelcik	h AA ɛ AC j AB c e AC l d ʒ i AC c
hiperbol	h AA i AC p e AC ɾ b ɔ AE l
hipermetrop	h AA i AC p e AC ɾ m e AC t ɾ o AE p
hipotalamus	h AA i AC p ɔ AE t ɑ AH ɫ ɑ AH m u AE s
his	h AA i AC s
hititoloji	h AA i AC t i AC t o AE l o AE ʒ i AC
hoca	h AA o AE d ʒ a AC
hocadır	h AA o AE d ʒ a AC d ɯ AH ɾ
hocalar	h AA o AE d ʒ a AC ɫ a AC ɾ
hocanın	h AA o AE d ʒ a AC n ɯ AH n
hocayı	h AA o AE d ʒ a AC j AB ɯ AH
hocayım	h AA o AE d ʒ a AC j AB ɯ AH m
homoseksüel	h AA ɔ AE m ɔ AE s ɛ AC c s y AG e AC l
hudut	h AA u AE d u AE t
hudutlu	h AA u AE d u AE t ɫ u AE
hudutsuz	h AA u AE d u AE t s u AE z
hurma	h AA u AE ɾ m a AC
hüzünlü	h AA y AG z y AG n l y AG
hız	h AA ɯ AH z
hızlıca	h AA ɯ AH z ɫ ɯ AH d ʒ ɑ AH
iffet	i AC f f e AC t
iftitah	i AC f t i AC t a AC h AA
ikincil	i AC k i AC n d ʒ i AC ɫ
ileti	i AC l ɛ AC t i AC
ilgeç	i AC l ɟ e AC t ʃ
ilişki	i AC l i AC ʃ c i AC
ilişkisel	i AC l i AC ʃ c i AC s e AC l
ilke	i AC l c e AC
ilklendirme	i AC ɫ k ɫ e AC n d i AC r m e AC
ilklendirmek	i AC ɫ k ɫ e AC n d i AC r m e AC c
ilklendirmeme	i AC ɫ k ɫ e AC n d i AC r m e AC m e AC
imdi	i AC m d i AC
inci	i AC n d ʒ i AC
indi	i AC n d i AC
indirim	i AC n d i AC ɾ i AC m
inek	i AC n e AC c
insan	i AC n s ɑ AH n
insanlık	i AC n s a AC n ɫ ɯ AH k
intihar	i AC n t ɑː AJ ɾ
ipek	i AC p ɛ AC c
iribaş	i AC ɾ i AC b ɑ AH ʃ
isimler	i AC s i AC m l e AC ɾ
iskender	i AC s c e AC n d e AC ɾ
istirahat	i AC s t i AC ɾ a AC h AA a AC t
istisna	i AC s t i AC s n ɑː AJ
it	i AC t
itmek	i AC t m e AC c
ittirilmek	i AC t t i AC r i AC ɫ m e AC c
ittirmek	i AC t t i AC ɾ m e AC c
ittirtilmek	i AC t t i AC r t i AC ɫ m e AC c
ittirtmek	i AC t t i AC ɾ t m e AC c
iz	i AC z
izin	i AC z i AC n
izolasyon	i AC z o AE l a AC s y AG o AE n
iç	i AC t ʃ
içecek	i AC t ʃ ɛ AC d ʒ ɛ AC k
içlik	i AC t ʃ l i AC k
işgücü	i AC ʃ ɟ y AG d ʒ y AG
i̇branice	i AC b ɾ aː AD n i AC d ʒ e AC
i̇ffet	i AC f f e AC t
i̇ngilizce	i AC n ɡ i AC l i AC z d ʒ ɛ AC
i̇pek	i AC p ɛ AC c
i̇skandinavya	i AC s k ɑ AH n d i AC n ɑ AH β j AB ɑ AH
i̇stanbul	i AC s t a AC n b u AE ɫ
i̇stanbul'dan	i AC s t a AC n b u AE ɫ d a AC n
i̇sveçli	i AC s v ɛ AC t ʃ l i AC
i̇zmir	i AC z m i AC ɾ
i̇zmirli	i AC z m i AC ɾ l i AC
jaguar	ʒ ɑ AH ɡ ʊ AE ɑ AH ɾ
jartiyer	ʒ ɑ AH ɾ t i AC j AB e AC ɾ
jelatin	ʒ ɛ AC l a AC t i AC n
jilet	ʒ i AC ɫ e AC t
jonglör	ʒ ɔ AE n ɡ l œ AG ɾ
kaba	k a AC b a AC
kabalık	k a AC b a AC ɫ ɯ AH k
kabarık	k a AC b a AC ɾ ɯ AH k
kadınlık	k a AC d ɯ AH n ɫ ɯ AH k
kahve	k ɑ AH h AA v e AC
kahverengi	k ɑ AH h AA v e AC ɾ e AC ŋ ɡ i AC
kalamar	k ɑ AH ɫ ɑ AH m ɑ AH ɾ
kaldırım	k ɑ AH ɫ d ɯ AH r ɯ AH m
kale	k ɑ AH l e AC
kalleş	k a AC ɫ e AC ʃ
kalleşçe	k a AC ɫ e AC ʃ t ʃ e AC
kalp	k a AC l p
kalpak	k ɑ AH ɫ p ɑ AH k
kamçı	k ɑ AH m t ʃ ɯ AH
kanal	k a AC n a AC l
kanguru	k ɑ AH ŋ ɡ u AE ɾ ʊ AE
kantin	k ɑ AH n t i AC n
kanto	k ɑ AH n t ɔ AE
kanun	k ɑː AJ n u AE n
kapakçık	k a AC p a AC k t ʃ ɯ AH c
kapasite	k a AC p a AC s i AC t e AC
kapasitede	k a AC p a AC s i AC t e AC d e AC
kapasiteden	k a AC p a AC s i AC t e AC d e AC n
kapasiteler	k a AC p a AC s i AC t e AC ɫ e AC ɾ
kapasitenin	k a AC p a AC s i AC t e AC n i AC n
kapasiteye	k a AC p a AC s i AC t e AC j AB e AC
kapasiteyi	k a AC p a AC s i AC t e AC j AB i AC
karadul	k ɑ AH ɾ ɑ AH d u AE ɫ
karakalpakça	k ɑ AH ɾ ɑ AH k ɑ AH ɫ p ɑ AH k t ʃ ɑ AH
karakol	k ɑ AH ɾ ɑ AH k o AE ɫ
karamel	k ɑ AH ɾ ɑ AH m e AC l
karanlık	k ɑ AH ɾ ɑ AH n ɫ ɯ AH k
kardelen	k ɑ AH ɾ d ɛ AC l e AC n
kardeş	k ɑ AH ɾ d e AC ʃ
kare	k a AC ɾ e AC
karides	k ɑ AH ɾ i AC d ɛ AC s
kars	k ɑ AH ɾ s
kartal	k ɑ AH ɾ t ɑ AH ɫ
karıncayiyen	k ɑ AH ɾ ɯ AH n d ʒ ɑ AH j AB i AC j AB e AC n
kas	k ɑ AH s
kasbilim	k a AC s b i AC l i AC m
kaside	k ɑ AH s iː AD d ɛ AC
katalog	k ɑ AH t ɑ AH ɫ ɔ AE ɡ
katkı	k a AC t k ɯ AH
kavala	k ɑ AH v ɑ AH ɫ ɑ AH
kavim	k a AC v i AC m
kaya	k a AC j AB a AC
kaygı	k ɑ AH j AB ɡ ɯ AH
kaz	k ɑ AH z
kazak	k a AC z a AC k
kaçmak	k ɑ AH t ʃ m ɑ AH k
kaçırmak	k ɑ AH t ʃ ɯ AH ɾ m ɑ AH k
kağıt	c ɑ AH ɰ AI ɯ AH t
kaşar	k ɑ AH ʃ ɑ AH ɾ
kaşık	k a AC ʃ ɯ AH k
kederli	c ɛ AC d e AC ɾ l i AC
kefir	c ɛ AC f i AC ɾ
kehribar	c ɛ AC h AA ɾ i AC b ɑ AH ɾ
kelime	c e AC l i AC m e AC
kelimeler	c ɛ AC l i AC m ɛ AC l e AC ɾ
kelimenin	c e AC l i AC m e AC n i AC n
kelimeyi	c ɛ AC l i AC m ɛ AC j AB i AC
kellik	c e AC l l i AC c
keman	c ɛ AC m ɑ AH n
kemençe	c ɛ AC m e AC n t ʃ ɛ AC
kepek	c ɛ AC p ɛ AC c
kereviz	c ɛ AC ɾ ɛ AC β i AC z
keser	c e AC s e AC ɾ
keseri	c e AC s e AC ɾ i AC
keserler	c e AC s e AC ɾ l e AC ɾ
kesmek	c e AC s m e AC c
kesyap	k e AC s j AB a AC p
kiler	k i AC l e AC ɾ
kimi	c i AC m i AC
kir	c i AC ɾ
kireç	c i AC ɾ ɛ AC t ʃ
kirmen	c i AC ɾ m e AC n
kirpik	c ɪ AC ɾ p ɪ AC c
kitap	c i AC t a AC p
kitaplık	k i AC t a AC p ɫ ɯ AH k
kitapçık	k i AC t a AC p t ʃ ɯ AH c
kişi	c i AC ʃ ɪ AC
klarnet	k l a AC ɾ n ɛ AC t
klitoris	k l i AC t ɔ AE ɾ i AC s
klişe	k l i AC ʃ ɛ AC
klor	k l o AE ɾ
klorofil	k l o AE ɾ o AE f i AC l
kolaj	k o AE ɫ a AC ʒ
kolay	k ɔ AE ɫ ɑ AH j AB
kolaç	k o AE ɫ a AC t ʃ
kolej	k o AE l e AC ʒ
kolonya	k ɔ AE l ɔ AE n j AB ɑ AH
koltuk	k o AE ɫ t u AE k
komando	k ɔ AE m ɑ AH n d o AE
komikleşmek	k o AE m i AC c l ɛ AC ʃ m ɛ AC c
konar	k o AE n a AC ɾ
konmak	k o AE n m a AC c
konmaz	k o AE n m a AC z
konsey	k o AE n s e AC j AB
konstantinopolis	k ɔ AE n s t ɑ AH n t i AC n ɔ AE p ɔ AE l i AC s
kontes	k o AE n t e AC s
konum	k o AE n u AE m
konun	k o AE n u AE n
konunun	k o AE n u AE n u AE n
konusu	k o AE n u AE s u AE
konuşmak	k o AE n u AE ʃ m ɑ AH k
koordinat	k o AE o AE ɾ d i AC n a AC t
koordinata	k o AE o AE ɾ d i AC n a AC t a AC
koordinatlar	k o AE o AE ɾ d i AC n a AC t ɫ a AC ɾ
koordinatlara	k o AE o AE ɾ d i AC n a AC t ɫ a AC ɾ a AC
koordinatlarda	k o AE o AE ɾ d i AC n a AC t ɫ a AC ɾ d a AC
koordinatlardan	k o AE o AE ɾ d i AC n a AC t ɫ a AC ɾ d a AC n
koordinatları	k o AE o AE ɾ d i AC n a AC t ɫ a AC ɾ ɯ AH
koordinatlarım	k o AE o AE ɾ d i AC n a AC t ɫ a AC ɾ ɯ AH m
koordinatların	k o AE o AE ɾ d i AC n a AC t ɫ a AC ɾ ɯ AH n
koordinatta	k o AE o AE ɾ d i AC n a AC t t a AC
koordinattan	k o AE o AE ɾ d i AC n a AC t t a AC n
koordinatı	k o AE o AE ɾ d i AC n a AC t ɯ AH
koordinatım	k o AE o AE ɾ d i AC n a AC t ɯ AH m
koordinatın	k o AE o AE ɾ d i AC n a AC t ɯ AH n
korimboz	k o AE ɾ i AC m b o AE z
korsan	k o AE ɾ s a AC n
korse	k ɔ AE ɾ s ɛ AC
kosinüs	k o AE s i AC n y AG s
kot	k ɔ AE t
kotanjant	k o AE t a AC n ʒ a AC n t
kova	k ɔ AE v ɑ AH
koy	k o AE j AB
koymak	k o AE j AB m a AC k
koymamak	k o AE j AB m a AC m a AC c
koza	k ɔ AE z ɑ AH
koşmak	k ɔ AE ʃ m ɑ AH k
koşturmak	k ɔ AE ʃ t u AE r m ɑ AH k
koşturtmak	k ɔ AE ʃ t u AE r m ɑ AH k
kraker	k ɾ ɑ AH k e AC ɾ
kral	k ɯ AH ɾ ɑ AH ɫ
kraliçe	k ɯ AH ɾ ɑ AH ɫ i AC t ʃ ɛ AC
krallık	k ɯ AH ɾ a AC ɫ ɫ ɯ AH k
kravat	k ɾ ɑ AH v ɑ AH t
krom	k ɾ o AE m
kukla	k u AE k l a AC
kuku	k u AE k u AE
kulakçık	k u AE ɫ a AC k t ʃ ɯ AH c
kulaç	k u AE ɫ a AC t ʃ
kulüp	k u AE l y AG p
kumanda	k u AE m ɑ AH n d ɑ AH
kumaş	k u AE m a AC ʃ
kural	k u AE ɾ ɑ AH ɫ
kuram	k u AE ɾ a AC m
kurban	k u AE ɾ b a AC n
kurşun	k u AE ɾ ʃ u AE n
kutsallık	k u AE t s a AC ɫ ɫ ɯ AH k
kuvantum	k u AE v a AC n t u AE m
kuvvet	k u AE v v e AC t
kuvveti	k u AE v v e AC t i AC
kuvvetim	k u AE v v e AC t i AC m
kuvvetin	k u AE v v e AC t i AC n
kuvvetler	k u AE v v e AC t ɫ e AC ɾ
kuyruk	k u AE j AB ɾ u AE c
kuyruklu	k u AE j AB r u AE k ɫ u AE
kuyruksuz	k u AE j AB r u AE k s u AE z
kuzu	k u AE z u AE
kuzular	k u AE z u AE l a AC ɾ
kuşkonmaz	k u AE ʃ k o AE n m a AC z
kuşkonmazlar	k u AE ʃ k o AE n m a AC z ɫ a AC ɾ
kuşkonmazı	k u AE ʃ k o AE n m a AC z ɯ AH
kâbus	c aː AD b u AE s
kâfir	c aː AD f i AC r
kâğıt	c ɑ AH ɰ AI ɯ AH t
köfte	c œ AG f t ɛ AC
köpek	c ø AG p e AC c
köpük	c œ AG p y AG c
kötüleşmek	c œ AG t y AG l ɛ AC ʃ m ɛ AC c
kötüleştirmek	c œ AG t y AG l ɛ AC ʃ t i AC ɾ m ɛ AC c
köy	k œ AG j AB
köylü	k œ AG j AB l y AG
kükürt	c y AG c y AG ɾ t
külot	c ʏ AG ɫ ɔ AE t
kümes	c y AG m ɛ AC s
künefe	c y AG n e AC f ɛ AC
kürk	c y AG ɾ c
küvet	c y AG v ɛ AC t
kıble	k ɯ AH b l ɛ AC
kıbrıslı	k ɯ AH b ɾ ɯ AH s ɫ ɯ AH
kıllı	k ɯ AH ɫ ɫ ɯ AH
kılma	k ɯ AH ɫ m a AC
kılsız	k ɯ AH ɫ s ɯ AH z
kılıbık	k ɯ AH ɫ ɯ AH b ɯ AH k
kırbaç	k ɯ AH ɾ b ɑ AH t ʃ
kırım	k ɯ AH ɾ ɯ AH m
kırıtmak	k ɯ AH ɾ ɯ AH t m a AC k
kıyafet	k ɯ AH j AB ɑː AJ f ɛ AC t
kıyma	k ɯ AH j AB m ɑ AH
kız	k ɯ AH z
laboratuvar	l a AC b ɔ AE ɾ ɑ AH t u AE β ɑ AH ɾ
lahana	l a AC h AA ɑ AH n ɑ AH
lahmacun	l a AC h AA m ɑː AJ d ʒ ʊ AE n
lakaytlık	l aː AD k a AC j AB t ɫ ɯ AH k
lala	ɫ ɑ AH ɫ ɑ AH
lastik	l a AC s t i AC k
laterna	l a AC t e AC ɾ n ɑ AH
lavaş	l ɑ AH v ɑ AH ʃ
layemut	ɫ aː AD j AB e AC m uː AF t
leblebi	l ɛ AC b l ɛ AC b i AC
leyla	l ɛ AC j AB ɫ ɑ AH
litvanca	l i AC t v ɑ AH n d ʒ ɑ AH
litvanyalı	l i AC t v ɑ AH n j AB ɑ AH ɫ ɯ AH
lityum	l i AC t j AB u AE m
lokum	l ɔ AE k ʊ AE m
lolipop	l ɔ AE l i AC p o AE p
lord	ɫ o AE ɾ d
lorda	ɫ o AE ɾ d a AC
lordda	ɫ o AE ɾ d d a AC
lorddan	ɫ o AE ɾ d a AC n
lordlar	ɫ o AE ɾ d ɫ a AC ɾ
lordu	ɫ o AE ɾ d u AE
lordum	ɫ o AE ɾ d u AE m
lordun	ɫ o AE ɾ d u AE n
lubunca	l u AE b u AE ɳ d ʒ ɑ AH
lubunyaca	l u AE b u AE ɳ j AB ɑ AH d ʒ ɑ AH
lunapark	l u AE n ɑ AH p ɑ AH ɾ k
maalesef	m ɑː AJ l e AC s e AC f
maaş	m ɑː AJ ʃ
madalya	m a AC d a AC l j AB a AC
maden	m a AC d ɛ AC n
maestro	m aː AD e AC s t ɾ o AE
magnezyum	m a AC ɡ n ɛ AC z j AB u AE m
mahlep	m ɑ AH h AA l ɛ AC p
mahzen	m ɑ AH h AA z e AC n
makarna	m ɑ AH k ɑ AH ɾ n ɑ AH
makta	m ɑ AH k t ɑː AJ
makul	m aː AD k u AE ɫ
makyaj	m a AC k j AB a AC ʒ
malt	m a AC l t
mancınık	m ɑ AH n d ʒ ɯ AH n ɯ AH k
mandalina	m ɑ AH n d ɑ AH l i AC n ɑ AH
manganez	m a AC n ɟ a AC n e AC z
manyetik	m ɑ AH n j AB e AC t i AC k
marmelat	m a AC ɾ m e AC l a AC t
masa	m a AC s a AC
masajlar	m ɑ AH s ɑ AH ʒ l a AC ɾ
masajı	m ɑ AH s ɑ AH ʒ ɯ AH
maskara	m ɑ AH s k ɑ AH ɾ ɑ AH
maskulen	m ɑ AH s k ʊ AE l e AC n
mastürbasyon	m a AC s t y AG ɾ b a AC s j AB o AE n
masumiyet	m ɑː AJ s ʊ AE m i AC j AB ɛ AC t
matla	m ɑ AH t ɫ ɑː AJ
matruşka	m a AC t ɾ u AE ʃ k a AC
mavi	m ɑː AJ v i AC
maya	m ɑ AH j AB ɑ AH
maymun	m a AC j AB m u AE n
maymunlar	m a AC j AB m u AE n ɫ a AC ɾ
maymunu	m a AC j AB m u AE n u AE
mayo	m ɑ AH j AB ɔ AE
mazot	m a AC z o AE t
mazotlar	m a AC z o AE t ɫ a AC ɾ
mazotu	m a AC z o AE t u AE
maça	m ɑ AH t ʃ ɑ AH
maço	m ɑ AH t ʃ o AE
maşa	m a AC ʃ a AC
maşrapa	m a AC ʃ r a AC p a AC
medrese	m ɛ AC d ɾ ɛ AC s ɛ AC
mefhum	m e AC f h AA u AE m
mefhumlar	m e AC f h AA u AE m ɫ a AC ɾ
mefhumu	m e AC f h AA uː AF m u AE
mefhumum	m e AC f h AA uː AF m u AE m
mefhumun	m e AC f h AA uː AF m u AE n
mekik	m e AC k i AC c
meksikalı	m ɛ AC c s i AC k ɑ AH ɫ ɯ AH
melis	m ɛ AC l i AC s
melisa	m ɛ AC l i AC s ɑ AH
menemen	m e AC n e AC m e AC n
menfi	m e AC n f iː AD
meni	m ɛ AC n i AC
menteşe	m ɛ AC n t ɛ AC ʃ ɛ AC
merkez	m e AC r k e AC z
mermi	m e AC ɾ m i AC
mesaj	m ɛ AC s ɑ AH ʒ
mesajlar	m ɛ AC s ɑ AH ʒ l a AC ɾ
mesajı	m ɛ AC s ɑ AH ʒ ɯ AH
metrdotel	m ɛ AC t ɾ d o AE t ɛ AC l
meyhane	m ɛ AC j AB h AA ɑː AJ n ɛ AC
meşale	m ɛ AC ʃ ɑː AJ l ɛ AC
meşhur	m e AC ʃ h AA u AE ɾ
mihrap	m i AC h AA ɾ ɑ AH p
mikrofon	m i AC k ɾ o AE f o AE n
mikronezyalı	m i AC c ɾ ɔ AE n ɛ AC z j AB ɑ AH ɫ ɯ AH
minare	m i AC n ɑː AJ ɾ ɛ AC
minber	m i AC n b e AC ɾ
misket	m i AC s c ɛ AC t
miskin	m i AC s c i AC n
miyoloji	m i AC j AB o AE l o AE ʒ i AC
miyop	m i AC j AB o AE p
moldovalı	m ɔ AE ɫ d ɔ AE v ɑ AH ɫ ɯ AH
monarşi	m o AE n a AC ɾ ʃ i AC
monolog	m o AE n o AE ɫ o AE ɟ
monologlar	m o AE n o AE ɫ o AE ɟ ɫ ɑ AH r
monoloğu	m o AE n o AE ɫ o AE ɰ AI u AE
monoloğum	m o AE n o AE ɫ o AE ɰ AI u AE m
monoloğun	m o AE n o AE ɫ o AE ɰ AI u AE n
moron	m o AE ɾ o AE n
moskovalı	m ɔ AE s k ɔ AE v ɑ AH ɫ ɯ AH
motorin	m o AE t o AE ɾ i AC n
motorini	m o AE t o AE r i AC n i AC
motorinler	m o AE t o AE r i AC n ɫ e AC ɾ
mucize	m uː AF d ʒ i AC z ɛ AC
mumluk	m u AE m ɫ u AE k
mumya	m u AE m j AB ɑ AH
muson	m u AE s o AE n
mutfak	m u AE t f ɑ AH k
mutluluk	m u AE t ɫ u AE ɫ u AE k
muzaffer	m u AE z a AC f f æ AC ɾ
müdür	m y AG d y AG r
müge	m y AG ɟ ɛ AC
müsaade	m y AG s ɑː AJ d e AC
müsait	m ʏ AG s ɑː AJ i AC t
müspet	m y AG s p e AC t
müttehit	m y AG t t e AC h AA i AC t
müzik	m y AG z ɪ AC k
müşteri	m y AG ʃ t ɛ AC ɾ i AC
mıh	m ɯ AH h AA
mısra	m ɯ AH s ɾ aː AD
mısır	m ɯ AH s ɯ AH ɾ
nagasaki	n ɑ AH ɡ ɑ AH z ɑː AJ c i AC
namaz	n ɑ AH m ɑ AH z
namüsait	n ɑː AJ m ʏ AG s ɑː AJ i AC t
nargile	n ɑ AH ɾ ɟ i AC l ɛ AC
nasıl	n ɑ AH s ɯ AH ɫ
nasılsın	n ɑ AH s ɯ AH ɫ s ɯ AH n
nasılsınız	n ɑ AH s ɯ AH ɫ s ɯ AH n ɯ AH z
nazen	n a AC z e AC n
nazenin	n a AC z e AC n i AC n
neden	n ɛ AC d æ AC n
neon	n ɛ AC o AE n
neredeyse	n e AC r e AC d e AC j AB s e AC
nergis	n e AC ɾ ɟ i AC z
neyse	n ɛ AC j AB s ɛ AC
nice	n i AC d ʒ e AC
nihayet	n i AC h AA ɑː AJ j AB ɛ AC t
nikel	n i AC c ɛ AC l
nilüfer	n i AC l y AG f e AC ɾ
nohut	n ɔ AE h AA ʊ AE t
noktürn	n o AE k t y AG r n
noktürnler	n o AE k t y AG r n ɫ e AC ɾ
noktürnü	n o AE k t y AG r n y AG
noktürnüm	n o AE k t y AG r n y AG m
noktürnün	n o AE k t y AG r n y AG n
notilus	n ɔ AE t i AC ɫ ʊ AE s
okiya	ɔ AE c ɪ AC j AB ɑ AH
okul	o AE k u AE ɫ
okunaklı	o AE k u AE n a AC k ɫ ɯ AH
okunaklılık	o AE k u AE n a AC k ɫ ɯ AH ɫ ɯ AH k
okunaksız	o AE k u AE n a AC k s ɯ AH z
okunaksızlık	o AE k u AE n a AC k s ɯ AH z ɫ ɯ AH k
okçu	o̞ AE k t ʃ u AE
olay	ɔ AE ɫ ɑ AH j AB
oligarşi	o AE l i AC ɟ a AC ɾ ʃ i AC
olmak	o AE ɫ m a AC k
olta	ɔ AE ɫ t ɑ AH
olumlu	o AE ɫ u AE m ɫ u AE
olumluluk	o AE ɫ u AE m ɫ u AE ɫ u AE c
olumsuz	o AE ɫ u AE m s u AE z
olumsuzluk	o AE ɫ u AE m s u AE z ɫ u AE c
ongen	o AE n ɟ e AC n
orta	o AE ɾ t a AC
ortam	o AE ɾ t a AC m
orçun	ɔ AE ɾ t ʃ u AE n
ot	ɔ AE t
otizm	ɔ AE t i AC z m
oto	ɔ AE t ɔ AE
otocu	o AE t o AE d ʒ u AE
otocular	o AE t o AE d ʒ u AE ɫ a AC ɾ
otoculuk	o AE t o AE d ʒ u AE ɫ u AE c
otoculuklar	o AE t o AE d ʒ u AE ɫ u AE k ɫ a AC ɾ
otoculuğu	o AE t o AE d ʒ u AE ɫ u AE ɰ AI u AE
otoculuğum	o AE t o AE d ʒ u AE ɫ u AE ɰ AI u AE
otoculuğun	o AE t o AE d ʒ u AE ɫ u AE ɰ AI u AE n
otocunun	o AE t o AE d ʒ u AE n u AE n
otocuyu	o AE t o AE d ʒ u AE y AG u AE
otogar	ɔ AE t ɔ AE ɡ ɑ AH ɾ
otom	o AE t o AE m
otomobil	o AE t o AE m o AE b i AC ɫ
otomobilci	o AE t o AE m o AE b i AC ɫ d ʒ i AC
otomobilciler	o AE t o AE m o AE b i AC ɫ d ʒ i AC ɫ e AC ɾ
otomobilcilik	o AE t o AE m o AE b i AC ɫ d ʒ i AC ɫ i AC c
otomobilcilikler	o AE t o AE m o AE b i AC ɫ d ʒ i AC ɫ i AC k ɫ e AC ɾ
otomobilciliği	o AE t o AE m o AE b i AC ɫ d ʒ i AC ɫ i AC ɰ AI i AC
otomobilciliğim	o AE t o AE m o AE b i AC ɫ d ʒ i AC ɫ i AC ɰ AI i AC m
otomobilciliğin	o AE t o AE m o AE b i AC ɫ d ʒ i AC ɫ i AC ɰ AI i AC n
otomobilcim	o AE t o AE m o AE b i AC ɫ d ʒ i AC m
otomobilcin	o AE t o AE m o AE b i AC ɫ d ʒ i AC n
otomobilcinin	o AE t o AE m o AE b i AC ɫ d ʒ i AC n i AC n
otomobilcisi	o AE t o AE m o AE b i AC ɫ d ʒ i AC s i AC
otomobilciyi	o AE t o AE m o AE b i AC ɫ d ʒ i AC ɫ i AC c j AB i AC
otomobili	o AE t o AE m o AE b i AC ɫ i AC
otomobilim	o AE t o AE m o AE b i AC ɫ i AC m
otomobilin	o AE t o AE m o AE b i AC ɫ i AC n
otomobiller	o AE t o AE m o AE b i AC ɫ ɫ e AC ɾ
oton	o AE t o AE n
otonun	o AE t o AE n u AE n
otostop	ɔ AE t ɔ AE s t ɔ AE p
otostopçu	ɔ AE t ɔ AE s t ɔ AE p t ʃ ʊ AE
otosu	o AE t o AE s u AE
oymak	o AE j AB m a AC c
oymamak	o AE j AB m a AC m a AC c
oyun	o AE j AB u AE n
oyunculuk	o AE j AB u AE n d ʒ u AE ɫ u AE k
oyunlar	o AE j AB u AE n l a AC ɾ
palavra	p ɑ AH ɫ ɑ AH v ɾ ɑ AH
palikarya	p a AC l i AC k ɑ AH ɾ j AB ɑ AH
palmiye	p a AC l m i AC j AB ɛ AC
panamalı	p ɑ AH n ɑ AH m ɑ AH ɫ ɯ AH
pancar	p ɑ AH n d ʒ ɑ AH ɾ
panda	p a AC n d a AC
pandispanya	p ɑ AH n d i AC s p ɑ AH n j AB ɑ AH
papirüs	p ɑ AH p i AC ɾ y AG s
papyon	p ɑ AH p j AB ɔ AE n
parabol	p ɑ AH ɾ ɑ AH b ɔ AE l
paralelkenar	p a AC ɾ a AC l e AC l k e AC n a AC ɾ
parasızlık	p a AC ɾ a AC s ɯ AH z ɫ ɯ AH k
paris	p ɑː AJ ɾ i AC s
parlatmak	p ɑ AH ɾ ɫ ɑ AH t m ɑ AH k
parlatıcı	p ɑ AH ɾ ɫ ɑ AH t ɯ AH d ʒ ɯ AH
paten	p ɑ AH t e AC n
patik	p a AC t i AC c
pay	p a AC j AB
payda	p a AC j AB d a AC
paydalar	p a AC j AB d a AC ɫ a AC ɾ
paydayı	p a AC j AB d a AC j AB ɯ AH
paylamaz	p a AC j AB ɫ a AC m a AC z
paylar	p a AC j AB ɫ a AC ɾ
payı	p a AC j AB ɯ AH
payım	p a AC j AB ɯ AH m
payın	p a AC j AB ɯ AH n
paşa	p ɑ AH ʃ ɑ AH
peder	p ɛ AC d e AC ɾ
pelin	p e AC l i AC n
pencere	p e AC n d ʒ e AC ɾ e AC
perende	p e AC r æ AC n d ɛ AC
perestroyka	p e AC ɾ e AC s t ɾ o AE j AB k ɑ AH
peynir	p ɛ AC j AB n i AC ɾ
pezevenk	p e AC z e AC v e AC ɳ c
pijama	p ɪ AC ʒ ɑ AH m ɑ AH
pipi	p i AC p i AC
piramit	p i AC ɾ a AC m i AC t
polinom	p ɔ AE l i AC n ɔ AE m
politikacı	p ɔ AE l i AC t i AC k ɑ AH d ʒ ɯ AH
pompa	p o AE m p a AC
porno	p o AE ɾ n o AE
portekizli	p ɔ AE ɾ t ɛ AC c i AC z l i AC
post	p o AE s t
prenses	p ɾ ɛ AC n s e̞ AC s
prensip	p ɾ e AC n s i AC p
psikiyatr	p s i AC k i AC j AB a AC t ɾ
psikiyatrist	p s i AC k i AC j AB a AC t ɾ i AC s t
psikolog	p s i AC k ɔ AE l ɔ AE ɡ
psikoloji	p s i AC k ɔ AE l ɔ AE ʒ i AC
psikosomatik	p s i AC c ɔ AE s ɔ AE m ɑ AH t i AC c
psikoterapi	p s i AC k ɔ AE t ɛ AC ɾ ɑ AH p i AC
puan	p u AE ɑ AH n
pyongyang	p j AB o AE n ɡ j AB a AC n ɡ
rahat	ɾ ɑ AH h AA ɑ AH t
rakam	ɾ ɑ AH k ɑ AH m
raket	ɾ a AC k e AC t
rakı	ɾ ɑ AH k ɯ AH
ranza	r ɑ AH n z ɑ AH
rağmen	r aː AD m ɛ AC n
rebetiko	ɾ ɛ AC b ɛ AC t i AC k ɔ AE
rehine	ɾ ɛ AC h AA iː AD n ɛ AC
renk	ɾ e AC ŋ k
reçel	ɾ e AC t ʃ e AC l
riboz	ɾ i AC b o AE z
rimel	ɾ i AC m e AC l
ritüel	ɾ i AC t y AG e AC l
roket	ɾ o AE k e AC t
ruj	ɾ u AE ʒ
rumca	ɾ ʊ AE m d ʒ ɑ AH
rüya	ɾ ʏ AG j AB ɑː AJ
sabit	s ɑː AJ b i AC t
sabırlı	s ɑ AH b ɯ AH ɾ ɫ ɯ AH
saga	s ɑ AH ɡ ɑ AH
sahip	s ɑː AJ h AA i AC p
saka	s a AC k a AC
saksafon	s ɑ AH k s ɑ AH f ɔ AE n
saksı	s ɑ AH k s ɯ AH
sakız	s a AC k ɯ AH z
salak	s ɑ AH l ɑ AH k
salıncak	s ɑ AH ɫ ɯ AH n d ʒ ɑ AH k
saman	s a AC m a AC n
samuray	s a AC m u AE ɾ a AC j AB
sanat	s ɑ AH n ɑ AH t
sansar	s ɑ AH n s ɑ AH ɾ
sapan	s ɑ AH p ɑ AH n
sapıkça	s ɑ AH p ɯ AH k t ʃ ɑ AH
sarmal	s a AC ɾ m a AC ɫ
sarmaşık	s a AC ɾ m a AC ʃ ɯ AH k
sarılmak	s ɑ AH ɾ ɯ AH ɫ m ɑ AH k
sarımsak	s a AC ɾ ɯ AH m s a AC k
savaşçı	s ɑ AH β ɑ AH ʃ t ʃ ɯ AH
sayfa	s ɑ AH j AB f ɑ AH
saçma	s ɑ AH t ʃ m ɑ AH
saçmalık	s ɑ AH t ʃ m ɑ AH ɫ ɯ AH k
sağ	s aː AD
sağlam	s ɑ AH ɰ AI ɫ ɑ AH m
sağrı	s ɑ AH ɰ AI ɾ ɯ AH
sağım	s a AC ɰ AI ɯ AH m
seccade	s ɛ AC d ʒ d ʒ ɑː AJ d ɛ AC
seher	s e AC h AA e AC r
sekizgen	s e AC k i AC z ɟ e AC n
sekreter	s e AC k ɾ e AC t e AC ɾ
selanik	s e AC l aː AD n i AC c
semer	s ɛ AC m e AC ɾ
semerci	s ɛ AC m e AC ɾ d ʒ i AC
sen	s æ AC n
senkretizm	s ɛ AC n k ɾ ɛ AC t i AC z m
sepet	s ɛ AC p ɛ AC t
serçe	s e AC ɾ t ʃ ɛ AC
sessizlik	s ɛ AC s s i AC z l i AC c
sevda	s e AC β d ɑ AH
sevdalinka	s ɛ AC v d ɑː AJ l i AC ɳ k ɑ AH
seven	s e AC v e AC n
sevgili	s e AC β ɟ i AC l i AC
sevilen	s e AC v i AC ɫ e AC n
sevilmek	s e AC v i AC ɫ m e AC c
sevilmemek	s e AC v i AC ɫ m e AC m e AC c
sevilmeyen	s e AC v i AC ɫ m e AC j AB e AC n
sevinmek	s e AC v i AC n m e AC c
sevişmek	s e AC v i AC ʃ m e AC c
sevmek	s e AC v m e AC c
seyahat	s e AC j AB ɑ AH h AA ɑ AH t
seçer	s e AC t ʃ e AC r
seçilebilir	s e AC t ʃ i AC ɫ e AC b i AC ɫ i AC ɾ
seçilemez	s e AC t ʃ i AC ɫ e AC m e AC z
seçilir	s e AC t ʃ i AC ɫ i AC r
seçilmez	s e AC t ʃ i AC ɫ m e AC z
seçmek	s e AC t ʃ m e AC c
seçmemek	s e AC t ʃ m e AC m e AC c
seçmez	s e AC t ʃ m e AC z
sidik	s i AC d i AC c
sigara	s ɪ AC ɡ ɑ AH ɾ ɑ AH
sik	s i AC c
sikilmek	s i AC c i AC l m ɛ AC c
sikmek	s i AC c m ɛ AC c
silgi	s i AC l ɟ i AC
silindir	s i AC l i AC n d i AC ɾ
silisyum	s i AC l i AC s j AB u AE m
simya	s i AC m j AB aː AD
sincap	s i AC n d ʒ ɑ AH p
sindirim	s i AC n d i AC ɾ i AC m
sinem	s i AC n e AC m
singapurlu	s i AC ɳ ɡ ɑ AH p u AE ɾ ɫ u AE
sinir	s i AC n i AC ɾ
sinirlendirici	s i AC n i AC ɾ ɫ e AC n d i AC ɾ i AC d ʒ i AC
sinirlendirmeyici	s i AC n i AC ɾ ɫ e AC n d i AC ɾ m e AC j AB i AC d ʒ i AC
sinirli	s i AC n i AC r l i AC
sinirsiz	s i AC n i AC r s i AC z
sinüs	s i AC n y AG s
sistemi	s i AC s t e AC m i AC
sistemim	s i AC s t e AC m i AC m
sistemin	s i AC s t e AC m i AC n
sistemini	s i AC s t e AC m i AC n i AC
sistemler	s i AC s t e AC ɫ e AC ɾ
sistemli	s i AC s t e AC m ɫ i AC
sistemsiz	s i AC s t e AC m s i AC z
site	s i AC t e AC
sivil	s i AC v i AC l
sivilce	s i AC v i AC l d ʒ ɛ AC
sivrisinek	s i AC v ɾ i AC s i AC n ɛ AC c
siyasetçi	s i AC j AB ɑː AJ s ɛ AC t t ʃ i AC
skrotum	s ɯ AH k ɾ o AE t u AE m
smiley	s m a AC j AB l e AC j AB
sofyalı	s ɔ AE f j AB ɑ AH ɫ ɯ AH
sokak	s ɔ AE k ɑ AH k
sol	s ɔ AE ɫ
solmak	s ɔ AE ɫ m ɑ AH k
sonbahar	s ɔ AE n b ɑ AH h AA ɑ AH ɾ
sonsuzluk	s o AE n s u AE z ɫ u AE k
sormak	s o AE ɾ m a AC k
sorumlu	s o AE ɾ u AE m ɫ u AE
sorumluluk	s o AE ɾ u AE m ɫ u AE ɫ u AE k
sorumsuz	s o AE ɾ u AE m s u AE z
sorumsuzluk	s o AE ɾ u AE m s u AE z ɫ u AE k
sosyolog	s o AE s j AB o AE ɫ o AE ɟ
sosyoloji	s o AE s j AB o AE l o AE ʒ i AC
soygaz	s ɔ AE j AB ɡ ɑ AH z
soylu	s o AE j AB l u AE
spam	s p a AC m
spamcıl	s p a AC m d ʒ ɯ AH ɫ
sporcu	s p ɔ AE ɾ d ʒ ʊ AE
sporcular	s p ɔ AE ɾ d ʒ ʊ AE ɫ a AC ɾ
sporcum	s p ɔ AE ɾ d ʒ ʊ AE m
sporcun	s p ɔ AE ɾ d ʒ ʊ AE n
sporcunun	s p ɔ AE ɾ d ʒ ʊ AE n ʊ AE n
sporcusu	s p ɔ AE ɾ d ʒ ʊ AE s ʊ AE
sporcuyu	s p ɔ AE ɾ d ʒ ʊ AE j AB ʊ AE
stant	s t a AC n t
start	s t a AC ɾ t
su	s u AE
sucuk	s u AE d ʒ u AE k
sucuklar	s u AE d ʒ u AE c l a AC ɾ
supap	s u AE p a AC p
susuz	s u AE s u AE z
susuzluk	s u AE s u AE z ɫ u AE k
sutyen	s u AE t j AB e AC n
suçlamak	s u AE t ʃ l a AC m a AC k
söyleniş	s ø AG j AB l ɛ AC n i AC ʃ
söz	s ø AG z
sözcük	s œ AG z d ʒ y AG c
sözlük	s œ AG z l y AG k
sülfür	s y AG l f y AG ɾ
sülük	s y AG l y AG c
sümük	s ʏ AG m ʏ AG c
sünger	s y AG ɳ ɟ e AC ɾ
sürdürebilirlik	s y AG ɾ d y AG ɾ e AC b i AC l i AC ɾ l i AC c
sürdürmek	s y AG ɾ d y AG ɾ m e AC c
sürdürmemek	s y AG ɾ d y AG ɾ m e AC m e AC c
sürdürülebilirlik	s y AG ɾ d y AG ɾ y AG ɫ e AC b i AC l i AC ɾ l i AC c
süreklilik	s y AG ɾ ɛ AC c l i AC l i AC c
sürgün	s ʏ AG ɾ ɟ ʏ AG n
sürmemek	s y AG ɾ m e AC m e AC c
sürpriz	s y AG ɾ p ɾ i AC z
sürtük	s y AG r t y AG c
sürücü	s y AG ɾ y AG d ʒ y AG
sürülmek	s y AG ɾ y AG l m e AC c
sürülmemek	s y AG ɾ y AG l m e AC m e AC c
sürüm	s y AG ɾ y AG m
sürümde	s y AG ɾ y AG m d e AC
sürümden	s y AG ɾ y AG m d e AC n
sürüme	s y AG ɾ y AG m e AC
sürümler	s y AG ɾ y AG m ɫ e AC ɾ
sürümü	s y AG ɾ y AG m y AG
sürümüm	s y AG ɾ y AG m y AG m
sürümün	s y AG ɾ y AG m y AG n
sürüngen	s ʏ AG ɾ ʏ AG ɳ ɟ e AC n
süt	s y AG t
sütyen	s ʏ AG t j AB e AC n
süzme	s y AG z m e AC
süzmek	s y AG z m e AC c
sıcaklık	s ɯ AH d ʒ ɑ AH k ɫ ɯ AH k
sıfat	s ɯ AH f a AC t
sıfatlar	s ɯ AH f a AC t l a AC r
sıfatı	s ɯ AH f a AC t ɯ AH
sıhhi	s ɯ AH h AA h AA iː AD
sıkmak	s ɯ AH k m a AC k
sıkıntı	s ɯ AH k ɯ AH n t ɯ AH
sıkıntılar	s ɯ AH c ɾ ɯ AH n t ɯ AH l a AC ɾ
sıkıntıyı	s ɯ AH k ɯ AH n t ɯ AH j AB ɯ AH
sınav	s ɯ AH n a AC β
sınır	s ɯ AH n ɯ AH ɾ
sınırdaş	s ɯ AH n ɯ AH ɾ d a AC ʃ
sınırlı	s ɯ AH n ɯ AH r l ɯ AH
sınırsız	s ɯ AH n ɯ AH r s ɯ AH z
sıpa	s ɯ AH p a AC
sıradan	s ɯ AH ɾ ɑ AH d ɑ AH n
tabanca	t ɑ AH b ɑ AH n d ʒ ɑ AH
taciz	t aː AD d ʒ i AC z
tahdit	t a AC h AA d i AC t
taksi	t ɑ AH k s i AC
takvim	t ɑ AH k v i AC m
tandır	t ɑ AH n d ɯ AH ɾ
tanjant	t a AC n ʒ a AC n t
tanrı	t ɑ AH n ɾ ɯ AH
taraf	t ɑ AH ɾ ɑ AH f
tarihçi	t ɑː AJ ɾ i AC h AA t ʃ i AC
tarzanca	t ɑ AH ɾ z ɑ AH n d ʒ ɑ AH
tarım	t a AC ɾ ɯ AH m
tatar	t a AC t a AC ɾ
taverna	t ɑ AH β e AC ɾ n ɑ AH
tavukgötü	t ɑ AH β u AE k ɟ œ AG t y AG
tayfa	t ɑ AH j AB f ɑ AH
tayga	t a AC j AB ɟ a AC
taç	t ɑ AH t ʃ
taşak	t ɑ AH ʃ ɑ AH k
taşeron	t a AC ʃ e AC r o̞ AE n
tecrit	t e AC j AB r i AC t
tehlike	t e AC h AA ɫ i AC k e AC
tehlikeli	t e AC h AA ɫ i AC k e AC ɫ i AC
tehlikesiz	t e AC h AA ɫ i AC k e AC s i AC z
tekfur	t ɛ AC c f ʊ AE ɾ
tekrar	t e AC k ɾ a AC ɾ
tensör	t e AC n s ø AG ɾ
tensörler	t e AC n s ø AG ɾ ɫ e AC ɾ
tensörü	t e AC n s ø AG ɾ y AG
tensörüm	t e AC n s ø AG ɾ y AG m
tensörün	t e AC n s ø AG ɾ y AG n
tercih	t æ AC ɾ d ʒ i AC h AA
tercüman	t æ AC ɾ d ʒ y AG m ɑ AH n
testine	t ɛ AC s t i AC n ɛ AC
testinin	t ɛ AC s t i AC n i AC n
tezene	t ɛ AC z ɛ AC n ɛ AC
tiflis	t i AC f l i AC s
tilde	t i AC l d e AC
tip	t i AC p
tipografi	t i AC p o̞ AE ɡ r a AC f i AC
tipografik	t i AC p o̞ AE ɡ r a AC f i AC k
tipografya	t i AC p o̞ AE ɡ r a AC f j AB a AC
tonton	t o AE n t o AE n
topik	t ɔ AE p i AC c
topografik	t ɔ AE p ɔ AE ɡ ɾ ɑ AH f i AC c
topçu	t o̞ AE p t ʃ ʊ AE
torun	t ɔ AE ɾ ʊ AE n
tosbağa	t o AE s b aː AD
trafik	t ɾ a AC f i AC c
trajik	t r a AC j AB iː AD c
travma	t ɾ ɑ AH v m ɑ AH
trende	t ɾ e AC n d e AC
trenden	t ɾ e AC n d e AC n
trene	t ɾ e AC n e AC
treni	t ɾ e AC n i AC
trenim	t ɾ e AC n i AC m
trenimi	t ɾ e AC n i AC m i AC
trenin	t ɾ e AC n i AC n
trenini	t ɾ e AC n i AC n i AC
trenler	t ɾ e AC n ɫ e AC ɾ
tuvalet	t u AE β a AC l e AC t
tuğra	t uː AF r a AC
tümce	t y AG m d ʒ ɛ AC
türev	t y AG ɾ ɛ AC v
türkiye	t y AG ɾ c i AC j AB ɛ AC
türkmence	t y AG ɾ c m e AC n d ʒ ɛ AC
türkân	t y AG ɾ k j AB a AC n
tütmek	t y AG t m e AC c
tütsü	t y AG t s y AG
tütü	t y AG t y AG
tütüncü	t y AG t y AG n d ʒ y AG
tüy	t y AG j AB
ugandalı	u AE ɡ ɑ AH n d ɑ AH ɫ ɯ AH
ukraynaca	ʊ AE k ɾ ɑ AH j AB n ɑ AH d ʒ ɑ AH
ukraynalı	ʊ AE k ɾ ɑ AH j AB n ɑ AH ɫ ɯ AH
usta	u AE s t a AC
utandırmak	u AE t ɑ AH n d ɯ AH ɾ m ɑ AH k
utanmak	u AE t ɑ AH n m ɑ AH k
uyanmak	u AE j AB ɑ AH n m ɑ AH k
uydu	u AE j AB d u AE
uygun	u AE j AB ɡ u AE n
uzay	u AE z a AC j AB
uçak	u AE t ʃ a AC k
uçurtma	u AE t ʃ u AE ɾ t m ɑ AH
uğramak	uː AF r a AC m a AC k
uğratmak	u AE ɰ AI r a AC t m a AC k
uğratılmak	u AE ɰ AI r a AC t ɯ AH l m a AC k
uğur	uː AF ɾ
vade	v ɑː AJ d ɛ AC
vaha	β ɑ AH h AA ɑː AJ
valide	β aː AD l i AC d e AC
vapur	v ɑ AH p u AE ɾ
varış	β a AC ɾ ɯ AH ʃ
vasat	v ɑ AH s ɑ AH t
vasiyet	β a AC s i AC j AB e AC t
vefat	v e AC f aː AD t
vefatlar	v e AC f aː AD t ɫ a AC ɾ
vefatı	v e AC f aː AD t ɯ AH
vefatın	v e AC f aː AD t ɯ AH n
velet	v ɛ AC l ɛ AC t
venedikli	v e AC n e AC d i AC k l i AC
vermek	v e AC ɾ m e AC c
veteriner	β ɛ AC t ɛ AC ɾ i AC n e AC ɾ
veya	v ɛ AC j AB ɑː AJ
veyahut	v ɛ AC j AB ɑː AJ h AA u AE t
vietnamca	v i AC ɛ AC t n ɑ AH m d ʒ ɑ AH
vietnamlı	v i AC ɛ AC t n ɑ AH m ɫ ɯ AH
vilayet	v i AC l a AC j AB ɛ AC t
virgül	β i AC ɾ ɡ y AG l
viyanalı	v i AC j AB ɑ AH n ɑ AH ɫ ɯ AH
voleybol	β o AE l e AC j AB b o AE ɫ
votka	β ɔ AE t k ɑ AH
vuvuzela	v u AE v u AE z ɛ AC ɫ ɑ AH
yahudi	j AB ɑ AH h AA ʊ AE d i AC
yahudilik	j AB ɑ AH h AA ʊ AE d i AC l i AC c
yahut	j AB ɑː AJ h AA u AE t
yakmak	j AB a AC k m a AC k
yakmamak	j AB a AC k m a AC m a AC k
yakut	j AB ɑː AJ k ʊ AE t
yakın	j AB a AC k ɯ AH n
yalan	j AB a AC ɫ a AC n
yalnız	j AB a AC ɫ n ɯ AH z
yalnızlık	j AB a AC ɫ n ɯ AH z ɫ ɯ AH k
yalvarış	j AB a AC l β a AC ɾ ɯ AH ʃ
yalıtım	j AB a AC l ɯ AH t ɯ AH m
yamyam	j AB ɑ AH m j AB ɑ AH m
yangın	j AB ɑ AH ŋ ɡ ɯ AH n
yani	j AB ɑː AJ n i AC
yanlışlık	j AB a AC n ɫ ɯ AH ʃ ɫ ɯ AH k
yanıtlamak	j AB ɑ AH n ɯ AH t ɫ ɑ AH m ɑ AH k
yaprak	j AB ɑ AH p ɾ ɑ AH k
yapıncak	j AB ɑ AH p ɯ AH n d ʒ ɑ AH k
yara	j AB ɑ AH ɾ ɑ AH
yarak	j AB a AC ɾ a AC k
yaraklar	j AB a AC ɾ a AC k ɫ a AC r
yaralı	j AB ɑ AH ɾ ɑ AH l ɯ AH
yarar	j AB a AC ɾ a AC ɾ
yaratıcı	j AB ɑ AH ɾ ɑ AH t ɯ AH d ʒ ɯ AH
yardımsever	j AB ɑ AH ɾ d ɯ AH m s e AC v e AC ɾ
yardımseverlik	j AB ɑ AH ɾ d ɯ AH m s e AC v e AC ɾ ɫ i AC c
yarmak	j AB a AC ɾ m a AC k
yarmaz	j AB a AC ɾ m a AC z
yarışma	j AB a AC ɾ ɯ AH ʃ m a AC
yasa	j AB ɑ AH s ɑ AH
yasak	j AB ɑ AH s ɑ AH k
yasemin	j AB ɑː AJ s ɛ AC m i AC n
yatay	j AB ɑ AH t ɑ AH j AB
yavaşça	j AB ɑ AH v ɑ AH ʃ t ʃ ɑ AH
yavru	j AB a AC v ɾ u AE
yavrulamaz	j AB a AC v ɾ u AE ɫ a AC m a AC z
yavrular	j AB a AC v ɾ u AE ɫ a AC ɾ
yavrum	j AB a AC v ɾ u AE m
yavrun	j AB a AC v ɾ u AE n
yavrunun	j AB a AC v ɾ u AE n u AE n
yavrusu	j AB a AC v ɾ u AE s u AE
yavruyu	j AB a AC v ɾ u AE j AB u AE
yavşak	j AB a AC v ʃ a AC k
yaya	j AB a AC j AB a AC
yayımcılık	j AB a AC j AB ɯ AH m d ʒ ɯ AH ɫ ɯ AH c
yayıncılık	j AB a AC j AB ɯ AH n d ʒ ɯ AH ɫ ɯ AH c
yazarım	j AB a AC z a AC ɾ ɯ AH m
yazma	j AB a AC z m a AC
yazmak	j AB a AC z m a AC k
yazmalar	j AB a AC z m a AC ɫ a AC ɾ
yazmam	j AB a AC z m a AC m
yazmamak	j AB a AC z m a AC m a AC c
yazmanın	j AB a AC z m a AC n ɯ AH n
yazmayı	j AB a AC z m a AC j AB ɯ AH
yağma	j AB ɑ AH ɰ AI m ɑ AH
yağmurlu	j AB aː AD m u AE ɾ ɫ u AE
yağış	j AB ɑ AH ɰ AI ɯ AH ʃ
yaşasın	j AB ɑ AH ʃ ɑ AH s ɯ AH n
yedigen	j AB e AC d i AC ɟ e AC n
yedirmek	j AB ɛ AC d i AC ɾ m ɛ AC k
yedirtmek	j AB ɛ AC d i AC ɾ t m ɛ AC k
yedirtmemek	j AB ɛ AC d i AC ɾ t m ɛ AC m ɛ AC k
yemek	j AB ɛ AC m ɛ AC c
yemeni	j AB ɛ AC m ɛ AC n i AC
yemiş	j AB ɛ AC m i AC ʃ
yemişi	j AB ɛ AC m i AC ʃ i AC
yemişler	j AB ɛ AC m i AC ʃ l e AC ɾ
yendirmek	j AB ɛ AC n d i AC ɾ m ɛ AC k
yendirtmek	j AB ɛ AC n d i AC ɾ t m ɛ AC k
yengeç	j AB ɛ AC n ɟ ɛ AC t ʃ
yenmek	j AB ɛ AC n m ɛ AC k
yeti	j AB e AC t i AC
yetmiş	j AB ɛ AC t m i AC ʃ
yeşim	j AB e AC ʃ i AC m
yirmigen	j AB i AC r m i AC ɟ e AC n
yiğit	j AB iː AD t
yol	j AB ɔ AE ɫ
yolculuk	j AB ɔ AE ɫ d ʒ u AE ɫ u AE k
yorgunluk	j AB o AE ɾ ɟ u AE n ɫ u AE k
yoğurt	j AB o AE ʊ AE r t
yoğurtçu	j AB o AE ʊ AE r t t ʃ ʊ AE
yoğurtçuluk	j AB o AE ʊ AE r t t ʃ ʊ AE ɫ ʊ AE k
yufka	j AB ʊ AE f k ɑ AH
yugoslavya	j AB ɔ AE ɡ ɔ AE s ɫ ɑː AJ v j AB ɑ AH
yumurtalık	j AB ʊ AE m ʊ AE ɾ t ɑ AH ɫ ɯ AH k
yunan	j AB u AE n ɑ AH n
yunanca	j AB u AE n ɑ AH n d ʒ ɑ AH
yunanistan	j AB u AE n a AC n i AC s t a AC n
yutmak	j AB u AE t m ɑ AH k
yöre	j AB ø AG ɾ ɛ AC
yörekent	j AB ø AG ɾ ɛ AC k ɛ AC n t
yörünge	j AB ø AG r y AG n ɡ e AC
yürek	j AB y AG ɾ ɛ AC c
yüzde	j AB y AG z d ɛ AC
yüzey	j AB ʏ AG z ɛ AC j AB
yıldırı	j AB ɯ AH ɫ d ɯ AH ɾ ɯ AH
yıldızıl	j AB ɯ AH l d ɯ AH z ɯ AH l
yılmaz	j AB ɯ AH ɫ m ɑ AH z
zafer	z ɑ AH f e AC ɾ
zaferde	z ɑ AH f e AC ɾ d ɛ AC
zaferden	z ɑ AH f e AC ɾ d e AC n
zafere	z ɑ AH f ɛ AC ɾ ɛ AC
zaferi	z ɑ AH f ɛ AC ɾ i AC
zaferin	z ɑ AH f ɛ AC ɾ i AC n
zaferler	z ɑ AH f e AC ɾ l e AC ɾ
zaferlerde	z ɑ AH f e AC ɾ l e AC ɾ d ɛ AC
zaferlerden	z ɑ AH f e AC ɾ l e AC ɾ d e AC n
zaferlere	z ɑ AH f e AC ɾ l ɛ AC ɾ ɛ AC
zaferleri	z ɑ AH f e AC ɾ l ɛ AC ɾ i AC
zaferlerin	z ɑ AH f e AC ɾ l ɛ AC ɾ i AC n
zahmet	z ɑ AH h AA m ɛ AC t
zaman	z ɑ AH m ɑː AJ n
zangoç	z ɑ AH ŋ ɡ o AE t ʃ
zarf	z a AC ɾ f
zavallı	z ɑ AH v ɑ AH ɫ ɫ ɯ AH
zavar	z ɑ AH v ɑ AH ɾ
zebra	z e AC b ɾ ɑ AH
zehra	z ɛ AC h AA ɾ ɑː AJ
zeval	z e AC v ɑ AH ɫ
zibidi	z i AC b i AC d i AC
zibidide	z i AC b i AC d i AC d e AC
zibididen	z i AC b i AC d i AC d e AC n
zibidiler	z i AC b i AC d i AC ɫ e AC ɾ
zibidilerde	z i AC b i AC d i AC ɫ e AC ɾ d e AC
zibidilerden	z i AC b i AC d i AC ɫ e AC ɾ d e AC n
zibidilere	z i AC b i AC d i AC ɫ e AC ɾ e AC
zibidileri	z i AC b i AC d i AC ɫ e AC ɾ i AC
zibidilerim	z i AC b i AC d i AC ɫ e AC ɾ i AC m
zibidilerin	z i AC b i AC d i AC ɫ e AC ɾ i AC n
zibidim	z i AC b i AC d i AC m
zibidin	z i AC b i AC d i AC n
zibidinin	z i AC b i AC d i AC n i AC n
zibidisi	z i AC b i AC d i AC s i AC
zibidiye	z i AC b i AC d i AC j AB e AC
zibidiyi	z i AC b i AC d i AC y AG i AC
zibil	z i AC b i AC l
ziggurat	z i AC ɡ ɡ u AE ɾ ɑ AH t
zinhar	z i AC n h AA ɑ AH ɾ
ziyaret	z i AC j AB ɑː AJ ɾ ɛ AC t
ziyaretçi	z i AC j AB ɑː AJ ɾ ɛ AC t t ʃ i AC
zorluk	z o AE ɾ ɫ u AE k
zulüm	z u AE l y AG m
zurna	z u AE ɾ n ɑ AH
âlem	aː AD l ɛ AC m
âlemi	aː AD l ɛ AC m i AC
âlemler	aː AD l ɛ AC m l ɛ AC ɾ
âmâ	aː AD m aː AD
âmâdır	aː AD m aː AD d ɯ AH ɾ
âmâlar	aː AD m aː AD ɫ a AC ɾ
âmâsın	aː AD m aː AD s ɯ AH n
âmâyı	aː AD m aː AD j AB ɯ AH
âmâyım	aː AD m aː AD j AB ɯ AH m
âşık	ɑː AJ ʃ ɯ AH k
çabucak	t ʃ ɑ AH b u AE d ʒ ɑ AH k
çakal	t ʃ ɑ AH k ɑ AH ɫ
çakma	t ʃ ɑ AH k m ɑ AH
çalgı	t ʃ ɑ AH ɫ ɡ ɯ AH
çalgıcı	t ʃ ɑ AH ɫ ɡ ɯ AH d ʒ ɯ AH
çalgıç	t ʃ ɑ AH ɫ ɡ ɯ AH t ʃ
çalışma	t ʃ a AC ɫ ɯ AH ʃ m a AC
çalışmak	t ʃ ɑ AH ɫ ɯ AH ʃ m ɑ AH k
çalışmamak	t ʃ ɑ AH ɫ ɯ AH ʃ m ɑ AH m ɑ AH k
çan	t ʃ a AC n
çap	t ʃ ɑ AH p
çapa	t ʃ ɑ AH p ɑ AH
çarşaf	t ʃ a AC ɾ ʃ a AC f
çatlak	t ʃ ɑ AH t ɫ ɑ AH k
çavuş	t ʃ ɑ AH v ʊ AE ʃ
çaydanlık	t ʃ a AC j AB d a AC n ɫ ɯ AH k
çağ	t ʃ ɑː AJ
çağdaş	t ʃ ɑː AJ d ɑ AH ʃ
çeker	t ʃ ɛ AC c ɛ AC ɾ
çekmece	t ʃ ɛ AC c m ɛ AC d ʒ ɛ AC
çekmek	t ʃ ɛ AC c m ɛ AC c
çekmez	t ʃ ɛ AC c m ɛ AC z
çelenk	t ʃ ɛ AC l ɛ AC ŋ k
çember	t ʃ e AC m b e AC ɾ
çernobil	t ʃ e AC ɾ n ɔ AE b i AC l
çevre	t ʃ e AC v ɾ ɛ AC
çeşni	t ʃ ɛ AC ʃ n i AC
çift	t ʃ i AC f t
çiftlik	t ʃ i AC f t l i AC c
çikolata	t ʃ i AC k o AE ɫ a AC t a AC
çilek	t ʃ i AC l ɛ AC k
çirkinlik	t ʃ i AC ɾ k i AC n l i AC c
çizgi	t ʃ i AC z ɟ i AC
çizmeci	t ʃ i AC z m ɛ AC d ʒ i AC
çiçe	t ʃ i AC t ʃ ɛ AC
çiçek	t ʃ ɪ AC t ʃ ɛ AC c
çocuk	t ʃ o̞ AE d ʒ u AE k
çocuklardan	t ʃ o AE d ʒ u AE k l a AC ɾ d a AC n
çocukluk	t ʃ o AE d ʒ u AE k ɫ u AE k
çok	t ʃ ɔ AE k
çokgen	t ʃ o AE k ɟ e AC n
çorap	t ʃ ɔ AE ɾ ɑ AH p
çubuk	t ʃ u AE b u AE k
çubuklu	t ʃ u AE b u AE k ɫ u AE
çubuksuz	t ʃ u AE b u AE k s u AE z
çökelti	t ʃ ø AG k e AC ɫ t i AC
çökermek	t ʃ ø AG k e AC ɾ m e AC c
çökerti	t ʃ ø AG k e AC ɾ t i AC
çökertici	t ʃ ø AG k e AC ɾ t i AC j AB i AC
çökertmek	t ʃ ø AG k e AC ɾ t m e AC c
çökertmemek	t ʃ ø AG k e AC ɾ t m e AC m e AC c
çöp	t ʃ ø AG p
çürümek	t ʃ y AG r y AG m e AC c
çürümemek	t ʃ y AG r y AG m e AC m e AC c
çılgın	t ʃ ɯ AH ɫ ɟ ɯ AH n
çılgınlık	t ʃ ɯ AH ɫ ɟ ɯ AH n ɫ ɯ AH k
çıpa	t ʃ ɯ AH p ɑ AH
çıplak	t ʃ ɯ AH p ɫ ɑ AH k
çıplaklık	t ʃ ɯ AH p ɫ ɑ AH k ɫ ɯ AH k
ödev	ø AG d e AC v
öglena	ø AG ɟ l e AC n ɑ AH
öküz	ø AG c y AG z
öldürtmek	ø AG ɫ d y AG ɾ t m e AC k
öldürtülmek	ø AG ɫ d y AG ɾ t y AG ɫ m e AC k
öldürülmek	ø AG ɫ d y AG ɾ y AG ɫ m e AC k
ölmek	œ AG l m ɛ AC c
ölü	ø AG l y AG
ölümlü	ø AG ɫ y AG m l y AG
ölümlülük	œ AG ɫ y AG m ɫ y AG ɫ y AG c
ölümsüz	ø AG ɫ y AG m s y AG z
ölümsüzlük	œ AG ɫ y AG m s y AG z ɫ y AG c
ölünmek	ø AG ɫ y AG n m e AC k
önce	ø AG n d ʒ ɛ AC
öncelik	ø AG n d ʒ ɛ AC l i AC c
önyargı	œ AG n j AB a AC r ɡ ɯ AH
öpmek	ø AG p m e AC c
örnek	ø AG ɾ n e AC c
örümcek	œ AG ɾ y AG m d ʒ ɛ AC c
öteki	œ AG t ɛ AC c i AC
öz	ø AG z
özer	œ AG z æ AC ɾ
özgemek	ø AG z ɡ ɛ AC m ɛ AC c
özgü	ø AG z ɟ y AG
özlemek	ø AG z l ɛ AC m ɛ AC c
özür	ø AG z y AG ɾ
öğretmeni	ø AG ɰ AI ɾ e AC t m e AC n i AC
öğretmenim	ø AG ɰ AI ɾ e AC t m e AC n i AC m
öğretmenin	ø AG ɰ AI ɾ e AC t m e AC n i AC n
öğütücü	œ AG ɰ AI y AG t y AG d ʒ y AG
ücretlilik	y AG d ʒ ɾ e AC t l i AC l i AC k
ücretsizlik	y AG d ʒ ɾ e AC t s i AC z l i AC k
ünlü	y AG n l y AG
ünsüz	y AG n s y AG z
üretmek	y AG ɾ ɛ AC t m ɛ AC c
ürün	y AG ɾ y AG n
üstünde	y AG s t y AG n d e AC
üstüne	y AG s t y AG n e AC
ütü	y AG t y AG
üyelik	y AG j AB ɛ AC l i AC c
üzerinde	y AG z ɛ AC ɾ i AC n d e AC
üzerine	y AG z ɛ AC ɾ i AC n e AC
üçgen	y AG t ʃ ɟ e AC n
üçlü	y AG t ʃ l y AG
üçüncül	y AG t ʃ y AG n d ʒ y AG ɫ
ğ	ɰ AI
ıslaklık	ɯ AH s ɫ a AC k l ɯ AH k
ışık	ɯ AH ʃ ɯ AH k
şaban	ʃ aː AD b a AC n
şafak	ʃ ɑ AH f ɑ AH k
şahmeran	ʃ ɑ AH h AA m e AC ɾ ɑ AH n
şahmerdan	ʃ ɑ AH h AA m e AC ɾ d ɑ AH n
şair	ʃ aː AD i AC ɾ
şakşakçı	ʃ ɑ AH k ʃ ɑ AH k t ʃ ɯ AH
şamandıra	ʃ ɑ AH m ɑ AH n d ɯ AH ɾ ɑ AH
şamdan	ʃ ɑ AH m d ɑ AH n
şamisen	ʃ ɑ AH m ɪ AC s e AC n
şampiyon	ʃ ɑ AH m p i AC j AB ɔ AE n
şampiyonluk	ʃ ɑ AH m p i AC j AB ɔ AE n ɫ u AE k
şapkacı	ʃ ɑ AH p k ɑ AH d ʒ ɯ AH
şarap	ʃ ɑ AH ɾ ɑ AH p
şarapçı	ʃ ɑ AH ɾ ɑ AH p t ʃ ɯ AH
şarkıcılık	ʃ a AC ɾ k ɯ AH d ʒ ɯ AH ɫ ɯ AH k
şato	ʃ a AC t o AE
şebnem	ʃ ɛ AC b n æ AC m
şeker	ʃ ɛ AC c ɛ AC ɾ
şekil	ʃ ɛ AC c i AC l
şelale	ʃ ɛ AC l ɑː AJ l ɛ AC
şemsiye	ʃ ɛ AC m s i AC j AB ɛ AC
şen	ʃ e AC n
şerbet	ʃ e AC ɾ b ɛ AC t
şerbetli	ʃ e AC ɾ b ɛ AC t l i AC
şerbetsiz	ʃ e AC ɾ b ɛ AC t s i AC z
şerbetçi	ʃ e AC ɾ b ɛ AC t t ʃ i AC
şerbetçilik	ʃ e AC ɾ b ɛ AC t t ʃ i AC l i AC c
şey	ʃ ɛ AC j AB
şifonyer	ʃ i AC f ɔ AE n j AB e AC ɾ
şiir	ʃ i AC i AC ɾ
şive	ʃ iː AD β ɛ AC
şizofreni	ʃ i AC z o AE f ɾ ɛ AC n i AC
şiş	ʃ i AC ʃ
şişlik	ʃ i AC ʃ l i AC c
şişman	ʃ i AC ʃ m a AC n
şok	ʃ o AE k
şort	ʃ ɔ AE ɾ t
şov	ʃ o AE v
şuur	ʃ u AE u AE ɾ
şuurlar	ʃ u AE u AE ɾ ɫ a AC ɾ
şuuru	ʃ u AE u AE ɾ u AE
şövalye	ʃ œ AG β a AC l j AB e AC
şırınga	ʃ ɯ AH ɾ ɯ AH ŋ ɡ ɑ AH
