aba	ɑː AE b ɑː AE
abacı	a AD b a AD d ʒ ɯ AD
abacılar	a AD b a AD d ʒ ɯ AD l a AD ɾ
abacılık	a AD b a AD d ʒ ɯ AD ɫ ɯ AD k
abajur	a AD b a AD ʒ u AF ɾ
abajurcu	a AD b a AD ʒ u AF ɾ d ʒ u AF
abajurcular	a AD b a AD ʒ u AF ɾ d ʒ u AF l a AD ɾ
abajurculuk	a AD b a AD ʒ u AF ɾ d ʒ u AF ɫ u AF k
abaküs	ɑ AD b ɑ AD c y AF s
abalı	a AD b a AD ɫ ɯ AD
abanoz	ɑ AD b ɑ AD n o AF ʐ
abartı	a AD b a AD r t ɯ AD
abartılı	a AD b a AD ɾ t ɯ AD l ɯ AD
abece	ɑː AE b eː AE d ʒ eː AE
abide	aː AE b i AD d e AD
acaba	a AD d ʒ a AD b aː AE
ad	ɑ AD t̪
adal	a AD d a AD ɫ
adalar	a AD d a AD l a AD ɾ
adam	ɑ AD d ɑ AD m
adamı	a AD d a AD m ɯ AD
aday	ɑ AD d ɑ AD j AB
adaylar	a AD d a AD j AB l a AD ɾ
adayı	a AD d a AD j AB ɯ AD
adi	aː AE d iː AE
adı	a AD d̪ ɯ AD
adım	ɑ AD d ɯ AD m
ahbap	ɑ AD h AA b ɑ AD p
ahlat	a AD h AA ɫ a AD t
ahtapotlar	ɑ AD h AA t ɑ AD p o AF t l a AD ɾ
ahududu	aː AE h AA u AF d u AF d u AF
ahududular	aː AE h AA u AF d u AF d u AF l a AD ɾ
aile	ɑ AD i AD l e AD
ajanda	ɑ AD ʒ ɑ AD n d ɑ AD
ak	ɑ AD k
akciğer	a AD k d ʒ iː AE e AD ɾ
akrabalar	a AD k ɾ a AD b aː AE l a AD ɾ
akrabayla	a AD k ɾ a AD b aː AE j AB l a AD
akrabayı	a AD k ɾ a AD b aː AE j AB ɯ AD
aksamak	ɑ AD k s ɑ AD m ɑ AD k
aksan	a AD k s a AD n
aksanlar	a AD k s a AD n l a AD ɾ
aktris	ɑ AD k t ɾ i AD s
aktör	ɑ AD k t œ AF ɾ
akvaryum	ɑ AD k v ɑ AD ɾ j AB u AF m
akıl	ɑ AD k ɯ AD ɫ
akın	a AD k ɯ AD n
akışkan	a AD k ɯ AD ʃ k a AD n
akışkanlar	a AD k ɯ AD ʃ k a AD n l a AD ɾ
akşamlar	a AD k ʃ a AD m l a AD ɾ
ala	ɑ AD ɫ ɑ AD
alabalık	ɑ AD ɫ ɑ AD b ɑ AD ɫ ɯ AD k
alacakaranlık	ɑ AD ɫ ɑ AD d ʒ ɑ AD k ɑ AD ɾ ɑ AD n ɫ ɯ AD k
alan	ɑ AD ɫ ɑ AD n
alaşım	ɑ AD ɫ ɑ AD ʃ ɯ AD m
albatros	a AD ɫ b a AD t r o AF s
albüm	ɑ AD l b y AF m
alet	ɑː AE l e AD t
alfabe	ɑ AD l f ɑ AD b e AD
alkol	a AD l k o AF l
alkış	a AD ɫ k ɯ AD ʃ
allah	aː AE ɫ aː AE h AA
alo	a AD l o AF
altı	ɑ AD l t ɯ̞ AD
altışar	a AD ɫ t ɯ AD ʃ a AD r
alüminyumlar	a AD l y AF m i AD n j AB u AF m l a AD ɾ
alın	ɑ AD ɫ ɯ AD n
amca	a AD m d ʒ a AD
amcalar	a AD m d ʒ a AD l a AD ɾ
amerika	a AD m e AD ɾ i AD k a AD
anahtarlar	a AD n a AD h AA t a AD ɾ ɫ a AD ɾ
anahtarları	a AD n a AD h AA t a AD ɾ ɫ a AD ɾ ɯ AD
anahtarların	a AD n a AD h AA t a AD ɾ ɫ a AD ɾ ɯ AD n
anahtarı	a AD n a AD h AA t a AD ɾ ɯ AD
anahtarım	a AD n a AD h AA t a AD ɾ ɯ AD m
anahtarın	a AD n a AD h AA t a AD ɾ ɯ AD n
analiz	a AD n a AD l i AD z
analizi	a AD n a AD l i AD z i AD
analizler	a AD n a AD l i AD z l e AD ɾ
andı	a AD n d ɯ AD
angolalı	a AD ŋ ɡ o AF ɫ a AD ɫ ɯ AD
anlam	ɑ AD n ɫ ɑ AD m
anmak	a AD n m a AD c
anmamak	a AD n m a AD m a AD c
ansiklopedi	a AD n s i AD k l ɔ AF p e AD d i AD
ant	a AD n t
antioksidan	a AD n t i AD o AF k s i AD d a AD n
antlar	a AD n t l a AD ɾ
antropomorfizm	a AD n t ɾ o AF p o AF m o AF ɾ f i AD z m
antropomorfizmi	a AD n t ɾ o AF p o AF m o AF ɾ f i AD z m i AD
antropomorfizmler	a AD n t ɾ o AF p o AF m o AF ɾ f i AD z m l e AD ɾ
apartman	a AD p a AD r t m a AD n
araba	a AD ɾ a AD b a AD
arabalar	a AD ɾ a AD b a AD l a AD ɾ
arabalı	a AD ɾ a AD b a AD l ɯ AD
arabasız	a AD ɾ a AD b a AD s ɯ AD z
arabayla	a AD ɾ a AD b a AD j AB l a AD
arabaysa	a AD ɾ a AD b a AD j AB s a AD
arabayı	a AD ɾ a AD b a AD j AB ɯ AD
araknofobi	a AD ɾ a AD k n o AF f o AF b i AD
arapça	a AD ɾ a AD p t ʃ a AD
arayüzler	a AD ɾ a AD j AB y AF z ɫ e AD ɾ
arayüzü	a AD ɾ a AD j AB y AF z y AF
araç	ɑ AD ɾ ɑ AD t ʃ
arda	ʌ AD ɾ d ʌ AD
arife	a AD ɾ i AD f e AD
arka	ɑ AD ɾ k ɑ AD
arkadaşları	a AD ɾ k a AD d a AD ʃ l a AD ɾ ɯ AD
arkeoloji	a AD r k e AD o AF l o AF ʒ i AD
armut	a AD r m u AF t
arnavutça	a AD ɾ n a AD v u AF t t ʃ a AD
arpa	ɑ AD ɾ p ɑ AD
arsa	ɑ AD ɾ s ɑ AD
arzu	a AD ɾ z u AF
arzuhal	ɑ AD ɾ z u AF h AA ɑ AD ɫ
arı	ɑ AD ɾ ɯ AD
arıcı	ɑ AD ɾ ɯ AD d ʒ ɯ AD
arıcılık	ɑ AD ɾ ɯ AD d ʒ ɯ AD ɫ ɯ AD k
asansör	ɑ AD s ɑ AD n s œ AF ɾ
asgari	a AD s ɡ a AD ɾ i AD
asistan	ɑ AD s i AD s t ɑ AD n
asker	ɑ AD s k e AD ɾ
asla	a AD s l a AD
aslan	ɑ̟ s ɫ ɑ̟ n
aslında	a AD s l ɯ AD n d a AD
asteroide	a AD s t e AD ɾ o AF i AD d e AD
asteroidi	a AD s t e AD ɾ o AF i AD d i AD
asteroidin	a AD s t e AD ɾ o AF i AD d i AD n
asteroit	a AD s t e AD ɾ o AF i AD t
asteroitle	a AD s t e AD ɾ o AF i AD t l e AD
asteroitler	a AD s t e AD ɾ o AF i AD t l e AD ɾ
asteroitse	a AD s t e AD ɾ o AF i AD t s e AD
asteroitte	a AD s t e AD ɾ o AF i AD t t e AD
asteroitten	a AD s t e AD ɾ o AF i AD t t e AD n
astronomi	ɑ AD s t ɾ o AF n o AF m i AD
astronot	ɑ AD s t ɾ o AF n o AF t
astım	ɑ AD s t ɯ AD m
asır	ɑ AD s ɯ AD ɾ
at	ä t̪
ata	a AD t a AD
atalar	a AD t a AD l a AD ɾ
atasözleri	a AD t a AD s ø AF z l e AD ɾ i AD
atasözü	a AD t a AD s ø AF z y AF
atasözünü	a AD t a AD s ø AF z y AF n y AF
atatürk	a AD t a AD t y AF ɾ k
atayı	a AD t a AD j AB ɯ AD
atinalı	a AD t i AD n a AD ɫ ɯ AD
atmaca	ɑ AD t m ɑ AD d ʒ ɑ AD
av	a AD β
avantaj	a AD v a AD n t a AD ʒ
avantajlar	a AD v a AD n t a AD ʒ l a AD ɾ
avantajı	a AD v a AD n t a AD ʒ ɯ AD
avcı	a AD v d ʒ ɯ AD
avustralyalı	a AD v u AF s t ɾ a AD l j AB a AD ɫ ɯ AD
ay	a AD j AB
ayakkabı	ɑ AD j AB ɑ AD k k ɑ AD b ɯ AD
aydan	a AD j AB d a AD n
ayna	a AD j AB n a AD
aynasız	a AD j AB n a AD s ɯ AD z
aynştaynyum	a AD j AB n ʃ t a AD j AB n j AB u AF m
ayran	a AD j AB ɾ a AD n
azerbaycan	aː AE z ɛ AD ɾ b a AD j AB d ʒ a AD n
azerbaycanlar	aː AE z ə AD ɾ b a AD j AB d ʒ a AD n l a AD ɾ
azerice	aː AE z e AD ɾ i AD d ʒ e AD
azir	a AD z i AD ɾ̥
açı	a AD t ʃ ɯ AD
açık	ɑ AD t ʃ ɯ AD k
ağa	ɑ AD ɰ AB ɑ AD
ağaç	äː t ʃ
ağır	ɑ AD ɑ AD ɾ̝̊
ağız	a AD ɰ AB ɯ AD z
aşk	a̟ AD ʃ k
aşure	a AD ʃ uː AG ɾ ɛ AD
b	b eː AE
baba	b ɑ AD b ɑ AD
babacan	b ɑ AD b ɑ AD d ʒ ɑ AD n
babil	b aː AE b i AD l
baca	b a AD d ʒ a AD
bacak	b a AD d ʒ a AD k
badem	b ɑː AE d ɛ AD m
bahar	b ɑ AD h AA ɑː AE ɾ
bakan	b ɑ AD k ɑ AD n
bakla	b a AD k l a AD
baklahorani	b a AD k ɫ a AD x o AF r a AD n i AD
baklava	b a AD k l a AD ʋ AC a AD
bal	b ɑ AD ɫ
balak	b ɑ AD ɫ ɑ AD k
baldır	b ɑ AD ɫ d ɯ AD ɾ
baldıran	b ɑ AD ɫ d ɯ AD ɾ ɑ AD n
baldırıkara	b ɑ AD ɫ d ɯ AD r ɯ AD k a AD r a AD
balina	b ɑ AD ɫ i AD n ɑ AD
balkmak	b ɑ AD ɫ k m ɑ AD k
balta	b ɑ AD l t ɑ AD
balyoz	b ɑ AD ɫ j AB o AF z
bankacılık	b a AD n k a AD d ʒ ɯ AD l ɯ AD k
barış	b a AD ɾ ɯ AD ʃ
bas	b a AD s
basketbolcu	b ʌ AD s k ɛ AD t b o AF ɫ d ʒ u AF
basma	b a AD s m a AD
basmak	b ɑ AD s m ɑ AD k
basmalar	b a AD s m a AD l a AD ɾ
basmamak	b ɑ AD s m ɑ AD m ɑ AD k
basmayı	b a AD s m a AD j AB ɯ AD
basmayın	b a AD s m a AD j AB ɯ AD n
bası	b a AD s ɯ AD
basılar	b a AD s ɯ AD l a AD ɾ
basın	b a AD s ɯ AD n
basınlar	b a AD s ɯ AD n l a AD ɾ
basını	b a AD s ɯ AD n ɯ AD
basıyı	b a AD s ɯ AD j AB ɯ AD
batmak	b ɑ AD t m ɑ AD k
batman	b ɑ AD t m ɑ AD n
bay	b a AD j AB
bayak	b ɑ AD j AB ɑ AD k
baykuş	b ɑ AD j AB k u AF ʃ
bayrak	b ɑ AD j AB ɾ ɑ AD k
bayraklar	b ɑ AD j AB ɾ ɑ AD k l ɑ AD ɾ
bayram	b a AD j AB ɾ a AD m
bayılmak	b ɑ AD j AB ɯ AD ɫ m ɑ AD k
bazalt	b a AD z a AD l t
bazaltlar	b a AD z a AD l t l a AD ɾ
bazaltı	b a AD z a AD l t ɯ AD
bazen	b aː AE z e AD n
bağımlılık	b ɑ AD ɯ AD m l ɯ AD l ɯ AD c
bağımlılıklar	b ɑ AD ɯ AD m l ɯ AD l ɯ AD c l a AD ɾ
bağımlılığı	b ɑ AD ɯ AD m l ɯ AD l ɯ AD ɯ AD
başa	b a AD ʃ a AD
başarmak	b a AD ʃ a AD ɾ m a AD k
başarılı	b ɑ AD ʃ ɑ AD ɾ ɯ AD ɫ ɯ AD
başka	b ɑ AD ʃ k ɑ AD
başla	b a AD ʃ l a AD
başlık	b ɑ AD ʃ ɫ ɯ AD k
başsa	b a AD ʃ s a AD
başvurular	b a AD ʃ v u AF ɾ u AF l a AD ɾ
başvurusu	b a AD ʃ v u AF ɾ u AF s u AF
başvuruya	b a AD ʃ v u AF ɾ u AF j AB a AD
başvuruyu	b a AD ʃ v u AF ɾ u AF j AB u AF
başını	b a AD ʃ ɯ AD n ɯ AD
beden	b e AD d æ AD n
bej	b e AD ʒ
bel	b ɛ AD l
belge	b e AD l ɟ ɛ AD
belirli	b e AD l i AD ɾ l i AD
belirsiz	b e AD l i AD ɾ s i AD z
belki	b ɛ AD l c ɪ AD
ben	b ɛ AD n
bencil	b e AD n d ʒ i AD l
beni	b e AD n i AD
benim	b e AD n i AD m
beniz	b e AD n i AD z
berkay	b e AD ɾ k a AD j AB
berker	b e AD ɾ k e AD ɾ
beslemek	b e AD s l e AD m e AD c
beslememek	b e AD s l e AD m e AD c
beslemez	b e AD s l e AD m e AD z
besler	b e AD s l e AD ɾ
betik	b ɛ AD t i AD c
betikle	b ɛ AD t i AD c l e AD
betikler	b ɛ AD t i AD c l e AD ɾ
betiği	b ɛ AD t i AD j AB i AD
beyaz	b e AD j AB ɑ AD z
bez	b e AD z
bezi	b e AD z i AD
bezler	b e AD z l e AD ɾ
beş	b e AD ʃ
beşer	b e AD ʃ æ AD r
bilet	b i AD l ɛ AD t
bilge	b i AD l ɟ e AD
bilgin	b i AD l ɟ i AD n
bilgisayarla	b i AD l ɡ i AD s a AD j AB a AD ɾ l a AD
bilgisayarlı	b i AD l ɡ i AD s a AD j AB a AD ɾ l ɯ AD
bilgisayarsa	b i AD l ɡ i AD s a AD j AB a AD ɾ s a AD
bilgisayarsız	b i AD l ɡ i AD s a AD j AB a AD ɾ s ɯ AD z
bin	b i AD n
bina	b i AD n ɑː AE
binyıl	b i AD n j AB ɯ AD l
bir	b i AD ɾ̝̊
birer	b i AD r æ AD r
birinci	b i AD ɾ i AD n d ʒ i AD
birçok	b i AD ɾ t ʃ o AF k
bisküvi	b i AD s k y AF v i AD
bit	b i AD t
biz	b ɪ AD z
bizim	b ɪ AD z i AD m
bişkek	b i AD ʃ c ɛ AD c
bluz	b l u AF z
bluza	b l u AF z a AD
bluzla	b l u AF z l a AD
bluzlar	b l u AF z l a AD ɾ
bluzlu	b l u AF z l u AF
bluzlular	b l u AF z l u AF l a AD ɾ
bluzluyu	b l u AF z l u AF j AB u AF
bluzsa	b l u AF z s a AD
bluzsuz	b l u AF z s u AF z
bluzsuzlar	b l u AF z s u AF z l a AD ɾ
bluzsuzu	b l u AF z s u AF z u AF
bluzu	b l u AF z u AF
bok	b o AF k
boklar	b ɔ AF k l ɑ AD ɾ
boksör	b o AF k s œ AF r
boz	b o AF z
bozok	b o AF z o AF k
boğaz	b o AF a AD z
boğazlar	b o AF a AD z l a AD ɾ
boğazı	b o AF a AD z ɯ AD
bu	b u AF
bugün	b u AF ɟ y AF n
bulgarca	b u AF ɫ ɟ ʌ AD ɾ d ʒ ʌ AD
bulgur	b u AF ɫ ɡ u AF ɾ
burak	b u AF ɾ a AD k
bursa	b u AF r s a AD
burç	b u AF r t ʃ
buz	b u AF z
buzla	b u AF z l a AD
buzlar	b u AF z l a AD ɾ
buzsa	b u AF z s a AD
buzsuz	b u AF z s u AF z
buzu	b u AF z u AF
buçuk	b u AF t ʃ u AF k
buğra	b u AF ɣ ɾ ʌː AE
böbrek	b œ AF b ɾ e AD k
böcek	b ø AF d ʒ ɛ AD c
bölüm	b ø AF l y AF m
böyle	b œ AF j AB l ɛ AD
böğür	b ø AF ø AF ɾ̝̊
böğürtlen	b œ AF ɣ y AF ɾ t l e AD n
bükülmem	b y AF k y AF l m e AD m
bütçe	b y AF t ʃ e AD
bütün	b y AF t y AF n
bıçak	b ɯ AD t ʃ ɑ AD k
c	d ʒ ɛː AE
cacık	d ʒ ɑ AD d ʒ ɯ AD c
cadı	d ʒ a AD d ɯ AD
cam	d ʒ a AD m
can	d ʒ a AD n
canberk	d ʒ a AD n b e AD ɾ k
cep	d ʒ e AD p
cerahatlen	d ʒ e AD ɾ a AD h AA a AD t l e AD n
cerahatlenir	d ʒ e AD ɾ a AD h AA a AD t l e AD n i AD r
cerahatlenme	d ʒ e AD ɾ a AD h AA a AD t l e AD n m e AD
cerahatlenmek	d ʒ e AD ɾ a AD h AA a AD t l e AD n m e AD c
cerahatlenmeler	d ʒ e AD ɾ a AD h AA a AD t l e AD n m e AD l e AD ɾ
cerahatlenmeme	d ʒ e AD ɾ a AD h AA a AD t l e AD n m e AD m e AD
cerahatlenmemek	d ʒ e AD ɾ a AD h AA a AD t l e AD n m e AD m e AD c
cerahatlenmemeler	d ʒ e AD ɾ a AD h AA a AD t l e AD n m e AD m e AD l e AD ɾ
cerahatlenmemeyi	d ʒ e AD ɾ a AD h AA a AD t l e AD n m e AD m e AD j AB i AD
cerahatlenmeyi	d ʒ e AD ɾ a AD h AA a AD t l e AD n m e AD j AB i AD
cerahatlenmez	d ʒ e AD ɾ a AD h AA a AD t l e AD n m e AD z
cibinlik	d ʒ i AD b i AD n l i AD c
cihadı	d ʒ i AD h AA a AD d ɯ AD
cihan	d ʒ i AD h AA a AD n
cihat	d ʒ i AD h AA a AD t
cihatlar	d ʒ i AD h AA a AD t l a AD ɾ
cins	d ʒ i AD n s
cinsel	d ʒ ɪ AD n s ɛ AD l
civara	c i AD v a AD ɾ a AD
civarda	c i AD v a AD ɾ d a AD
civardan	c i AD v a AD ɾ d a AD n
civarlara	c i AD v a AD ɾ l a AD ɾ a AD
civarlarda	c i AD v a AD l a AD ɾ d a AD
civarlardan	c i AD v a AD l a AD ɾ d a AD n
civarları	c i AD v a AD l a AD ɾ ɯ AD
civarların	c i AD v a AD l a AD ɾ ɯ AD n
civarı	c i AD v a AD ɾ ɯ AD
civarın	c i AD v a AD ɾ ɯ AD n
ciğer	d ʒ i AD j AB æ AD ɾ
concon	d ʒ o AF n d ʒ o AF n
conconlar	d ʒ o AF n d ʒ o AF n l a AD ɾ
conconu	d ʒ o AF n d ʒ o AF n u AF
cuma	d ʒ ʊ AF m ɑː AE
cumartesi	d ʒ ʊ AF m ɑ AD ɾ t ɛ AD s ɪ AD
cumhurbaşkanı	d ʒ u AF m h AA u AF ɾ b a AD ʃ k a AD n ɯ AD
cumhuriyet	d ʒ u AF m h AA uː AG ɾ i AD j AB e AD t
cüneyt	d ʒ y AF n ɛ AD j AB t
cık	t ɪ AD s k
daha	d a AD h AA a AD
daire	d a AD i AD ɾ e AD
daireler	d a AD i AD ɾ e AD l e AD ɾ
daireyi	d a AD i AD ɾ e AD j AB i AD
daktilo	d a AD k t i AD l ɔ AF
daktilolar	d a AD k t ɨ AD l ɔ AF l a AD ɾ
daktiloyla	d a AD k t ɨ AD l o AF j AB l a AD
daktiloysa	d a AD k t ɨ AD l o AF j AB s a AD
daktiloyu	d a AD k t ɨ AD l ɔ AF j AB u AF
dal	d a AD ɫ
dalga	d a AD l ɡ a AD
dalgalar	d a AD l ɡ a AD l a AD ɾ
dalgayı	d a AD l ɡ a AD j AB ɯ AD
dam	d ɑ AD m
damacana	d a AD m a AD d ʒ a AD n a AD
damlacık	d a AD m ɫ a AD d ʒ ɯ AD k
dansçı	d a AD n s t ʃ ɯ AD
danışmak	d ɑ AD n ɯ AD ʃ m ɑ AD k
darbe	d a AD ɾ b e AD
darmadağınık	d a AD r m a AD d a AD ɯ AD n ɯ AD k
darp	d a AD ɾ p
dağ	d a AD ɰ AB
dağcı	d ɑː AE d ʒ ɯ AD
dağcılık	d ɑː AE d ʒ ɯ AD ɫ ɯ AD k
dağlık	d ɑː AE ɫ ɯ AD k
dağınık	d a AD ɯ AD n ɯ AD k
define	d e AD f iː AE n e AD
deist	d e AD i AD s t
deisti	d e AD i AD s t i AD
deistin	d e AD i AD s t i AD n
deistler	d e AD i AD s t l e AD ɾ
deli	d ɛ AD l i AD
demirci	d ɛ AD m i AD ɾ d ʒ i AD
deneyim	d ɛ AD n ɛ AD j AB i AD m
denge	d e AD n ɡ e AD
dengeler	d e AD n ɡ e AD l e AD ɾ
dengeyi	d e AD n ɡ e AD j AB i AD
denizaltı	d ɛ AD n i AD z a AD ɫ t ɯ AD
ders	d e AD ɾ s
değer	d e AD j AB e AD ɾ
değeri	d e AD e AD ɾ i AD
değerler	d e AD e AD r ɫ e AD ɾ
değil	d e AD j AB i AD l
değmezler	d e AD m e AD z ɫ e AD ɾ
dil	d i AD l
dilde	d i AD l d e AD
dilden	d i AD l d e AD n
dile	d i AD l e AD
dili	d i AD l i AD
dilin	d i AD l i AD n
diller	d i AD l l e AD ɾ
dillerde	d i AD l l e AD ɾ d e AD
dillerden	d i AD l l e AD ɾ d e AD n
dillere	d i AD l l e AD ɾ e AD
dilleri	d i AD l l e AD ɾ i AD
dillerin	d i AD l l e AD ɾ i AD n
dilli	d i AD l l i AD
dilsiz	d i AD l s i AD z
dilsizi	d i AD l s i AD z i AD
dilsizler	d i AD l s i AD z l e AD ɾ
dilsizlik	d i AD l s i AD z l i AD c
dilsizlikler	d i AD l s i AD z l i AD c l e AD ɾ
dilsizliği	d i AD l s i AD z l i AD j AB i AD
dinlenmek	d i AD n l e AD n m e AD c
diyabet	d i AD j AB a AD b e AD t
diyalog	d i AD j AB ɑ AD l o AF ɡ
dizeler	d i AD z e AD ɫ e AD ɾ
dizem	d i AD z e AD m
dizen	d i AD z e AD n
dizesi	d i AD z e AD s i AD
dizeyi	d i AD z e AD j AB i AD
diğer	d i AD j AB e AD ɾ
dişi	d i AD ʃ i AD
dişlek	d i AD ʃ ɫ e AD c
dişleklik	d i AD ʃ ɫ e AD k ɫ i AD c
dişçi	d i AD ʃ t ʃ i AD
dok	d o AF k
dokuz	d o AF k u AF z
dokuzar	d o AF k u AF z a AD r
dolap	d o AF ɫ a AD p
donanım	d o AF n a AD n ɯ AD m
donanımlar	d o AF n a AD ɯ AD m l a AD ɾ
donanımları	d o AF n a AD n ɯ AD m l a AD ɾ ɯ AD
donanımı	d o AF n a AD n ɯ AD m ɯ AD
dondurma	d o AF n d u AF ɾ m a AD
doğmak	d o AF ɣ m a AD k
doğru	d o AF ɰ AB ɾ u AF
doğurmak	d o AF ɰ AB u AF ɾ m ɑ AD k
doğuş	d o AF u AF ʃ
durak	d u AF ɾ ɑ AD k
dut	d u AF t
duygu	d u AF j AB ɡ u AF
dyugudyugu	dʲ u AF ɡ u AF dʲ u AF ɡ u AF
dörder	d ø AF r d æ AD r
dört	d œ AF ɾ t
dükkân	d y AF c c a AD n
dümen	d y AF m e AD n
dünyevî	d y AF n j AB e AD v iː AE
dürüst	d y AF ɾ y AF s t
düğüm	d y AF j AB y AF m
düğün	d y AF ɰ AB y AF n
düş	d ʏ AF ʃ
düşünce	d y AF ʃ y AF n d ʒ e AD
dışarı	d ɯ AD ʃ a AD ɾ ɯ AD
edebiyat	e AD d e AD b i AD j AB aː AE t
edebiyatçı	e AD d e AD b i AD j AB a AD t t ʃ ɯ AD
edilmek	e AD d i AD l m e AD c
edilmemek	e AD d i AD ɫ m e AD m e AD c
ediz	e AD d i AD z
ediz'i	e AD d i AD z i AD
ediz'le	e AD d i AD z l e AD
ediz'ler	e AD d i AD z l e AD ɾ
ediz'li	e AD d i AD z l i AD
ediz'siz	e AD d i AD z s i AD z
edizler	e AD d i AD z l e AD ɾ
egemen	e AD ɟ e AD m ɛ AD n
ehliyet	e AD h AA l i AD j AB e AD t
eklemeli	e AD c l e AD m e AD l i AD
eklemesiz	e AD c l e AD m e AD s i AD z
ekmek	e AD c m e AD c
el	ə AD l
elhamdülillah	e AD ɫ h AA a AD m d y AF ɫ i AD l l ä h AA
elifbe	e AD l i AD f b eː AE
emetofobi	e AD m e AD t o AF f o AF b i AD
emir	e AD m i AD ɾ
emmi	e AD m m i AD
enfeksiyon	ɛ AD n f ɛ AD c s i AD j AB o AF n
engin	ɛ AD n ɟ i AD n
enjeksiyon	e AD n ʒ e AD c s i AD j AB o AF n
enjeksiyonlar	e AD n ʒ e AD c s i AD j AB o AF n l a AD ɾ
enjeksiyonları	e AD n ʒ e AD c s i AD j AB o AF n l a AD ɾ ɯ AD
enjeksiyonu	e AD n ʒ e AD c s i AD j AB o AF n u AF
enjeksiyonunu	e AD n ʒ e AD c s i AD j AB o AF n u AF n u AF
enç	e AD n t ʃ
ercan	e AD ɾ d ʒ a AD n
erdoğan	e AD ɾ d o AF ɰ AB a AD n
erkek	æ AD ɾ c e AD c
ermenice	e AD ɾ m e AD n i AD d ʒ e AD
ertunç	e AD ɾ t u AF n t ʃ
estonya	ɛ AD s t ɔ AF n j AB a AD
et	ɛ AD t
etiyopyalı	e AD t i AD y AF o AF p y AF a AD ɫ ɯ AD
evcil	e AD β d ʒ i AD l
evet	e AD v e AD t
evle	e AD v ɫ e AD
evlenmek	e AD v l e AD n m e AD c
evler	e AD v ɫ e AD ɾ
evli	ɛ AD v l i AD
evlilikler	e AD v l i AD l i AD c l æ AD r
evse	e AD v s e AD
evsiz	e AD v s i AD z
ezgi	e AD z ɡ i AD
eğer	e AD ɣ e AD r
eğitim	ɛ AD ɤ AD ɨ AD t ɨ AD m
eğlence	e AD ɰ AB l e AD n d ʒ e AD
eğlenmek	eː AE l e AD n m e AD c
eşantiyon	ɛ AD ʃ a AD n t i AD j AB o AF n
eşantiyonlar	ɛ AD ʃ a AD n t i AD j AB o AF n l a AD ɾ
eşantiyonu	ɛ AD ʃ a AD n t i AD j AB o AF n u AF
eşek	e AD ʃ e AD c
fagofobi	f ɑ AD ɡ o AF f o AF b i AD
fakir	f a AD c i AD r
fark	f a AD ɾ k
farka	f a AD ɾ c a AD
farklar	f a AD ɾ c l a AD ɾ
farkı	f a AD ɾ c ɯ AD
fasık	f ɑː AE s ɯ AD c
fasıklar	f ɑː AE s ɯ AD c l a AD ɾ
fasığı	f ɑː AE s ɯ AD ɯ AD
fatih	f aː AE t i AD h AA
fazla	f ɑ AD z ɫ ɑ AD
felsefe	f e AD l s e AD f e AD
felsefeler	f e AD l s e AD f e AD l e AD ɾ
felsefeyi	f e AD l s e AD f e AD j AB i AD
feribot	f e AD ɾ i AD b o AF t
fetva	f e AD t v aː AE
fetö	f e AD t œ AF
fibrinojen	f i AD b ɾ i AD n o AF ʒ e AD n
figür	f i AD ɟ y AF ɾ
fiil	f iː AE l
fil	f i AD l
filistin	f i AD l i AD s t i AD n
film	f i AD l m
fince	f i AD n d ʒ ɛ AD
fitil	f i AD t i AD l
fobofobi	f o AF b o AF f o AF b i AD
fonksiyonlar	f o AF n c s i AD j AB o AF n l a AD ɾ
fotoğrafçı	f o AF t oː AG ɾ a AD f t ʃ ɯ AD
frambuaz	f ɾ a AD m b uː AG a AD z
fukara	f u AF k a AD r aː AE
futbol	f u AF t b ɔ AF ɫ
futbolcu	f u AF t b o AF ɫ d ʒ u AF
fıkra	f ɯ AD k r a AD
gazete	ɡ a AD z ɛ AD t ɛ AD
gefirofobi	ɟ e AD f i AD ɾ o AF f o AF b i AD
gel	ɟ ɛ AD l
geldin	ɡ e AD l d i AD n
geldiniz	ɡ e AD l d i AD n i AD z
gelincik	ɟ e AD l i AD n d ʒ i AD k
gelinmemek	ɡ ɛ AD ɫ i AD n m ɛ AD m ɛ AD c
gelirler	ɡ e AD ɫ i AD r ɫ e AD ɾ
gelişme	ɡ e AD l i AD ʃ m e AD
gelişmeler	ɡ e AD l i AD ʃ m e AD l e AD ɾ
gelişmeme	ɡ e AD l i AD ʃ m e AD m e AD
gelişmemeler	ɡ e AD l i AD ʃ m e AD m e AD l e AD ɾ
gelişmemeyi	ɡ e AD l i AD ʃ m e AD m e AD j AB i AD
gelişmeyi	ɡ e AD l i AD ʃ m e AD j AB i AD
geliştir	ɡ e AD ɫ i AD ʃ t i AD ɾ
geliştirici	ɡ e AD l i AD ʃ t i AD ɾ i AD d ʒ i AD
geliştiriciler	ɡ e AD l i AD ʃ t i AD ɾ i AD d ʒ i AD j AB i AD l e AD ɾ
geliştiriciyi	ɡ e AD l i AD ʃ t i AD ɾ i AD d ʒ i AD j AB i AD
geliştirir	ɡ e AD ɫ i AD ʃ t i AD ɾ i AD ɾ
geliştirme	ɡ e AD ɫ i AD ʃ t i AD ɾ m e AD
geliştirmek	ɡ e AD ɫ i AD ʃ t i AD ɾ m e AD c
geliştirmeler	ɡ e AD ɫ i AD ʃ t i AD ɾ m e AD ɫ e AD ɾ
geliştirmemek	ɡ e AD ɫ i AD ʃ t i AD ɾ m e AD m e AD c
geliştirmeyi	ɡ e AD ɫ i AD ʃ t i AD ɾ m e AD j AB i AD
geliştirmez	ɡ e AD ɫ i AD ʃ t i AD ɾ m e AD z
gelmedin	ɡ e AD l m e AD d i AD n
gelmediniz	ɡ e AD l m e AD d i AD n i AD z
gelmemek	ɡ ɛ AD ɫ m ɛ AD m ɛ AD c
gelmezler	ɡ e AD m e AD z ɫ e AD ɾ
genofobi	ɟ e AD n o AF f o AF b i AD
gerek	ɟ e AD ɾ e AD c
gerçek	ɟ æ AD ɾ t ʃ e AD c
gerçekten	ɟ e AD ɾ t ʃ e AD c t e AD n
gey	ɟ e AD j AB
geyşa	ɟ ɛ AD j AB ʃ ɑ AD
gezegen	ɡ e AD z e AD ɡ e AD n
gezegende	ɡ e AD z e AD ɡ e AD n d e AD
gezegeni	ɡ e AD z e AD ɡ e AD n i AD
gezegenler	ɡ e AD z e AD ɡ e AD n l e AD ɾ
geçidi	ɡ e AD t ʃ i AD d i AD
geçidini	ɡ e AD t ʃ i AD d i AD n i AD
geçit	ɡ e AD t ʃ i AD t
geçitler	ɡ e AD t ʃ i AD t l e AD ɾ
geçitleri	ɡ e AD t ʃ i AD t l e AD ɾ i AD
geğirmek	ɡ e AD j AB i AD ɾ m e AD c
gibi	ɡ i AD b i AD
giderim	ɟ i AD d̪ e AD ɾ i AD m
gir	i AD r
git	ɡ i AD t
gitar	ɟ i AD t a AD ɾ
gitme	ɡ i AD t m e AD
gitmedin	ɡ i AD t m e AD d i AD n
gitmediniz	ɡ i AD t m e AD d i AD n i AD z
gittin	ɡ i AD t t i AD n
gittiniz	ɡ i AD t t i AD n i AD z
giz	ɟ i AD z
gişe	ɡ i AD ʃ e AD
gişeler	ɡ i AD ʃ e AD l e AD ɾ
gişeyi	ɡ i AD ʃ e AD j AB i AD
gri	ɡ ɾ iː AE
gök	ɟ ø AF k
gökhan	ɟ œ AF c h AA a AD n
gökkuşağı	ɟ œ AF c k u AF ʃ ʌ AD ɣ ɯ AD
gökler	ɡ ø AF c l e AD ɾ
göksel	ɟ ø AF k s e AD l
gökyüzü	ɡ œ AF c j AB y AF z̟ y AF
göl	ɟ œ AF l
göz	ɟ ø AF z
gözden	ɟ œ AF z d e AD n
gözlükçü	ɟ œ AF z l y AF k t ʃ y AF
göğüs	ɟ œ AF ɰ AB y AF s
güdüm	ɟ y AF d y AF m
güdümler	ɟ y AF d y AF m l e AD ɾ
güdümü	ɟ y AF d y AF m y AF
güllü	ɟ y AF l l y AF
gün	ɡ y AF n
günahkâr	ɡ y AF n a AD h AA k j AB a AD ɾ
günahkârlar	ɡ y AF n a AD h AA k j AB a AD ɾ l a AD ɾ
günahkârı	ɡ y AF n a AD h AA k j AB a AD ɾ ɯ AD
günaydın	ɟ y AF n a AD j AB d ɯ AD n
günlük	ɟ y AF n l y AF c
günlükler	ɟ y AF n l y AF c l e AD ɾ
günlükleri	ɟ y AF n l y AF c l e AD ɾ i AD
günlüğü	ɟ y AF n l y AF j AB y AF
günlüğünü	ɟ y AF n l y AF j AB y AF n y AF
gürcüce	ɟ y AF ɾ d ʒ yː AG d ʒ ɛ AD
güvercin	ɟ y AF v e AD ɾ̝̊ d ʒ i AD n
güzel	ɟ y AF z ɛ AD l
güzergâh	ɟ y AF z e AD ɾ ɟ a AD h AA
hac	h AA ɑ AD d ʒ
hacı	h AA ɑ AD d ʒ ɯ AD
hacılık	h AA ɑ AD d ʒ ɯ AD ɫ ɯ AD k
had	h AA a AD d
hafriyat	h AA a AD f ɾ i AD j AB a AD t
hak	h AA ɑ AD k
hakan	h AA ɑː AE k ɑː AE n
hal	h AA ɑ AD lʲ
hala	h AA a AD ɫ a AD
hale	h AA aː AE l e AD
halüsinasyon	h AA a AD l y AF s i AD n a AD s j AB ɔ AF n
halı	h AA ä ɫ ɯ AD
hamdolsun	h AA a AD m d o AF ɫ s u AF n
hamur	h AA a AD m u AF ɾ
han	h AA a AD n
harp	h AA ɑ AD r p
harputlu	h AA ɑ AD ɾ p u AF t ɫ u AF
has	h AA a AD s
hasret	h AA a AD s ɾ e AD t
hatun	h AA ɑː AE t u AF n
hava	h AA ɑ AD v ɑ AD
havlu	h AA a AD v ɫ u AF
hayat	h AA ɑ AD j AB ɑ AD t
haymatlos	h AA a AD j AB m a AD t l oː AG s
hayırlı	h AA a AD j AB ɯ AD ɾ ɫ ɯ AD
haziran	h AA ɑ AD z iː AE r ɑ AD n
haçvari	h AA a AD t ʃ v aː AE ɾ i AD
hem	h AA e AD m
herkes	h AA æ AD ɾ c ɛ AD z
heykel	h AA e AD j AB c e AD l
hidayet	h AA i AD d aː AE j AB e AD t
hidayeti	h AA i AD d aː AE j AB e AD t i AD
hidayetler	h AA i AD d aː AE j AB e AD t l e AD ɾ
hikaye	h AA i AD k aː AE j AB e AD
hinterlant	h AA ɪ AD n t ə AD ɹ AH l æ AD n d
hipopotam	h AA i AD p o AF p o AF t a AD m
hiroşima	h AA i AD ɾ o AF ʃ i AD m ɑ AD
hisler	h AA i AD s l e AD ɾ
hâl	h AA ɑː AE lʲ
hâli	h AA aː AE l i AD
hâlini	h AA aː AE ɫ i AD n i AD
hâlleri	h AA aː AE ɫ ɫ e AD r i AD
hâlâ	h AA aː AE lʲ aː AE
hücre	h AA y AF d ʒ r ɛ AD
hükmü	h AA y AF k m y AF
hüküm	h AA y AF k y AF m
hükümler	h AA y AF k y AF m ɫ e AD ɾ
hırsız	h AA ɯ AD ɾ s ɯ AD z
idare	i AD d aː AE ɾ e AD
ideal	i AD d e AD a AD ɫ
ihtiyacı	i AD h AA t i AD j AB a AD d ʒ ɯ AD
ihtiyaç	i AD h AA t i AD j AB a AD t ʃ
ihtiyaçlar	i AD h AA t i AD j AB a AD d ʒ l a AD ɾ
iki	i AD k i AD
ikinci	i AD c i AD n d ʒ i AD
ikişer	i AD c i AD ʃ æ AD r
ilave	i AD l aː AE v e AD
ilaç	ɪ AD l a AD t ʃ
ilâç	ɪ AD l a AD t ʃ
imambayıldı	i AD m ɑ AD m b ɑ AD j AB ɯ AD ɫ d ɯ AD
ince	i AD n d ʒ ɛ AD
intikam	i AD n t i AD k a AD m
inşa	i AD n ʃ aː AE
inşaat	i AD n ʃ a AD a AD t
ip	i AD p
irak	ɯː AE ɾ a AD k
isyan	i AD s j AB a AD n
isyanlar	i AD s j AB a AD n l a AD ɾ
isyanı	i AD s j AB aː AE n ɯ AD
itaat	i AD t ɑː AE t
itilmek	i AD t i AD ɫ m e AD c
iyi	i AD j AB i AD
iyimser	i AD j AB i AD m s e AD ɾ
izbandut	i AD z b ɑ AD n d u AF t
izlek	i AD z ɫ e AD c
içer	i AD t ʃ e AD r
içerim	i AD t ʃ e AD r i AD m
içki	i AD t ʃ c i AD
iğne	iː AE n ɛ AD
iş	i AD ʃ
işaret	i AD ʃ aː AE ɾ e AD t
işareti	i AD ʃ aː AE ɾ e AD t i AD
işaretler	i AD ʃ aː AE ɾ e AD t l e AD ɾ
işlek	i AD ʃ ɫ e AD c
işlem	i AD ʃ l e AD m
işte	i AD ʃ t ɛ AD
işçi	i AD ʃ t ʃ i AD
işıktan	ɯ AD ʃ ɯ AD k t a AD n
i̇brahim	ɪ AD b r ɑ AD h AA ɪ AD m
i̇ngilizceleştirmek	i AD n ɟ i AD l i AD z d ʒ e AD l e AD ʃ t i AD ɾ m e AD c
i̇rlandalı	i AD ɾ l ɑ AD n d ɑ AD ɫ ɯ AD
i̇spanya	i AD s p ɑ AD n j AB ɑ AD
i̇spanyolca	i AD s p a AD n j AB o AF ɫ d ʒ a AD
i̇srailli	i AD s ɾ ɑː AE i AD l l i AD
i̇stanbullu	i AD s t ɑ AD n b u AF ɫ ɫ u AF
i̇talya	i AD t ɑ AD l j AB ɑ AD
i̇zlandaca	i AD z ɫ a AD n d a AD d ʒ a AD
j	ʒ
jale	ʒ a AD l e AD
japon	ʒ ɑ AD p o AF n
japonca	ʒ a AD p o AF n d ʒ a AD
jeolog	ʒ e AD o AF ɫ o AF ɡ
jeologlar	ʒ e AD o AF ɫ o AF ɡ l a AD ɾ
jeologu	ʒ e AD o AF ɫ o AF ɡ u AF
ji̇t	ʒ i AD t
ji̇tem	ʒ i AD t e AD m
kabak	k a AD b a AD k
kabinler	c a AD b i AD n l e AD ɾ
kablo	k a AD b ɫ ɔ AF
kabul	k a AD b uː AG lʲ
kadar	k ɑ AD d ɑ AD r
kader	k a AD d e AD r
kadın	k a AD d ɯ AD n
kalbur	k ɑ AD ɫ b u AF ɾ
kalkan	k a AD ɫ k a AD n
kan	k ɑ AD n
kanadalı	k ɑ AD n ɑ AD d ɑ AD ɫ ɯ AD
kanat	k ɑ AD n ɑ AD t
kaniş	k a AD n i AD ʃ
kap	k a AD p
kapa	k a AD p a AD
kapalı	k a AD p a AD l ɯ AD
kapama	k a AD p a AD m a AD
kapamak	k ɑ AD p ɑ AD m ɑ AD k
kapamalar	k a AD p a AD m a AD l a AD ɾ
kapamamak	k a AD p a AD m a AD m a AD c
kapamayı	k a AD p a AD m a AD j AB ɯ AD
kapibara	k a AD p i AD b a AD ɾ a AD
kaplumbağa	k a AD p ɫ ʊ AF m b aː AE
kaprisli	k a AD p ɾ i AD s l i AD
kapsam	k a AD p s a AD m
kapsamla	k a AD p s a AD m l a AD
kapsamlar	k a AD p s a AD m l a AD ɾ
kapsamlı	k a AD p s a AD m l ɯ AD
kapsamsa	k a AD p s a AD m s a AD
kapsamsız	k a AD p s a AD m s ɯ AD z
kapsamı	k a AD p s a AD m ɯ AD
kapuska	k a AD p u AF s k a AD
kapı	k a AD p ɯ AD
kar	k a AD ɾ
kara	k ɑ AD ɾ ɑ AD
karaciğer	k a AD ɾ a AD d ʒ iː AE e AD ɾ
karamsar	k a AD ɾ a AD m s a AD ɾ
karanfil	k a AD ɾ a AD n f i AD l
karar	k a AD ɾ a AD ɾ
karbonat	c a AD ɾ b o AF n a AD t
karbonatlar	c a AD ɾ b o AF n a AD t l a AD ɾ
karbonatı	c a AD ɾ b o AF n a AD t ɯ AD
karma	k a AD ɾ m a AD
karne	k ɑ AD ɾ n ɛ AD
karpuz	k a AD ɾ p u AF z
karıştırmak	k a AD ɾ ɯ AD ʃ t ɯ AD ɾ m a AD k
kaslı	k ɑ AD s ɫ ɯ AD
kasık	k ɑ AD s ɯ AD k
kasım	k ɑ AD s ɯ AD m
katalanca	k ɑ AD t ɑ AD ɫ ɑ AD n d ʒ ɑ AD
kategori	c a AD t e AD ɡ o AF ɾ i AD
kategoriler	c a AD t e AD ɡ o AF ɾ i AD l e AD ɾ
kategoriyi	c a AD t e AD ɡ o AF ɾ i AD j AB i AD
katil	k ɑː AE t i AD l
kavun	k a AD v u AF n
kaya	k ɑ AD j AB ɑ AD
kaybolmak	k a AD j AB b o AF ɫ m ɑ AD k
kaydı	k a AD j AB d ɯ AD
kaynak	k a AD j AB n a AD k
kaynaklamaz	c a AD j AB n a AD c l a AD m a AD z
kaynaklar	c a AD j AB n a AD c l a AD ɾ
kaynağı	c a AD j AB n a AD ɯ AD
kayık	k ɑ AD j AB ɯ AD k
kayıkçı	k ɑ AD j AB ɯ AD k t ʃ ɯ AD
kayısı	k a AD j AB ɯ AD s ɯ AD
kayıt	k a AD j AB ɯ AD t
kazanmak	k ɑ AD z ɑ AD n m ɑ AD k
kazma	k a AD z m a AD
kazı	k a AD z ɯ AD
kaşağı	k a AD ʃ a AD ɰ AB ɯ AD
kaşağılamaz	k a AD ʃ a AD ɰ AB ɯ AD l a AD m a AD z
kaşağılar	k a AD ʃ a AD ɰ AB ɯ AD l a AD ɾ
kaşağıyı	k a AD ʃ a AD ɰ AB ɯ AD j AB ɯ AD
kaşe	k a AD ʃ e AD
kaşelemez	k a AD ʃ e AD ɫ e AD m e AD z
kaşeler	k a AD ʃ e AD j AB i AD
kaşeyi	k a AD ʃ e AD j AB i AD
kedi	c e AD d i AD
kefal	c e AD f a AD l
kel	c ɛ AD l
kelepçe	k e AD ɫ e AD p t ʃ e AD
kemal	c e AD m a AD l
kemik	c e AD m i AD c
kemikler	k e AD m i AD k l e AD ɾ
kemiği	k e AD m i AD j AB i AD
kestirme	c e AD s t i AD ɾ m e AD
kestirmeler	k e AD s t i AD ɾ m e AD l e AD ɾ
kestirmeyi	c e AD s t i AD ɾ m e AD j AB i AD
keş	k e AD ʃ
keşkek	c e AD ʃ c ɛ AD c
ki	c i AD
kibutz	k i AD b u AF t z
kibutzlar	k i AD b u AF t z l a AD ɾ
kibutzu	k i AD b u AF t z u AF
kilise	c i AD l i AD s ɛ AD
kim	c i AD m
kimofobi	k i AD m o AF f o AF b i AD
kimya	c i AD m j AB aː AE
kimyacı	k i AD m j AB aː AE d ʒ ɯ AD
kimyalar	c i AD m j AB aː AE l a AD ɾ
kimyayı	c i AD m j AB aː AE j AB ɯ AD
kiraz	c i AD ɾ a AD z
kirpi	c i AD ɾ p i AD
kist	c i AD s t
kiste	c i AD s t e AD
kisti	c i AD s t i AD
kistin	c i AD s t t i AD n
kistler	c i AD s t l e AD ɾ
kistte	c i AD s t t e AD
kistten	c i AD s t t e AD n
klavye	k l a AD v j AB ɛ AD
klostrofobi	k ɫ o AF s t ɾ o AF f o AF b i AD
koca	k ɔ AF d ʒ ɑ AD
kodak	k o AF d a AD k
kokarca	k o AF k ɑ AD ɾ d ʒ ɑ AD
koklamak	k o AF k ɫ ɑ AD m ɑ AD k
kokmak	k o AF k m ɑ AD k
kokteyl	k o AF k t e AD j AB l
koku	k o AF k u AF
kol	k o AF ɫ
kolye	k o AF l j AB e AD
kombinasyon	k o AF m b i AD n a AD s j AB o AF n
kombinasyonla	k o AF m b i AD n a AD s j AB o AF n l a AD
kombinasyonlar	k o AF m b i AD n a AD s j AB o AF n l a AD ɾ
kombinasyonlu	k o AF m b i AD n a AD s j AB o AF n l u AF
kombinasyonsuz	k o AF m b i AD n a AD s j AB o AF n s u AF z
kombinasyonu	k o AF m b i AD n a AD s j AB o AF n a AD
koni	k o AF n ɪ AD
koruyucu	k o AF ɾ u AF j AB u AF d ʒ u AF
kovboy	k o AF v b o AF j AB
kul	k ʊ AF l
kula	k ʊ AF l a AD
kulak	k u AF ɫ ɑ AD k
kulda	k ʊ AF l d a AD
kullanıcı	k u AF ɫ ɫ a AD n ɯ AD d ʒ ɯ AD
kullar	k ʊ AF l l a AD ɾ
kulu	k ʊ AF l u AF
kulun	k ʊ AF l u AF n
kulübe	k u AF l y AF b ɛ AD
kum	k u AF m
kurbağa	k u AF ɾ b aː AE
kurgan	k u AF ɾ ɡ ɑ AD n
kuruşla	k u AF ɾ u AF ʃ l a AD
kuruşlar	k u AF ɾ u AF ʃ l a AD ɾ
kuruşu	k u AF ɾ u AF ʃ u AF
kutlama	k u AF t l a AD m a AD
kutsal	k u AF t s a AD ɫ
kuyu	k u AF j AB u AF
kuyumcu	k u AF j AB u AF m d ʒ u AF
kuğu	k u AF ɣ u AF
kuşak	k u AF ʃ a AD c
kuşaklar	k u AF ʃ a AD c l a AD ɾ
kuşağı	k u AF ʃ a AD ɯ AD
kâbe	k j AB aː AE b e AD
kâr	c a AD ɾ
kâse	c aː AE s e AD
kâseler	k j AB aː AE s e AD j AB i AD
kâseyi	k j AB aː AE s e AD j AB i AD
kör	k ø AF ɾ
köstebek	k œ AF s t ɛ AD b ɛ AD c
kötümser	c œ AF t y AF m s e AD ɾ
köyün	cʰ œ AF j AB y AF n
kül	c ʏ AF l
külfet	k y AF l f ɛ AD t
kültür	k y AF l t y AF ɾ
küpe	k y AF p ɛ AD
küçük	c y AF t ʃ y AF c
kılavuz	k ɯ AD ɫ ɑ AD v u AF z
kılıç	k ɯ AD ɫ ɯ AD t ʃ
kırklareli	k ɯ AD ɾ k ɫ ɑ AD ɾ ɛ AD l i AD
kırklarelili	k ɯ AD ɾ k ɫ ɑ AD ɾ ɛ AD l i AD l i AD
kırmızı	k ɯ AD ɾ m ɯ AD z ɯ AD
kırtasiye	k ɯ AD ɾ t aː AE s i AD j AB e AD
kırıklar	c ɯ AD ɾ ɯ AD c l a AD ɾ
kırılacak	k ɯ AD ɾ ɯ AD l a AD d ʒ a AD k
kırılacaklar	k ɯ AD ɾ ɯ AD l a AD d ʒ a AD k l a AD ɾ
kırığı	k ɯ AD ɾ ɯ AD ɯ AD
kısaltma	c ɯ AD s a AD l t m a AD
kısaltmalar	c ɯ AD s a AD l t m a AD l a AD ɾ
kısaltmaya	c ɯ AD s a AD l t m a AD j AB a AD
kısaltmayı	c ɯ AD s a AD l t m a AD j AB ɯ AD
kısayol	k ɯ AD s a AD j AB o AF l
kısayollar	k ɯ AD s a AD j AB o AF l l a AD ɾ
kısayolu	k ɯ AD s a AD j AB o AF l u AF
kısayolum	k ɯ AD s a AD j AB o AF l u AF m
kısayolun	k ɯ AD s a AD j AB o AF l u AF n
kısmet	k ɯ AD s m ɛ AD t
kıy	k ɯ AD j AB
kıyamet	k ɯ AD j AB aː AE m e AD t
kıymayın	k ɯ AD j AB m a AD j AB ɯ AD n
kıymet	k ɯ AD j AB m e AD t
kıymeti	k ɯ AD j AB m e AD t i AD
kıymetler	k ɯ AD j AB m e AD t l e AD ɾ
kıyı	k ɯ AD j AB ɯ AD
kıyılar	c ɯ AD j AB ɯ AD l a AD ɾ
kıyın	k ɯ AD j AB ɯ AD n
kıyınlar	k ɯ AD j AB ɯ AD n l a AD ɾ
kıyını	k ɯ AD j AB ɯ AD n ɯ AD
kıyıyı	c ɯ AD j AB ɯ AD j AB ɯ AD
kızıl	k ɯ AD z ɯ AD ɫ
kışla	k ɯ AD ʃ ɫ ɑ AD
lacivert	l aː AE d ʒ i AD v e AD ɾ t
laik	l ɑ AD i AD c
lehçe	l ɛ AD h AA t ʃ ɛ AD
letonca	l e AD t o AF n d ʒ a AD
leş	l ɛ AD ʃ
leşi	ɫ e AD ʃ i AD
leşler	ɫ e AD ʃ ɫ e AD ɾ
limon	l i AD m o AF n
lipofobi	l i AD p o AF f o AF b i AD
liralar	l i AD ɾ a AD l a AD ɾ
lirayla	l i AD ɾ a AD j AB l a AD
lisan	l i AD s a AD n
lisanlar	l i AD s a AD n l a AD ɾ
lisanı	l i AD s aː AE n ɯ AD
lise	l i AD s e AD
lokma	ɫ o AF k m a AD
lokmalar	ɫ o AF k m a AD ɫ a AD ɾ
lokmam	ɫ o AF k m a AD m
lokman	ɫ o AF k m a AD n
lokmanın	ɫ o AF k m a AD n ɯ AD n
lokması	ɫ o AF k m a AD s ɯ AD
lokmayı	ɫ o AF k m a AD j AB ɯ AD
londralı	l o AF n d ɾ ɑ AD ɫ ɯ AD
lütfen	l y AF t f ɛ AD n
maalesef	m a AD a AD l e AD s e AD f
maaş	m a AD a AD ʃ
macarca	m a AD d ʒ a AD ɾ d ʒ a AD
madde	m ɑ AD d d ɛ AD
maddeler	m a AD d d e AD l e AD ɾ
maddeyi	m a AD d d e AD j AB i AD
makedonya	m ɑ AD k ɛ AD d ɔ AF n j AB ɑ AD
mal	m ɑ AD ɫ
mallar	m a AD l l a AD ɾ
malı	m a AD l ɯ AD
mamut	m a AD m u AF t
manen	m aː AE n e AD n
mantar	m a AD n t a AD ɾ
mantarlar	m a AD n t a AD ɾ l a AD ɾ
mantarı	m a AD n t a AD ɾ ɯ AD
marangoz	m a AD ɾ a AD n ɡ o AF z
margarin	m ɑ AD ɾ ɡ ɑ AD ɾ i AD n
masaj	m a AD s a AD ʒ
masal	m ɑ AD s ɑ AD ɫ
masaüstü	m a AD s a AD ʔ y AF s t y AF
masum	m ɑː AE s u AF m
masör	m a AD s ø AF ɾ
masörler	m a AD s ø AF ɾ l e AD ɾ
masörü	m a AD s ø AF ɾ y AF
matematik	m a AD t e AD m a AD t i AD c
matematikle	m a AD t e AD m a AD t i AD c l e AD
matematikler	m a AD t e AD m a AD t i AD c l e AD ɾ
matematikli	m a AD t e AD m a AD t i AD c l i AD
matematiksiz	m a AD t e AD m a AD t i AD c s i AD z
matematiği	m a AD t e AD m a AD t i AD j AB i AD
mazı	m ɑ AD z ɯ AD
mağara	m a AD a AD ɾ a AD
mektep	m ɛ AD k t ɛ AD p
melek	m ɛ AD l ɛ AD c
memnuniyet	m e AD m n uː AG n i AD j AB e AD t
memnuniyeti	m e AD m n uː AG n i AD j AB e AD t i AD
memnuniyetle	m e AD m n uː AG n i AD j AB e AD t l e AD
memnuniyetler	m e AD m n uː AG n i AD j AB e AD t l e AD ɾ
memnuniyetse	m e AD m n uː AG n i AD j AB e AD t s e AD
mendil	m e AD n d i AD l
menekşe	m ɛ AD n ɛ AD c ʃ ɛ AD
menü	m e AD n y AF
menüler	m e AD n y AF l e AD ɾ
menüyü	m e AD n y AF j AB y AF
merhaba	m ɛ AD ɾ a AD b a AD
merheba	m ɛ AD ɾ a AD b a AD
mert	m ɛ AD r t
mesafe	m e AD s aː AE f e AD
meslek	m e AD s l e AD c
mesul	m e AD s ʔ u AF ɫ
mesuliyetli	m e AD s ʔ uː AG l i AD j AB e AD t l i AD
mesuliyetsiz	m e AD s ʔ uː AG l i AD j AB e AD t s i AD z
metre	m ɛ AD t ɾ ɛ AD
metres	m ɛ AD t ɾ ɛ AD s
mezar	m e AD z a AD ɾ
mezarlar	m e AD z a AD ɾ l a AD ɾ
mezarı	m e AD z a AD ɾ ɯ AD
mezra	m e AD z ɾ aː AE
mezralar	m e AD z ɾ aː AE l a AD ɾ
mezrayı	m e AD z ɾ aː AE j AB ɯ AD
meşe	m e AD ʃ e AD
meşeler	m e AD ʃ e AD ɫ e AD ɾ
meşem	m e AD ʃ e AD m
meşen	m e AD ʃ e AD n
meşenin	m e AD ʃ e AD n i AD n
meşeyi	m e AD ʃ e AD j AB i AD
mikroskop	m ɪ AD k r ɔ AF s k ɔ AF p
mil	m i AD l
milenyum	m i AD l e AD n j AB u AF m
mimar	m iː AE m ɑ AD r
minder	m i AD n d e AD r
mistik	m i AD s t i AD c
miço	m i AD t ʃ o AF
model	m o AF d e AD l
mor	m o AF ɾ
muck	m u AF d ʒ k
muhafiyet	m u AF x aː AE f i AD j AB e AD t
muhallebi	m u AF h AA a AD l l e AD b i AD
muhtaç	m u AF h AA t a AD t ʃ
mum	m u AF m
murat	m u AF ɾ a AD t
musa	m uː AG s aː AE
mustafa	m u AF s t a AD f a AD
muz	m u AF z
muş	m u AF ʃ
muşmula	m u AF ʃ m u AF ɫ a AD
mübadele	m y AF b aː AE d e AD l e AD
mübarek	m ʏ AF b a AD ɾ e AD c
müftü	m y AF f t y AF
müsaade	m y AF s a AD a AD d e AD
müslüman	m y AF s l y AF m ɑ AD n
müslümanlar	m y AF s l y AF m a AD n l a AD ɾ
müzakere	m y AF z aː AE k e AD ɾ e AD
müzakereler	m y AF z aː AE k e AD ɾ e AD l e AD ɾ
müzakereyi	m y AF z aː AE k e AD ɾ e AD j AB i AD
mısırlı	m ɯ AD s ɯ AD ɾ ɫ ɯ AD
mısırsız	m ɯ AD s ɯ AD ɾ s ɯ AD z
nah	n ɑ AD h AA
naif	n ɑː AE i AD f
nalci	n ɑ AD l d ʒ i AD
nargileler	n ɑ AD ɾ ɟ i AD l ɛ AD l ɛ AD ɾ
nargileyi	n ɑ AD ɾ ɟ i AD l ɛ AD j AB i AD
nasır	n a AD s ɯ AD ɾ
nasırda	n a AD s ɯ AD ɾ d a AD
nasırdan	n a AD s ɯ AD ɾ d a AD n
nasırlar	n a AD s ɯ AD ɾ l a AD ɾ
nasırlara	n a AD s ɯ AD ɾ l a AD ɾ a AD
nasırlarda	n a AD s ɯ AD ɾ l a AD ɾ d a AD
nasırlardan	n a AD s ɯ AD ɾ l a AD ɾ d a AD n
nasırları	n a AD s ɯ AD ɾ l a AD ɾ ɯ AD
nasırların	n a AD s ɯ AD ɾ l a AD ɾ ɯ AD n
nasırı	n a AD s ɯ AD ɾ ɯ AD
nasırın	n a AD s ɯ AD ɾ ɯ AD n
nataşa	n ɑ AD t ɑ AD ʃ ɑ AD
nedime	n e AD d iː AE m e AD
neptün	n e AD p t y AF n
nezle	n e AD z l e AD
neşriyat	n e AD ʃ r i AD j AB aː AE t
nida	n i AD d a AD
nil	n i AD l
nimet	n iː AE m e AD t
ninni	n i AD n n i AD
niçin	n iː AE t ʃ i AD n
nişanlı	n i AD ʃ a AD n ɫ ɯ AD
nomofobi	n o AF m o AF f o AF b i AD
numaralama	n u AF m a AD ɾ a AD l a AD m a AD
numaralamalar	n u AF m a AD ɾ a AD l a AD m a AD l a AD ɾ
numaralamama	n u AF m a AD ɾ a AD l a AD m a AD m a AD
numaralamamalar	n u AF m a AD ɾ a AD l a AD m a AD m a AD l a AD ɾ
numaralamamayı	n u AF m a AD ɾ a AD l a AD m a AD m a AD j AB ɯ AD
numaralamayı	n u AF m a AD ɾ a AD l a AD m a AD j AB ɯ AD
nur	n u AF ɾ
nöron	n œ AF r ɔ AF n
o	o AF
oburluk	o AF b u AF ɾ ɫ u AF k
ocak	o AF d ʒ a AD k
oha	ɔː AG h AA ɑː AE
oje	o AF ʒ ɛ AD
oku	o AF k u AF
okuma	o AF k u AF m a AD
okumak	o AF k u AF m a AD k
okumalar	o AF k u AF m a AD l a AD ɾ
okumayı	o AF k u AF m a AD j AB ɯ AD
ol	o AF l
olsun	o AF ɫ s u AF n
oluşmak	o AF ɫ u AF ʃ m ɑ AD k
oluşturmak	o AF ɫ u AF ʃ t u AF ɾ m ɑ AD k
ombudsman	o AF m b u AF d s m ɑ AD n
onar	o AF n a AD r
onlar	o AF n l a AD r
onur	o AF n u AF ɾ
optimizasyon	o AF p t i AD m i AD z a AD s j AB o AF n
optimizasyonlar	o AF p t i AD m i AD z a AD s j AB o AF n l a AD ɾ
optimizasyonu	o AF p t i AD m i AD z a AD s j AB o AF n u AF
oran	o AF ɾ a AD n
oranlar	o AF ɾ a AD n l a AD ɾ
oranı	o AF ɾ a AD n ɯ AD
ortak	o AF ɾ t a AD k
ortaklı	o AF ɾ t ɑ AD k ɫ ɯ AD
ortaklık	o AF ɾ t ɑ AD k ɫ ɯ AD c
ortaksız	o AF ɾ t a AD k s ɯ AD z
oslo	o AF s ɫ o AF
osmanlı	o AF s m a AD n ɫ ɯ AD
otobüs	o AF t ɔ AF b y AF s
otofobi	o AF t o AF f o AF b i AD
oy	o AF j AB
oysa	o AF j AB s a AD
oyuncu	o AF j AB u AF n d ʒ u AF
oğuz	o AF ɣ u AF z
pandeist	p a AD n d e AD i AD s t
pandeisti	p a AD n d e AD i AD s t i AD
pandeistin	p a AD n d e AD i AD s t i AD n
pandeistler	p a AD n d e AD i AD s t l e AD ɾ
panendeist	p a AD n e AD n d e AD i AD s t
panendeisti	p a AD n e AD n d e AD i AD s t i AD
panendeistin	p a AD n e AD n d e AD i AD s t i AD n
panendeistler	p a AD n e AD n d e AD i AD s t l e AD ɾ
panenteizm	p a AD n e AD n t e AD i AD z m
panenteizmi	p a AD n e AD n t e AD i AD z m i AD
panenteizmler	p a AD n e AD n t e AD i AD z m l e AD ɾ
panteizm	p a AD n t e AD i AD z m
panteizmi	p a AD n t e AD i AD z m i AD
panteizmler	p a AD n t e AD i AD z m l e AD ɾ
panteon	p ɑ AD n t ɛ AD o AF n
papa	p a AD p a AD
papatya	p ɑ AD p ɑ AD t j AB ɑ AD
papatyalar	p ɑ AD p ɑ AD t j AB ɑ AD l a AD ɾ
papatyayı	p ɑ AD p ɑ AD t j AB ɑ AD j AB ɯ AD
para	p ɑ AD ɾ ɑ AD
parisli	p ɑː AE ɾ i AD s l i AD
parti	p ɑ AD ɾ t i AD
pas	p a AD s
patlıcan	p a AD t ɫ ɯ AD d ʒ a AD n
patron	p a AD t ɾ o AF n
paylaşmak	p ɑ AD j AB ɫ ɑ AD ʃ m ɑ AD k
ped	p e AD d
pedofobi	p e AD d o AF f o AF b i AD
pek	p ɛ AD k
pembe	p e AD m b e AD
pena	p ɛ AD n ɑ AD
perde	p ɛ AD ɾ d ɛ AD
permütasyon	p e AD ɾ m y AF t a AD s j AB o AF n
permütasyonla	p ɛ AD r m y AF t a AD s j AB o AF n l a AD
permütasyonlar	p e AD r m y AF t a AD s j AB o AF n l a AD ɾ
permütasyonlu	p ɛ AD ɾ m y AF t a AD s j AB o AF n l u AF
permütasyonsuz	p ɛ AD ɾ m y AF t a AD s j AB o AF n s u AF z
permütasyonu	p e AD ɾ m y AF t a AD s j AB o AF n u AF
peçete	p e AD t ʃ e AD t e AD
piknik	p i AD c n i AD c
pil	p ɪ AD l
pilav	p i AD l a AD v
pirinç	p i AD ɾ i AD n t ʃ
pis	p i AD s
pisi	p i AD s i AD
planet	p ɫ a AD n e AD t
planeti	p ɫ a AD n e AD t i AD
planetler	p ɫ a AD n e AD t l e AD ɾ
platformlararası	p ɫ a AD t f o AF ɾ m l a AD ɾ a AD ɾ a AD s ɯ AD
plüton	p l y AF t o AF n
plüton'u	p l y AF t o AF n u AF
plütonlar	p l y AF t o AF n l a AD ɾ
polis	p o AF l i AD s
polisi	p o AF l i AD s i AD
polisler	p o AF l i AD s l e AD ɾ
porsuk	p o AF ɾ s u AF k
program	p ɾ o AF ɡ ɾ a AD m
programla	p ɾ o AF ɡ ɾ a AD m l a AD
programlama	p ɾ o AF ɡ ɾ a AD m l a AD m a AD
programlamak	p ɾ o AF ɡ ɾ a AD m l a AD m a AD k
programlamamak	p ɾ o AF ɡ ɾ a AD m l a AD m a AD m a AD k
programlamaz	p ɾ o AF ɡ ɾ a AD m l a AD m a AD z
programlar	p ɾ o AF ɡ ɾ a AD m l a AD ɾ
programsa	p ɾ o AF ɡ ɾ a AD m s a AD
programı	p ɾ o AF ɡ ɾ a AD m ɯ AD
programını	p ɾ o AF ɡ ɾ a AD m ɯ AD n ɯ AD
psikoz	p s i AD k o AF z
psikozla	p s i AD k o AF z l a AD
psikozlar	p s i AD k o AF z l a AD ɾ
psikozlu	p s i AD k o AF z l u AF
psikozsa	p s i AD k o AF z s a AD
psikozsuz	p s i AD k o AF z s u AF z
psikozu	p s i AD k o AF z u AF
pus	p u AF s
pürüz	p y AF ɾ y AF z
radyo	ɾ a AD d j AB o AF
rahmi	ɾ a AD h AA m i AD
ramazan	ɾ ɑ AD m ɑ AD z ɑ AD n
rasathane	r a AD s a AD t h AA aː AE n e AD
rasathaneler	r a AD s a AD t h AA aː AE n e AD ɫ e AD ɾ
rasathaneyi	r a AD s a AD t h AA aː AE n e AD j AB i AD
rağmen	r a AD ɣ m e AD n
reform	ɾ ɛ AD f o AF ɾ m
rehber	ɾ ɛ AD h AA b e AD ɾ
ritim	ɾ i AD t i AD m
ritm	ɾ i AD t m
riyad	ɾ i AD j AB a AD d
romalı	ɾ o AF m a AD ɫ ɯ AD
roman	ɾ o AF m ɑ AD n
rumen	ɾ u AF m e AD n
rusça	ɾ u AF s t ʃ a AD
rusçalar	ɾ u AF s t ʃ a AD l a AD ɾ
röntgenyum	ʀ œ AF n t ɡ eː AE n j AB ʊ AF m
rüzgâr	r y AF z ɟ a AD r
saat	s a AD a AD t
sabit	s aː AE b i AD t
sabun	s a AD b u AF n
sabır	s ɑ AD b ɯ AD ɾ
sac	s ʌ AD d ʒ
sakin	s aː AE c i AD n
sakini	s aː AE c i AD n i AD
sakinler	s aː AE c i AD n l e AD ɾ
sakın	s a AD k ɯ AD n
salata	s ɑ AD ɫ ɑ AD t ɑ AD
salt	s a AD ɫ t
salı	s ɑ AD l ɯ AD
samur	s ɑ AD m u AF ɾ
sanatçı	s a AD n a AD t t ʃ ɯ AD
sandalye	s a AD n d a AD l j AB e AD
sandviç	s a AD n d v i AD t ʃ
sanskrit	s a AD n s k ɾ i AD t
sap	s ɑ AD p
sarı	s ɑ AD ɾ ɯ AD
satranç	s ɑ AD t ɾ ɑ AD n t ʃ
sayfalandırma	s a AD j AB f a AD l a AD n d ɯ AD ɾ m a AD
saç	s a AD t ʃ
sağ	s a AD ɰ AB
sağlayıcı	s aː AE l a AD j AB ɯ AD d ʒ ɯ AD
sağlayıcılar	s aː AE l a AD j AB ɯ AD d ʒ ɯ AD l a AD ɾ
sağlayıcıyı	s aː AE l a AD j AB ɯ AD d ʒ ɯ AD j AB ɯ AD
sekiz	s e AD c i AD z
sekizer	s e AD c i AD z æ AD r
selam	s e AD l a AD m
selamünaleyküm	s e AD l a AD m y AF n a AD l e AD j AB c y AF m
selim	s e AD l i AD m
sembol	s e AD m b ɔ AF ɫ
semiz	s e AD m i AD z
semizotu	s e AD m i AD z o AF t u AF
sempozyum	s e AD m p o AF z j AB u AF m
sempozyumlar	s e AD m p o AF z j AB u AF m l a AD ɾ
sempozyumu	s e AD m p o AF z j AB u AF m u AF
sen	s e AD n
sera	s e AD r ɑ AD
sercan	s e AD ɾ d ʒ ɑ AD n
serdar	s e AD ɾ d ɑ AD ɾ
serin	s e AD ɾ i AD n
server	s e AD ɾ v e AD ɾ
serverde	s e AD ɾ v e AD ɾ d e AD
serverden	s e AD ɾ v e AD ɾ d e AD n
servere	s e AD ɾ v e AD ɾ e AD
serveri	s e AD ɾ v e AD ɾ i AD
serverin	s e AD ɾ v e AD ɾ i AD n
serverler	s e AD ɾ v e AD ɾ l e AD ɾ
serverlerde	s e AD ɾ v e AD ɾ l e AD ɾ d e AD
serverlerden	s e AD ɾ v e AD ɾ l e AD ɾ d e AD n
serverlere	s e AD ɾ v e AD ɾ l e AD ɾ e AD
serverleri	s e AD ɾ v e AD ɾ l e AD ɾ i AD
serverlerin	s e AD ɾ v e AD ɾ l e AD ɾ i AD n
servi	s ɛ AD ɾ v i AD
ses	s e AD s
sesi	s e AD s i AD
sevda	s e AD v d a AD
sevgi	s e AD v ɟ ɪ AD
sevilla	s e AD v i AD l l a AD
seçenek	s ɛ AD t ʃ ɛ AD n ɛ AD c
seçilmek	s e AD t ʃ i AD ɫ m e AD c
sille	s i AD l l ɛ AD
simit	s i AD m i AD t
simyacı	s i AD m j AB aː AE d ʒ ɯ AD
sindirmek	s i AD n d i AD ɾ m ɛ AD c
sinek	s i AD n ɛ AD c
sineklik	s i AD n ɛ AD c l i AD c
sismik	s i AD s m i AD k
sistem	s i AD s t e AD m
siyah	s i AD j AB ɑ AD h AA
siz	s ɪ AD z
sohum	s o AF h AA u AF m
somnifobi	s o AF m n i AD f o AF b i AD
somon	s o AF m o AF n
sos	s o AF s
soy	s o AF ɪ AD
soykırım	s o AF j AB k ɯ AD ɾ ɯ AD m
soğuk	s o AF ɰ AB u AF k
soğukluk	s o AF ɰ AB u AF k ɫ u AF k
stokiyometri	s t o AF c i AD j AB o AF m e AD t ɾ i AD
stüdyo	s t y AF d j AB o AF
stüdyolar	s t y AF d j AB o AF l a AD ɾ
stüdyoyu	s t y AF d j AB o AF j AB u AF
sual	s u AF ʔ a AD ɫ
suali	s u AF ʔ a AD ɫ i AD
sualler	s u AF ʔ a AD ɫ l e AD ɾ
sulamaz	s u AF l a AD m a AD z
sular	s u AF l a AD ɾ
sultan	s u AF ɫ t aː AE n
sulu	s u AF ɫ u AF
sululuk	s u AF ɫ u AF ɫ u AF c
suna	s u AF n ɑ AD
suyu	s u AF j AB u AF
söylemek	s ø AF j AB l ɛ AD m ɛ AD c
söylememek	s ø AF j AB l ɛ AD m ɛ AD m ɛ AD c
sözlükçü	s œ AF z l y AF k t ʃ y AF
söğüt	s œ AF y AF t
sü	s y AF
sür	s y AF ɾ
sürme	s y AF ɾ m e AD
sürmek	s y AF ɾ m e AD c
sürmeler	s y AF ɾ m e AD l e AD ɾ
sürmeyi	s y AF ɾ m e AD j AB i AD
sütlaç	s y AF t l a AD t ʃ
sütun	s y AF t u AF n
sütunlar	s y AF t u AF n l a AD ɾ
sütunlu	s y AF t u AF n l u AF
sütunsuz	s y AF t u AF n s u AF z
sütunu	s y AF t u AF n u AF
sıcak	s ɯ AD d ʒ ɑ AD k
sınıf	s ɯ AD n ɯ AD f
sır	s ɯ AD ɾ
sıralamak	s ɯ AD ɾ a AD l a AD m a AD c
sıralamamak	s ɯ AD ɾ a AD l a AD m a AD m a AD c
sıralamaz	s ɯ AD ɾ a AD l a AD m a AD z
sıralar	s ɯ AD ɾ a AD l a AD ɾ
sırasıyla	s ɯ AD ɾ a AD s ɯ AD j AB l a AD
sırayla	s ɯ AD ɾ a AD j AB l a AD
sıvı	s ɯ AD v ɯ AD
tabak	t ɑ AD b ɑ AD k
taban	t a AD b a AD n
tabanlar	t a AD b a AD n l a AD ɾ
tabanları	t a AD b a AD n l a AD ɾ ɯ AD
tabanlı	t a AD b a AD n l ɯ AD
tabansız	t a AD b a AD n s ɯ AD z
tabansızla	t a AD b a AD n s ɯ AD z l a AD
tabansızlar	t a AD b a AD n s ɯ AD z l a AD ɾ
tabansızsa	t a AD b a AD n s ɯ AD z s a AD
tabansızı	t a AD b a AD n s ɯ AD z ɯ AD
tabanı	t a AD b a AD n ɯ AD
tabanını	t a AD b a AD n ɯ AD n ɯ AD
tablo	t ɑ AD b l ɔ AF
tabut	t a AD b u AF t
tadil	t aː AE d i AD l
tadilat	t aː AE d i AD l aː AE t
tadı	t a AD d ɯ AD
tagalogca	t a AD ɡ a AD l o AF ɡ d ʒ a AD
tagalogcalar	t a AD ɡ a AD l o AF ɡ d ʒ a AD l a AD ɾ
tagalogcayı	t a AD ɡ a AD l o AF ɡ d ʒ a AD j AB ɯ AD
taklidi	t a AD k ɫ iː AE d i AD
taklidim	t a AD k ɫ iː AE d i AD m
taklidin	t a AD k ɫ iː AE d i AD n
taklidî	t a AD k ɫ iː AE d iː AE
taklit	t a AD k ɫ i AD t
taklitle	t a AD k ɫ i AD t ɫ e AD
taklitler	t a AD k ɫ i AD t ɫ e AD ɾ
taklitçi	t a AD k ɫ i AD t t ʃ i AD
taklitçidir	t a AD k ɫ i AD t t ʃ i AD d i AD ɾ
taklitçiler	t a AD k ɫ i AD t t ʃ ɫ e AD ɾ
taklitçinin	t a AD k ɫ i AD t t ʃ i AD n i AD n
taklitçisin	t a AD k ɫ i AD t t ʃ i AD s i AD n
taklitçiyi	t a AD k ɫ i AD t t ʃ i AD j AB i AD
taklitçiyim	t a AD k ɫ i AD t t ʃ i AD j AB i AD m
takyon	t ɑ AD k j AB o AF n
talep	t a AD l e AD p
tamlayan	t ɑ AD m ɫ ɑ AD j AB ɑ AD n
tanga	t ɑ AD ŋ ɡ ɑ AD
tanrıcı	t ɑ AD n ɾ ɯ AD d ʒ ɯ AD
tanrıcılık	t ɑ AD n ɾ ɯ AD d ʒ ɯ AD ɫ ɯ AD k
tanımlık	t a AD n ɯ AD m l ɯ AD c
tanımlıklar	t a AD n ɯ AD m l ɯ AD c l a AD ɾ
tanımlığı	t a AD n ɯ AD m l ɯ AD ɯ AD
tarih	t aː AE ɾ i AD ç
tarçın	t a AD ɾ t ʃ ɯ AD n
tat	t a AD t
tatarca	t a AD t a AD ɾ d ʒ a AD
tatil	t aː AE t i AD l
tatlar	t a AD t l a AD ɾ
tatlı	t ɑ AD t ɫ ɯ AD
tavan	t ɑ AD β ɑ AD n
tay	t ɑ AD j AB
taş	t ɑ AD ʃ
tebeşir	t e AD b e AD ʃ i AD ɾ
tecrübe	t ɛ AD d ʒ ɾ y AF b ɛ AD
tedricî	t e AD d ɾ iː AE d ʒ iː AE
tekdilli	t e AD c d i AD l l i AD
tekdillilik	t e AD c d i AD l l i AD l i AD c
tekdillilikler	t e AD c d i AD l l i AD l i AD c l e AD ɾ
tekdilliliği	t e AD c d i AD l l i AD l i AD i AD
tel	t ɛ AD l
teleskop	t ɛ AD l ɛ AD s k ɔ AF p
temmuz	t ɛ AD mː ʊ AF z
tendon	t ɛ AD n d ɔ AF n
tenis	t e AD n i AD s
tenisçi	t ɛ AD n i AD s t ʃ i AD
teodise	t e AD o AF d i AD s e AD
teodiseler	t e AD o AF d i AD s e AD l e AD ɾ
teodiseyi	t e AD o AF d i AD s e AD j AB i AD
teoloji	t e AD o AF ɫ o AF ʒ i AD
teolojiler	t e AD o AF ɫ o AF ʒ i AD l e AD ɾ
teolojiyi	t e AD o AF ɫ o AF ʒ i AD j AB i AD
tepe	t e AD p ɛ AD
terapist	t ɛ AD ɾ ɑ AD p i AD s t
terli	t e AD ɾ l i AD
terlik	t e AD ɾ l i AD c
termometre	t ə AD ɾ m o AF m ɛ AD t ɾ ɛ AD
terzi	t e AD ɾ z i AD
terör	t e AD ɾ ø AF ɾ
terörizm	t e AD ɾ œ AF ɾ i AD z m
terörler	t e AD ɾ ø AF ɾ l e AD ɾ
terörü	t e AD ɾ ø AF ɾ y AF
tesadüf	t e AD s aː AE d y AF f
teslim	t e AD s l i AD m
test	t e AD s t
teste	t e AD s t e AD
testi	t e AD s t i AD
testle	t e AD s t l e AD
testler	t e AD s t l e AD ɾ
testli	t ɛ AD s t l i AD
testse	t e AD s t s e AD
testsiz	t ɛ AD s t s i AD z
tetrafobi	t e AD t ɾ a AD f o AF b i AD
teyze	t e AD j AB z e AD
teyzeler	t e AD j AB z e AD l e AD ɾ
teyzeyi	t e AD j AB z e AD j AB i AD
teşkilat	t ɛ AD ʃ k iː AE ɫ a AD t
teşkilatlar	t ɛ AD ʃ k iː AE ɫ aː AE t l a AD ɾ
teşkilatı	t ɛ AD ʃ k iː AE ɫ aː AE t ɯ AD
tir	t ɯ AD ɾ
tiyatro	t i AD j AB a AD t ɾ o AF
tokmak	t ɔ AF k m ɑ AD k
tokmaklar	t ɔ AF k m ɑ AD k l ɑ AD ɾ
tokofobi	t o AF k o AF f o AF b i AD
topoloji	t o AF p o AF l o AF ʒ i AD
topolojik	t o AF p o AF l o AF ʒ i AD c
topolojiler	t o AF p o AF l o AF ʒ i AD l e AD ɾ
topolojiyi	t o AF p o AF l o AF ʒ i AD j AB i AD
toprak	t o AF p ɾ ɑ AD k
topraklar	t o AF p ɾ a AD c l a AD ɾ
toprağı	t o AF p ɾ a AD ɯ AD
torbalı	t o AF r b a AD l ɯ AD
toz	t o AF z
tren	t ɾ e AD n
trigonometri	t ɾ i AD ɟ o AF n o AF m e AD t ɾ i AD
trigonometriler	t ɾ i AD ɟ o AF n o AF m e AD t ɾ i AD l e AD ɾ
trigonometriyi	t ɾ i AD ɟ o AF n o AF m e AD t ɾ i AD j AB i AD
tuna	t u AF n a AD
tundra	t u AF n d ɾ a AD
turuncu	t u AF ɾ u AF n d ʒ u AF
turşu	t u AF ɾ ʃ u AF
tuz	t u AF z
tuza	t u AF z a AD
tuzlamaz	t u AF z l a AD m a AD z
tuzlar	t u AF z l a AD ɾ
tuzlu	t u AF z l u AF
tuzsuz	t u AF z s u AF z
tuzu	t u AF z u AF
tuzum	t u AF z u AF m
tuzun	t u AF z u AF n
tüm	t y AF m
tünaydın	t y AF n a AD j AB d ɯ AD n
tür	t y AF r
türk	t y AF ɾ c
türkçeleştirmek	t y AF ɾ k t ʃ ɛ AD l e AD ʃ t i AD ɾ m e AD c
türler	t y AF ɾ l e AD ɾ
türlü	t y AF ɾ l y AF
türü	t y AF ɾ y AF
tüt	t y AF t
tüter	t y AF t e AD ɾ
tütün	t y AF t y AF n
tırabzan	t ɯ AD ɾ ɑ AD b z ɑ AD n
ucube	u AF d ʒ uː AG b ɛ AD
uhrevî	u AF h AA ɾ e AD v iː AE
ulus	u AF ɫ u AF s
uluslararası	u AF ɫ u AF s ɫ a AD ɾ a AD ɾ a AD s ɯ AD
uluslarüstü	u AF ɫ u AF s ɫ a AD ɾ y AF s t y AF
umumiyet	u AF m uː AG m i AD j AB e AD t
umumiyeti	u AF m uː AG m i AD j AB e AD t i AD
umumiyetler	u AF m uː AG m i AD j AB e AD t l e AD ɾ
unlu	u AF n ɫ u AF
ut	u AF t
utku	u AF t k u AF
uyarım	ɟ i AD d̪ e AD ɾ i AD m
uygulama	u AF j AB ɡ u AF l a AD m a AD
uygulamalar	u AF j AB ɡ u AF l a AD m a AD l a AD ɾ
uygulamayı	u AF j AB ɡ u AF l a AD m a AD j AB ɯ AD
uzak	u AF z a AD k
uğur	u AF ɣ u AF r
vaat	v ɑː AE t
vaftiz	v ɑ AD f t i AD z
vakıf	v ɑ AD k ɯ AD f
valla	v a AD lː aː AE
vallahi	v a AD lː aː AE h AA i AD
van	v a AD n
var	v ɑ AD ɾ
varlık	v ɑ AD ɾ ɫ ɯ AD k
varoş	v a AD r o AF ʃ
vasi	v aː AE s iː AE
vasiler	v aː AE s iː AE l e AD ɾ
vasistas	v a AD s i AD s t a AD s
vasiyi	v aː AE s iː AE j AB i AD
vatansever	v a AD t a AD n s e AD v e AD ɾ
vaşak	v ɑ AD ʃ ɑ AD k
ve	v e AD
veda	β ɛ AD d aː AE
veriler	v e AD ɾ i AD ɫ e AD ɾ
verilmek	v e AD ɾ i AD l m ɛ AD c
verirler	v e AD ɾ i AD ɾ l e AD ɾ
veriyi	v e AD ɾ i AD j AB i AD
vermezler	v e AD m e AD z l e AD ɾ
veysel	β e AD j AB s e AD l
vida	v i AD d a AD
viyadük	v i AD j AB ɑ AD d y AF c
vişne	v i AD ʃ n e AD
voleybolcu	v o AF l ɛ AD j AB b o AF ɫ d ʒ u AF
vurmak	v u AF ɾ m ɑ AD k
web	v e AD b
wiki	v i AD c i AD
yakamoz	j AB a AD k a AD m o AF z
yalanlamak	j AB a AD ɫ a AD n ɫ a AD m a AD k
yamuk	j AB a AD m u AF k
yanak	j AB ɑ AD n ɑ AD k
yanısıra	j AB a AD n ɯ AD s ɯ AD ɾ a AD
yapar	j AB a AD p a AD ɾ
yapmaz	j AB a AD p m a AD z
yar	j AB aː AE ɾ
yarın	j AB a AD ɾ ɯ AD n
yastık	j AB a AD s t ɯ AD k
yatırımcı	j AB ä t̪ ɯ AD ɾ ɯ AD m d ʒ ɯ AD
yavuz	j AB a AD v u AF z
yazılmak	j AB a AD z ɯ AD l m a AD k
yazılmamak	j AB a AD z ɯ AD l m a AD m a AD c
yazılım	j AB a AD z ɯ AD l ɯ AD m
yazılımlar	j AB a AD z ɯ AD l ɯ AD m l a AD ɾ
yazılımları	j AB a AD z ɯ AD l ɯ AD m l a AD ɾ ɯ AD
yazılımı	j AB a AD z ɯ AD l ɯ AD m ɯ AD
yağ	j AB aː AE
yağlı	j AB a AD ɣ ɫ ɯ AD
yağmur	j AB a AD ɣ m u AF r
yağsız	j AB a AD ɣ s ɯ AD z
yaşam	j AB a AD ʃ a AD m
yaşında	j AB a AD ʃ ɯ AD n d a AD
ye	j AB e AD
yedi	j AB e AD d i AD
yedişer	j AB e AD d i AD ʃ æ AD r
yel	j AB ɛ AD l
yemenli	j AB ɛ AD m e AD n l i AD
yer	j AB e AD ɾ
yerim	j AB e AD ɾ i AD m
yerler	y AF e AD ɾ l e AD ɾ
yetkili	j AB e AD t k i AD l i AD
yetkililer	j AB e AD t k i AD l i AD l e AD ɾ
yetkiliyi	j AB e AD t k i AD l i AD j AB i AD
yetkisiz	j AB e AD t k i AD s i AD z
yeşil	j AB e AD ʃ i AD l
yiğit	j AB i AD ɰ AB i AD t
yok	j AB o AF k
yoksa	j AB o AF k s a AD
yoldaş	j AB o AF ɫ d ɑ AD ʃ
yorgun	j AB o AF ɾ ɡ u AF n
yosun	j AB o AF s u AF n
yoğurtlar	j AB o AF w AC u AF r t ɫ a AD r
yumruk	j AB u AF m ɾ u AF k
yumurta	j AB u AF m u AF ɾ t a AD
yumurtalar	j AB u AF m u AF ɾ t a AD l a AD ɾ
yumurtayı	j AB u AF m u AF ɾ t a AD j AB ɯ AD
yumuşak	j AB u AF m u AF ʃ a AD k
yumuşaklar	j AB u AF m u AF ʃ a AD k l a AD ɾ
yumuşakça	j AB u AF m u AF ʃ a AD k t ʃ a AD
yumuşakçalar	j AB u AF m u AF ʃ a AD k t ʃ a AD l a AD ɾ
yumuşakçayı	j AB u AF m u AF ʃ a AD k t ʃ a AD j AB ɯ AD
yumuşağı	j AB u AF m u AF ʃ a AD ɯ AD
yunus	j AB u AF n u AF s
yurtsever	j AB u AF ɾ t s e AD v e AD ɾ
yuva	j AB u AF v ɑ AD
yönelimli	j AB ø AF n e AD l i AD m l i AD
yönelimsiz	j AB ø AF n e AD l i AD m s i AD z
yıl	j AB ɯ AD ɫ
yılan	j AB ɯ AD ɫ ɑ AD n
yılanlar	j AB ɯ AD ɫ ɑ AD n ɫ ɑ AD ɾ
yılanı	j AB ɯ AD ɫ ɑ AD n ɯ AD
yıldırım	j AB ɯ AD ɫ d ɯ AD r ɯ AD m
zarflar	z a AD ɾ f l a AD ɾ
zarfı	z a AD ɾ f ɯ AD
zaten	z aː AE t e AD n
zemin	z e AD m i AD n
zenofobi	z e AD n o AF f o AF b i AD
ziraat	z i AD ɾ ä ä t
zona	z o AF n a AD
zorlu	z o AF ɾ ɫ u AF
zürafa	z y AF r aː AE f aː AE
ç	t ʃ
çakıl	t ʃ ɑ AD k ɯ AD ɫ
çakırkeyif	t ʃ a AD k ɯ AD r c e AD j AB i AD f
çalışkan	t ʃ ɑ AD ɫ ɯ AD ʃ k ɑ AD n
çam	t ʃ ɑ AD m
çanta	t ʃ a AD n t a AD
çar	t ʃ a AD ɾ
çarmıh	t ʃ a AD ɾ m ɯ AD h AA
çarşamba	t ʃ ɑ AD ɾ ʃ ɑ AD m b ɑ AD
çatal	t ʃ a AD t a AD l
çağ	t ʃ a AD ɰ AB
çağatay	t ʃ aː AE t a AD j AB
çağdaş	t ʃ a AD ɰ AB d a AD ʃ
çağırmak	t ʃ ɑː AE ɯ AD ɾ m ɑ AD k
çekçe	t ʃ ɛ AD k t ʃ ɛ AD
çemberi	t ʃ e AD m b e AD ɾ i AD
çemberler	t ʃ e AD m b e AD ɾ l e AD ɾ
çene	t ʃ e AD ŋ ɛ AD
çeri	t ʃ e AD ɾ i AD
çevirme	t ʃ ɛ AD v i AD ɾ m ɛ AD
çeşitli	t ʃ e AD s i AD t l i AD
çifte	t ʃ i AD f t e AD
çiftçi	t ʃ i AD f t t ʃ i AD
çimdik	t ʃ i AD m d i AD c
çimdikleme	t ʃ i AD m d i AD c l e AD m e AD
çimdiklemek	t ʃ i AD m d i AD c l e AD m e AD c
çimdiklememe	t ʃ i AD m d i AD c l e AD m e AD m e AD
çimdiklememek	t ʃ i AD m d i AD c l e AD m e AD m e AD c
çince	t ʃ i AD n d ʒ e AD
çingene	t ʃ i AD ŋ ɟ e AD n e AD
çivi	t ʃ ɪ AD v ɪ AD
çiçekçi	t ʃ i AD t ʃ e AD c t ʃ i AD
çiğdem	t ʃ iː AE d e AD m
çiş	t ʃ i AD ʃ
çocuklar	t ʃ o AF d ʒ u AF k l a AD ɾ
çokdilli	t ʃ o AF k d i AD l l i AD
çokdillilik	t ʃ o AF k d i AD l l i AD l i AD c
çokdillilikler	t ʃ o AF k d i AD l l i AD l i AD c l e AD ɾ
çokdilliliği	t ʃ o AF k d i AD l l i AD l i AD j AB i AD
çorba	t ʃ o AF ɾ b ɑ AD
çufçuf	t ʃ u AF f t ʃ u AF f
çuğ	t ʃ uː AG
çöl	t ʃ ø AF l
çörek	t ʃ ø AF ɾ e AD c
çünkü	t ʃ y AF n k y AF
çıkarmak	t ʃ ɯ AD k ɑ AD ɾ m ɑ AD k
çıkarmamak	d ʒ ɯ AD k a AD ɾ m a AD m a AD k
çıkarmaz	d ʒ ɯ AD k a AD ɾ m a AD z
çıkarır	d ʒ ɯ AD k a AD ɾ ɯ AD ɾ
çıkmak	t ʃ ɯ AD k m ɑ AD k
çığ	t ʃ ɯː AE
çığlık	t ʃ ɯ AD l ɯ AD c
çığlıklar	t ʃ ɯ AD l ɯ AD c l a AD ɾ
çığlığı	t ʃ ɯ AD l ɯ AD ɯ AD
öbür	ø AF b y AF ɾ
öl	ø AF l
ölüm	œ AF l ʏ AF m
ölümcül	ø AF l y AF m d ʒ y AF l
ömür	ø AF m y AF ɾ
önermek	ø AF n ɛ AD ɾ m ɛ AD c
öpücük	ø AF p y AF d ʒ y AF k
öpüşmek	œ AF p y AF ʃ m ɛ AD c
öykü	œ AF j AB k y AF
öyle	œ AF j AB l ɛ AD
özellik	ø AF z e AD lː i AD c
özellikle	ø AF z e AD lː i AD c l e AD
özgün	ø AF z ɡ y AF n
özil	ø AF z i AD l
özlem	ø AF z l e AD m
özne	ø AF z n e AD
özsüz	ø AF z s y AF z
öç	ø AF t ʃ
öğle	øː AG l e AD
öğreti	øː AG r e AD t i AD
öğütmek	œ AF ɰ AB y AF t m e AD c
ümit	y AF m i AD t
ün	y AF n
üretim	y AF ɾ e AD t i AD m
üssel	y AF s s e AD ɫ
üstel	y AF s t e AD ɫ
üye	y AF j AB e AD
üzere	y AF z e AD ɾ e AD
üzgün	y AF z ɡ y AF n
üzüm	y AF z y AF m
üzüntü	y AF z y AF n t y AF
üzüntüler	y AF z y AF n t y AF l e AD ɾ
üzüntüyü	y AF z y AF n t y AF j AB y AF
üçer	y AF t ʃ æ AD r
üçüncü	y AF t ʃ y AF n d ʒ y AF
ılık	ɯ AD ɫ ɯ AD k
ırk	ɯ AD ɾ k
ıstakoz	ɯ AD s t a AD k o AF z
ısı	ɯ AD s ɯ AD
şablon	ʃ a AD b ɫ o AF n
şahin	ʃ ɑː AE h AA ɪ AD n
şahsiyet	ʃ a AD h AA s i AD j AB e AD t
şahsî	ʃ a AD h AA s iː AE
şahsı	ʃ a AD h AA s ɯ AD
şahıs	ʃ a AD h AA ɯ AD s
şahıslar	ʃ a AD h AA ɯ AD s l a AD ɾ
şaka	ʃ a AD k a AD
şans	ʃ a AD n s
şanslar	ʃ a AD n s ɫ a AD ɾ
şansı	ʃ a AD n s ɯ AD
şarkı	ʃ a AD r k ɯ AD
şarkıcı	ʃ a AD ɾ k ɯ AD d ʒ ɯ AD
şebnem	ʃ ɛ AD b n ɛ AD m
şeftali	ʃ ɛ AD f t ɑː AE l i AD
şekerlemez	ʃ e AD c e AD ɾ l e AD m e AD z
şekerler	ʃ e AD c e AD ɾ l e AD ɾ
şerefe	ʃ e AD ɾ e AD f e AD
şerif	ʃ e AD ɾ i AD f
şifa	ʃ i AD f e AD
şifalı	ʃ i AD f e AD
şiirsel	ʃ iː AE ɾ s ɛ AD l
şikâyet	ʃ i AD c aː AE j AB ɛ AD t
şimdi	ʃ i AD m d i AD
şu	ʃ u AF
şut	ʃ uː AG t
şöyle	ʃ œ AF j AB l e AD
şükür	ʃ y AF c y AF r
şüphe	ʃ y AF p h AA ɛ AD
şımarık	ʃ ɯ AD m a AD ɾ ɯ AD k
