abantu	a BB ɓ BG aː BB n AG t AK u BC
amabele	a BB m AF a BB ɓ BG eː BB l AE e BB
amabhanqa	a BB m AF a BB b AH aː BB ǃ a BB
amafutha	a BB m AF a BB f BF uː BC tʰ AL a BB
amagcino	a BB m AF a BB ǀʱ iː BB n AG o BC
amahlebezi	a BB m AF a BB ɬ BI e BB ɓ BG eː BB z AJ i BB
amahloni	a BB m AF a BB ɬ BI oː BC n AG i BB
amakha	a BB m AF aː BB kʰ AD a BB
amakhaza	a BB m AF a BB kʰ AD aː BB z AJ a BB
amakhosi	a BB m AF a BB kʰ AD oː BC s AJ i BB
amakhwezikhwezi	a BB m AF a BB kʰ AD w AM e BB z AJ i BB kʰ AD w AM eː BB z AJ i BB
amala	a BB m AF aː BB l AE a BB
amandla	a BB m AF aː BB n AG ɮ BI a BB
amanga	a BB m AF aː BB n AG ɡ AC a BB
amanqamu	a BB m AF a BB ǃ aː BB m AF u BC
amanyala	a BB m AF a BB ɲ AG aː BB l AE a BB
amanzi	a BB m AF aː BB n AG z AJ i BB
amatata	a BB m AF a BB t AK aː BB t AK a BB
amathe	a BB m AF aː BB tʰ AL e BB
ayina	ʔ BA a BB j AB iː BB n AG a BB
bana	ɓ BG aː BB n AG a BB
bayede	ɓ BG a BB j AB eː BB d AK e BB
be	ɓ BG e BB
bona	ɓ BG oː BC n AG a BB
buhlungu	ɓ BG u BC ɬ BI uː BC n AG ɡ AC u BC
c	ǀ
cha	ǀʰ a BB
cishe	ǀ iː BB ʃ AJ e BB
cwala	ǀ w AM aː BB l AE a BB
cwecwa	ǀ w AM eː BB ǀ w AM a BB
cwila	ǀ w AM iː BB l AE a BB
cwilisa	ǀ w AM i BB l AE iː BB s AJ a BB
dabuka	d AK a BB ɓ BG uː BC ɠ BJ a BB
dana	d AK aː BB n AG a BB
dla	ɮ BI a BB
dlala	ɮ BI aː BB l AE a BB
dlwengula	ɮ BI w AM e BB n AG ɡ AC uː BC l AE a BB
duma	d AK uː BC m AF a BB
dwa	d AK w AM a BB
ebula	e BB ɓ BG uː BC l AE a BB
ebuza	e BB ɓ BG uː BC z AJ a BB
eluka	e BB l AE uː BC ɠ BJ a BB
engeza	e BB n AG ɡ AC eː BB z AJ a BB
ethwasa	e BB tʰ AL w AM aː BB s AJ a BB
fa	f BF a BB
funa	f BF uː BC n AG a BB
futhi	f BF uː BC tʰ AL i BB
fuya	f BF uː BC j AB a BB
gaya	ɡ AC aː BB j AB a BB
gcoba	ǀʱ oː BC ɓ BG a BB
gcwalisa	ǀʱ w AM a BB l AE iː BB s AJ a BB
gqagqa	ǃʱ aː BB ǃʱ a BB
gqagqaza	ǃʱ a BB ǃʱ aː BB z AJ a BB
gqaja	ǃʱ aː BB d AK ʒ AJ a BB
gqama	ǃʱ aː BB m AF a BB
gqamuka	ǃʱ a BB m AF uː BC ɠ BJ a BB
gqekeza	ǃʱ e BB ɠ BJ eː BB z AJ a BB
gqola	ǃʱ oː BC l AE a BB
gqula	ǃʱ uː BC l AE a BB
gqwala	ǃʱ w AM aː BB l AE a BB
gwansa	ɡ AC w AM aː BB n AG s AJ a BB
gwavuma	ɡ AC w AM a BB v BF uː BC m AF a BB
gwaza	ɡ AC w AM aː BB z AJ a BB
gwedla	ɡ AC w AM eː BB ɮ BI a BB
gwema	ɡ AC w AM eː BB m AF a BB
gwinqa	ɡ AC w AM iː BB ǃ a BB
gwinya	ɡ AC w AM iː BB ɲ AG a BB
gxeka	ǁʱ eː BB ɠ BJ a BB
gxila	ǁʱ iː BB l AE a BB
hamba kahle	h AA a BB m AF b AH a BB ɠ BJ aː BB ɬ BI e BB
hambani kahle	h AA a BB m AF b AH a BB n AG i BB ɠ BJ aː BB ɬ BI e BB
hawu	h AA aː BB w AM u BC
hlafuna	ɬ BI a BB f BF uː BC n AG a BB
hleka	ɬ BI eː BB ɠ BJ a BB
hleze	ɬ BI eː BB z AJ e BB
hlikihla	ɬ BI i BB ɠ BJ iː BB ɬ BI a BB
hlobonga	ɬ BI o BC ɓ BG oː BC n AG ɡ AC a BB
hlonipha	ɬ BI o BC n AG iː BB pʰ AI a BB
ibala	iː BB ɓ BG aː BB l AE a BB
ibandla	i BB ɓ BG aː BB n AG ɮ BI a BB
ibele	iː BB ɓ BG eː BB l AE e BB
ibhaka	iː BB b AH aː BB ɠ BJ a BB
ibhakede	iː BB b AH a BB ɠ BJ eː BB d AK e BB
ibhala	iː BB b AH aː BB l AE a BB
ibhanoyi	iː BB b AH a BB n AG oː BC j AB i BB
ibhantshi	iː BB b AH aː BB ɲ AG t AK ʃ AJ i BB
ibhasi	iː BB b AH aː BB s AJ i BB
ibhayibheli	iː BB b AH a BB j AB i BB b AH eː BB l AE i BB
ibhayisikili	iː BB b AH a BB j AB i BB s AJ i BB k AC iː BB l AE i BB
ibhayisikobho	iː BB b AH a BB j AB i BB s AJ i BB k AC oː BC b AH o BC
ibhaza	iː BB b AH a BB z AJ aː BB
ibhentshi	iː BB b AH eː BB ɲ AG t AK ʃ AJ i BB
ibhimbi	iː BB b AH iː BB m AF b AH i BB
ibhodlela	iː BB b AH o BC ɮ BI eː BB l AE a BB
ibhodlo	iː BB b AH oː BC ɮ BI o BC
ibhodwe	iː BB b AH oː BC d AK w AM e BB
ibhokisi	iː BB b AH o BC ɠ BJ iː BB s AJ i BB
ibhola	iː BB b AH oː BC l AE a BB
ibhomu	iː BB b AH oː BC m AF u BC
ibhotela	iː BB b AH o BC t AK eː BB l AE a BB
ibhubesi	iː BB b AH u BC ɓ BG eː BB s AJ i BB
ibhudla	iː BB b AH uː BC ɮ BI a BB
ibhuku	iː BB b AH uː BC ɠ BJ u BC
ibhulakufesi	iː BB b AH u BC l AE a BB ɠ BJ u BC f BF eː BB s AJ i BB
ibhulashi	iː BB b AH u BC l AE aː BB ʃ AJ i BB
ibhuleki	iː BB b AH u BC l AE eː BB ɠ BJ i BB
ibhulukwe	iː BB b AH u BC l AE uː BC ɠ BJ w AM e BB
ibhungane	iː BB b AH u BC n AG ɡ AC aː BB n AG e BB
ibhunu	iː BB b AH uː BC n AG u BC
ibizo	iː BB ɓ BG iː BB z AJ o BC
ibomvu	iː BB ɓ BG oː BC m AF v BF u BC
ibululu	iː BB ɓ BG u BC l AE uː BC l AE u BC
ibumba	iː BB ɓ BG uː BC m AF b AH a BB
ibunzi	iː BB ɓ BG uː BC n AG z AJ i BB
icebo	iː BB ǀ eː BB ɓ BG o BC
icele	iː BB ǀ eː BB l AE e BB
ichibi	iː BB ǀʰ iː BB ɓ BG i BB
ichopho	iː BB ǀʰ oː BC pʰ AI o BC
ichwane	iː BB ǀʰ w AM aː BB n AG e BB
icici	iː BB ǀ iː BB ǀ i BB
icilongo	iː BB ǀ i BB l AE oː BC n AG ɡ AC o BC
icukazi	iː BB ǀ u BC ɠ BJ aː BB z AJ i BB
iculo	iː BB ǀ uː BC l AE o BC
idada	iː BB d AK aː BB d AK a BB
idesiki	iː BB d AK e BB s AJ iː BB ɠ BJ i BB
idikazi	iː BB d AK i BB ɠ BJ aː BB z AJ i BB
idimoni	iː BB d AK i BB m AF oː BC n AG i BB
idlaka	iː BB ɮ BI aː BB ɠ BJ a BB
idlozi	iː BB ɮ BI oː BC z AJ i BB
idolo	iː BB d AK oː BC l AE o BC
idolobha	iː BB d AK o BC l AE oː BC b AH a BB
idube	iː BB d AK uː BC ɓ BG e BB
iduku	iː BB d AK uː BC ɠ BJ u BC
idwala	iː BB d AK w AM aː BB l AE a BB
idweshu	iː BB d AK w AM eː BB ʃ AJ u BC
ifa	iː BB f BF a BB
ifilimu	iː BB f BF i BB l AE iː BB m AF u BC
ifleyistata	i BB f BF l AE e BB j AB i BB s AJ t AK aː BB t AK a BB
ifosholo	iː BB f BF o BC ʃ AJ oː BC l AE o BC
ifotho	iː BB f BF oː BC tʰ AL o BC
ifu	iː BB f BF u BC
ifulentshi	iː BB f BF u BC l AE eː BB ɲ AG t AK ʃ AJ i BB
igagasi	iː BB ɡ AC a BB ɡ AC aː BB s AJ i BB
igalaji	iː BB ɡ AC a BB l AE aː BB d AK ʒ AJ i BB
igalofu	iː BB ɡ AC a BB l AE oː BC f BF u BC
igama	iː BB ɡ AC aː BB m AF a BB
iganu	iː BB ɡ AC aː BB n AG u BC
igazi	iː BB ɡ AC aː BB z AJ i BB
igceke	iː BB ǀʱ eː BB ɠ BJ e BB
igciwane	iː BB ǀʱ i BB w AM aː BB n AG e BB
igcukumuva	iː BB ǀʱ u BC ɠ BJ u BC m AF uː BC v BF a BB
igedlela	iː BB ɡ AC e BB ɮ BI eː BB l AE a BB
igeja	iː BB ɡ AC eː BB d AK ʒ AJ a BB
igeza	iː BB ɡ AC eː BB z AJ a BB
igilavu	iː BB ɡ AC i BB l AE aː BB v BF u BC
igilebhisi	iː BB ɡ AC i BB l AE e BB b AH iː BB s AJ i BB
igobongo	iː BB ɡ AC o BC ɓ BG oː BC n AG ɡ AC o BC
igola	iː BB ɡ AC oː BC l AE a BB
igoli	iː BB ɡ AC oː BC l AE i BB
igolide	iː BB ɡ AC o BC l AE iː BB d AK e BB
igoqo	iː BB ɡ AC oː BC ǃ o BC
igqubu	iː BB ǃʱ uː BC ɓ BG u BC
igquma	iː BB ǃʱ uː BC m AF a BB
igqwetha	iː BB ǃʱ w AM eː BB tʰ AL a BB
igugu	iː BB ɡ AC uː BC ɡ AC u BC
igula	iː BB ɡ AC uː BC l AE a BB
igumbi	iː BB ɡ AC uː BC m AF b AH i BB
igundane	iː BB ɡ AC u BC n AG d AK aː BB n AG e BB
igundwane	iː BB ɡ AC u BC n AG d AK w AM aː BB n AG e BB
igwababa	iː BB ɡ AC w AM a BB ɓ BG aː BB ɓ BG a BB
igwala	iː BB ɡ AC w AM aː BB l AE a BB
igwebu	iː BB ɡ AC w AM eː BB ɓ BG u BC
igwenya	iː BB ɡ AC w AM eː BB ɲ AG a BB
igwinya	iː BB ɡ AC w AM iː BB ɲ AG a BB
igxolo	iː BB ǁʱ oː BC l AE o BC
ihansi	iː BB h AA aː BB n AG s AJ i BB
ihawa	iː BB h AA aː BB w AM a BB
ihembe	iː BB h AA eː BB m AF b AH e BB
ihhala	iː BB ɦ AA aː BB l AE a BB
ihhashi	iː BB ɦ AA aː BB ʃ AJ i BB
ihhofu	iː BB ɦ AA oː BC f BF u BC
ihholo	iː BB ɦ AA oː BC l AE o BC
ihhotela	iː BB ɦ AA o BC t AK eː BB l AE a BB
ihhovisi	iː BB ɦ AA o BC v BF iː BB s AJ i BB
ihlahla	iː BB ɬ BI aː BB ɬ BI a BB
ihlakani	iː BB ɬ BI a BB ɠ BJ aː BB n AG i BB
ihlathi	iː BB ɬ BI aː BB tʰ AL i BB
ihlaya	iː BB ɬ BI aː BB j AB a BB
ihlelo	iː BB ɬ BI eː BB l AE o BC
ihlezi	iː BB ɬ BI eː BB z AJ i BB
ihlo	iː BB ɬ BI o BC
ihlobo	iː BB ɬ BI oː BC ɓ BG o BC
ihlombe	iː BB ɬ BI oː BC m AF b AH e BB
ihlumela	iː BB ɬ BI u BC m AF eː BB l AE a BB
iholide	iː BB h AA o BC l AE iː BB d AK e BB
ihora	iː BB h AA oː BC r BD a BB
ihubo	iː BB h AA uː BC ɓ BG o BC
ijaji	iː BB d AK ʒ AJ aː BB d AK ʒ AJ i BB
ijazi	iː BB d AK ʒ AJ aː BB z AJ i BB
ijele	iː BB d AK ʒ AJ eː BB l AE e BB
ijezi	iː BB d AK ʒ AJ eː BB z AJ i BB
ijokwe	iː BB d AK ʒ AJ oː BC ɠ BJ w AM e BB
ijongosi	iː BB d AK ʒ AJ o BC n AG ɡ AC oː BC s AJ i BB
ijuba	iː BB d AK ʒ AJ uː BC ɓ BG a BB
ijubane	iː BB d AK ʒ AJ u BC ɓ BG aː BB n AG e BB
ikalikuni	iː BB k AC a BB l AE i BB k AC uː BC n AG i BB
ikamela	iː BB k AC a BB m AF eː BB l AE a BB
ikati	iː BB k AC aː BB t AK i BB
ikatshana	iː BB k AC a BB t AK ʃ AJ aː BB n AG a BB
ikesi	iː BB k AC eː BB s AJ i BB
ikewu	iː BB k AC eː BB w AM u BC
ikhabe	iː BB kʰ AD aː BB ɓ BG e BB
ikhabethe	iː BB kʰ AD a BB ɓ BG eː BB tʰ AL e BB
ikhala	iː BB kʰ AD aː BB l AE a BB
ikhalenda	iː BB kʰ AD a BB l AE eː BB n AG d AK a BB
ikhanda	iː BB kʰ AD aː BB n AG d AK a BB
ikhanjana	iː BB kʰ AD a BB ɲ AG d AK ʒ AJ aː BB n AG a BB
ikhanzi	iː BB kʰ AD aː BB n AG z AJ i BB
ikhaphethe	iː BB kʰ AD a BB pʰ AI eː BB tʰ AL e BB
ikhasi	iː BB kʰ AD aː BB s AJ i BB
ikhasimende	iː BB kʰ AD a BB s AJ i BB m AF eː BB n AG d AK e BB
ikhaya	iː BB kʰ AD aː BB j AB a BB
ikhefu	iː BB kʰ AD eː BB f BF u BC
ikhehla	iː BB kʰ AD eː BB ɬ BI a BB
ikheji	iː BB kʰ AD eː BB d AK ʒ AJ i BB
ikhekhe	iː BB kʰ AD eː BB kʰ AD e BB
ikhekheba	iː BB kʰ AD e BB kʰ AD eː BB ɓ BG a BB
ikheli	iː BB kʰ AD eː BB l AE i BB
ikhemese	iː BB kʰ AD e BB m AF eː BB s AJ e BB
ikhethini	iː BB kʰ AD e BB tʰ AL iː BB n AG i BB
ikhishi	iː BB kʰ AD iː BB ʃ AJ i BB
ikholwase	iː BB kʰ AD o BC l AE w AM aː BB s AJ e BB
ikhonsathi	iː BB kʰ AD o BC n AG s AJ aː BB tʰ AL i BB
ikhukhamba	iː BB kʰ AD u BC kʰ AD aː BB m AF b AH a BB
ikhukhu	iː BB kʰ AD uː BC kʰ AD u BC
ikhulu	iː BB kʰ AD uː BC l AE u BC
ikhwapha	iː BB kʰ AD w AM aː BB pʰ AI a BB
ikhweza	iː BB kʰ AD w AM eː BB z AJ a BB
ikhwezi	iː BB kʰ AD w AM eː BB z AJ i BB
ikhwilithi	iː BB kʰ AD w AM i BB l AE iː BB tʰ AL i BB
ikilasi	iː BB k AC i BB l AE aː BB s AJ i BB
ikilogo	iː BB k AC i BB l AE oː BC ɡ AC o BC
iklabishi	iː BB k AC x BE a BB ɓ BG iː BB ʃ AJ i BB
iklwa	iː BB k AC x BE w AM a BB
ilahle	iː BB l AE aː BB ɬ BI e BB
ilanga	iː BB l AE aː BB n AG ɡ AC a BB
ilantshi	iː BB l AE aː BB ɲ AG t AK ʃ AJ i BB
ilayisense	iː BB l AE a BB j AB i BB s AJ eː BB n AG s AJ e BB
ilayisi	iː BB l AE a BB j AB iː BB s AJ i BB
ilembe	iː BB l AE eː BB m AF b AH e BB
ilisho	iː BB l AE iː BB ʃ AJ o BC
ilobolo	iː BB l AE o BC ɓ BG oː BC l AE o BC
ilokhuzane	i BB l AE o BC kʰ AD u BC z AJ aː BB n AG e BB
ilokwe	iː BB l AE oː BC ɠ BJ w AM e BB
iloli	iː BB l AE oː BC l AE i BB
ilulwane	iː BB l AE u BC l AE w AM aː BB n AG e BB
ilungelo	iː BB l AE u BC n AG ɡ AC eː BB l AE o BC
imadlana	i BB m AF a BB ɮ BI aː BB n AG a BB
imali	i BB m AF aː BB l AE i BB
imamba	i BB m AF aː BB m AF b AH a BB
imayela	iː BB m AF a BB j AB eː BB l AE a BB
imbabala	i BB m AF b AH a BB ɓ BG aː BB l AE a BB
imbala	i BB m AF b AH aː BB l AE a BB
imbali	i BB m AF b AH aː BB l AE i BB
imbambe	i BB m AF b AH aː BB m AF b AH e BB
imbasa	i BB m AF b AH aː BB s AJ a BB
imbazo	i BB m AF b AH aː BB z AJ o BC
imbenge	i BB m AF b AH eː BB n AG ɡ AC e BB
imbewu	i BB m AF b AH eː BB w AM u BC
imbila	i BB m AF b AH iː BB l AE a BB
imbiza	i BB m AF b AH iː BB z AJ a BB
imbizo	i BB m AF b AH iː BB z AJ o BC
imbodla	i BB m AF b AH oː BC ɮ BI a BB
imbongi	i BB m AF b AH oː BC n AG ɡ AC i BB
imbongolo	i BB m AF b AH o BC n AG ɡ AC oː BC l AE o BC
imboni	i BB m AF b AH oː BC n AG i BB
imbovane	i BB m AF b AH o BC v BF aː BB n AG e BB
imbube	i BB m AF b AH uː BC ɓ BG e BB
imbungulu	i BB m AF b AH u BC n AG ɡ AC uː BC l AE u BC
imbuya	i BB m AF b AH uː BC j AB a BB
imbuzana	i BB m AF b AH u BC z AJ aː BB n AG a BB
imbuzane	i BB m AF b AH u BC z AJ aː BB n AG e BB
imbuzi	i BB m AF b AH uː BC z AJ i BB
imbuzikazi	i BB m AF b AH u BC z AJ i BB ɠ BJ aː BB z AJ i BB
imelika	iː BB m AF e BB l AE iː BB ɠ BJ a BB
imfene	i BB m AF f BF eː BB n AG e BB
imfihlo	i BB m AF f BF iː BB ɬ BI o BC
imfologo	i BB m AF f BF o BC l AE oː BC ɡ AC o BC
imfoloko	i BB m AF f BF o BC l AE oː BC ɠ BJ o BC
imfolozi	i BB m AF f BF o BC l AE oː BC z AJ i BB
imfuluwenza	i BB m AF f BF u BC l AE u BC w AM eː BB n AG z AJ a BB
imini	i BB m AF iː BB n AG i BB
iminithi	iː BB m AF i BB n AG iː BB tʰ AL i BB
imoto	i BB m AF oː BC t AK o BC
impahla	i BB m AF p AH aː BB ɬ BI a BB
impakama	i BB m AF p AH a BB ɠ BJ aː BB m AF a BB
impakathi	i BB m AF p AH a BB ɠ BJ aː BB tʰ AL i BB
impala	i BB m AF p AH aː BB l AE a BB
impalampala	i BB m AF p AH a BB l AE a BB m AF p AH aː BB l AE a BB
impambosi	i BB m AF p AH a BB m AF b AH oː BC s AJ i BB
impande	i BB m AF p AH aː BB n AG d AK e BB
impangele	i BB m AF p AH a BB n AG ɡ AC eː BB l AE e BB
impela	i BB m AF p AH eː BB l AE a BB
impelesi	i BB m AF p AH e BB l AE eː BB s AJ i BB
impempe	i BB m AF p AH eː BB m AF p AH e BB
impendulo	i BB m AF p AH e BB n AG d AK uː BC l AE o BC
impi	iː BB m AF p AH i BB
impilo	i BB m AF p AH iː BB l AE o BC
impisi	i BB m AF p AH iː BB s AJ i BB
impofu	i BB m AF p AH oː BC f BF u BC
impohlo	i BB m AF p AH oː BC ɬ BI o BC
impongo	i BB m AF p AH oː BC n AG ɡ AC o BC
impophoma	i BB m AF p AH o BC pʰ AI oː BC m AF a BB
impoqo	i BB m AF p AH oː BC ǃ o BC
impuco	i BB m AF p AH uː BC ǀ o BC
impukane	i BB m AF p AH u BC ɠ BJ aː BB n AG e BB
impumalanga	i BB m AF p AH u BC m AF a BB l AE aː BB n AG ɡ AC a BB
impumulo	i BB m AF p AH u BC m AF uː BC l AE o BC
impungushe	i BB m AF p AH u BC n AG ɡ AC uː BC ʃ AJ e BB
impunzi	i BB m AF p AH uː BC n AG z AJ i BB
impuphu	i BB m AF p AH uː BC pʰ AI u BC
impusela	i BB m AF p AH u BC s AJ eː BB l AE a BB
imvama	i BB m AF v BF aː BB m AF a BB
imvamisa	i BB m AF v BF a BB m AF iː BB s AJ a BB
imvana	i BB m AF v BF aː BB n AG a BB
imvelo	i BB m AF v BF eː BB l AE o BC
imvemvane	i BB m AF v BF e BB m AF v BF aː BB n AG e BB
imvu	iː BB m AF v BF u BC
imvubu	i BB m AF v BF uː BC ɓ BG u BC
imvukazi	i BB m AF v BF u BC ɠ BJ aː BB z AJ i BB
imvukusi	i BB m AF v BF u BC ɠ BJ uː BC s AJ i BB
imvula	i BB m AF v BF uː BC l AE a BB
imvumo	i BB m AF v BF uː BC m AF o BC
inalithi	iː BB n AG a BB l AE iː BB tʰ AL i BB
incazo	i BB ǀ aː BB z AJ o BC
inceku	i BB ǀ eː BB ɠ BJ u BC
incingo	i BB ǀ iː BB n AG ɡ AC o BC
incombo	i BB ǀ oː BC m AF b AH o BC
incuncu	i BB ǀ uː BC ǀ u BC
incwadi	i BB ǀ w AM aː BB d AK i BB
incwancwa	i BB ǀ w AM aː BB ǀ w AM a BB
incwincwi	i BB ǀ w AM iː BB ǀ w AM i BB
indaba	i BB n AG d AK aː BB ɓ BG a BB
indabushe	i BB n AG d AK a BB ɓ BG uː BC ʃ AJ e BB
indandatho	i BB n AG d AK a BB n AG d AK aː BB tʰ AL o BC
indawo	i BB n AG d AK aː BB w AM o BC
indebe	i BB n AG d AK eː BB ɓ BG e BB
indima	i BB n AG d AK iː BB m AF a BB
indingilizi	i BB n AG d AK i BB n AG ɡ AC i BB l AE iː BB z AJ i BB
indishi	i BB n AG d AK iː BB ʃ AJ i BB
indlala	i BB n AG ɮ BI aː BB l AE a BB
indlalifa	i BB n AG ɮ BI a BB l AE iː BB f BF a BB
indlamini	i BB n AG ɮ BI a BB m AF iː BB n AG i BB
indlamu	i BB n AG ɮ BI aː BB m AF u BC
indlazi	i BB n AG ɮ BI aː BB z AJ i BB
indle	iː BB n AG ɮ BI e BB
indlebe	i BB n AG ɮ BI eː BB ɓ BG e BB
indleko	i BB n AG ɮ BI eː BB ɠ BJ o BC
indlela	i BB n AG ɮ BI eː BB l AE a BB
indlobho	i BB n AG ɮ BI oː BC b AH o BC
indlondlo	i BB n AG ɮ BI oː BC n AG ɮ BI o BC
indlovu	i BB n AG ɮ BI oː BC v BF u BC
indlovukazi	i BB n AG ɮ BI o BC v BF u BC ɠ BJ aː BB z AJ i BB
indlozi	i BB n AG ɮ BI oː BC z AJ i BB
indlu	iː BB n AG ɮ BI u BC
indlulamithi	i BB n AG ɮ BI u BC l AE a BB m AF iː BB tʰ AL i BB
indlwana	i BB n AG ɮ BI w AM aː BB n AG a BB
indoda	i BB n AG d AK oː BC d AK a BB
indodakazi	i BB n AG d AK o BC d AK a BB ɠ BJ aː BB z AJ i BB
indodana	i BB n AG d AK o BC d AK aː BB n AG a BB
induku	i BB n AG d AK uː BC ɠ BJ u BC
induna	i BB n AG d AK uː BC n AG a BB
indwandwe	i BB n AG d AK w AM aː BB n AG d AK w AM e BB
indwangu	i BB n AG d AK w AM aː BB n AG ɡ AC u BC
inenevana	i BB n AG e BB n AG e BB v BF aː BB n AG a BB
inenevu	i BB n AG e BB n AG eː BB v BF u BC
ingadi	i BB n AG ɡ AC aː BB d AK i BB
ingalangala	i BB n AG ɡ AC a BB l AE a BB n AG ɡ AC aː BB l AE a BB
ingalo	i BB n AG ɡ AC aː BB l AE o BC
ingane	i BB n AG ɡ AC aː BB n AG e BB
inganeko	i BB n AG ɡ AC a BB n AG eː BB ɠ BJ o BC
inganekwane	i BB n AG ɡ AC a BB n AG e BB ɠ BJ w AM aː BB n AG e BB
ingcanga	i BB ǀʱ aː BB n AG ɡ AC a BB
ingcebo	i BB ǀʱ eː BB ɓ BG o BC
ingcosa	i BB ǀʱ oː BC s AJ a BB
ingcwaba	iː BB ǀʱ w AM aː BB ɓ BG a BB
ingcwali	i BB ǀʱ w AM aː BB l AE i BB
ingcweti	i BB ǀʱ w AM eː BB t AK i BB
ingebe	i BB n AG ɡ AC eː BB ɓ BG e BB
ingede	i BB n AG ɡ AC eː BB d AK e BB
ingisi	iː BB n AG ɡ AC iː BB s AJ i BB
ingobe	iː BB n AG ɡ AC oː BC ɓ BG e BB
ingoma	i BB n AG ɡ AC oː BC m AF a BB
ingonyama	i BB n AG ɡ AC o BC ɲ AG aː BB m AF a BB
ingoqokazi	i BB n AG ɡ AC o BC ǃ o BC ɠ BJ aː BB z AJ i BB
ingozi	i BB n AG ɡ AC oː BC z AJ i BB
ingqalasizinda	i BB ǃʱ a BB l AE a BB s AJ i BB z AJ iː BB n AG d AK a BB
ingqofa	i BB ǃʱ oː BC f BF a BB
ingqomfi	i BB ǃʱ oː BC m AF f BF i BB
ingqondo	i BB ǃʱ oː BC n AG d AK o BC
ingqumbi	i BB ǃʱ uː BC m AF b AH i BB
ingqunge	i BB ǃʱ uː BC n AG ɡ AC e BB
ingquza	i BB ǃʱ uː BC z AJ a BB
ingubo	i BB n AG ɡ AC uː BC ɓ BG o BC
ingulube	i BB n AG ɡ AC u BC l AE uː BC ɓ BG e BB
ingulule	i BB n AG ɡ AC u BC l AE uː BC l AE e BB
ingungumbane	i BB n AG ɡ AC u BC n AG ɡ AC u BC m AF b AH aː BB n AG e BB
ingwane	i BB n AG ɡ AC w AM aː BB n AG e BB
ingwe	iː BB n AG ɡ AC w AM e BB
ingwedli	i BB n AG ɡ AC w AM eː BB ɮ BI i BB
ingwenya	i BB n AG ɡ AC w AM eː BB ɲ AG a BB
ingxabano	i BB ǁʱ a BB ɓ BG aː BB n AG o BC
ingxenye	i BB ǁʱ eː BB ɲ AG e BB
ingxi	iː BB ǁʱ i BB
ingxobongo	i BB ǁʱ o BC ɓ BG oː BC n AG ɡ AC o BC
ingxotha	i BB ǁʱ oː BC tʰ AL a BB
ingxoxo	i BB ǁʱ oː BC ǁ o BC
ingxubevange	i BB ǁʱ u BC ɓ BG e BB v BF aː BB n AG ɡ AC e BB
inhlaba	i BB n AG ɬ BI aː BB ɓ BG a BB
inhlabathi	i BB n AG ɬ BI a BB ɓ BG aː BB tʰ AL i BB
inhlahla	i BB n AG ɬ BI aː BB ɬ BI a BB
inhlaka	i BB n AG ɬ BI aː BB ɠ BJ a BB
inhlakanipho	i BB n AG ɬ BI a BB ɠ BJ a BB n AG iː BB pʰ AI o BC
inhlalakahle	i BB n AG ɬ BI a BB l AE a BB ɠ BJ aː BB ɬ BI e BB
inhlalo	i BB n AG ɬ BI aː BB l AE o BC
inhlamvu	i BB n AG ɬ BI aː BB m AF v BF u BC
inhlamvukazi	i BB n AG ɬ BI a BB m AF v BF u BC ɠ BJ aː BB z AJ i BB
inhlangano	i BB n AG ɬ BI a BB n AG ɡ AC aː BB n AG o BC
inhlanhla	i BB n AG ɬ BI aː BB n AG ɬ BI a BB
inhlansi	i BB n AG ɬ BI aː BB n AG s AJ i BB
inhlanzi	i BB n AG ɬ BI aː BB n AG z AJ i BB
inhlaziyo	i BB n AG ɬ BI a BB z AJ iː BB j AB o BC
inhlekisa	i BB n AG ɬ BI e BB ɠ BJ iː BB s AJ a BB
inhlelo	i BB n AG ɬ BI eː BB l AE o BC
inhliziyo	i BB n AG ɬ BI i BB z AJ iː BB j AB o BC
inhlobo	i BB n AG ɬ BI oː BC ɓ BG o BC
inhloko	i BB n AG ɬ BI oː BC ɠ BJ o BC
inhloso	i BB n AG ɬ BI oː BC s AJ o BC
inhlwathi	i BB n AG ɬ BI w AM aː BB tʰ AL i BB
iningi	iː BB n AG iː BB n AG ɡ AC i BB
iningizimu	i BB n AG i BB n AG ɡ AC i BB z AJ iː BB m AF u BC
inja	iː BB ɲ AG d AK ʒ AJ a BB
injemane	i BB ɲ AG d AK ʒ AJ e BB m AF aː BB n AG e BB
injingwenikazi	i BB ɲ AG d AK ʒ AJ i BB n AG ɡ AC w AM e BB n AG i BB ɠ BJ aː BB z AJ i BB
injobo	i BB ɲ AG d AK ʒ AJ oː BC ɓ BG o BC
injolikazi	i BB ɲ AG d AK ʒ AJ o BC l AE i BB ɠ BJ aː BB z AJ i BB
injongo	i BB ɲ AG d AK ʒ AJ oː BC n AG ɡ AC o BC
injula	i BB ɲ AG d AK ʒ AJ uː BC l AE a BB
inkabi	i BB n AG k AC aː BB ɓ BG i BB
inkala	i BB n AG k AC aː BB l AE a BB
inkambo	i BB n AG k AC aː BB m AF b AH o BC
inkampane	i BB n AG k AC a BB m AF p AH aː BB n AG e BB
inkanyezi	i BB n AG k AC a BB ɲ AG eː BB z AJ i BB
inkathazo	i BB n AG k AC a BB tʰ AL aː BB z AJ o BC
inkathi	i BB n AG k AC aː BB tʰ AL i BB
inkawu	i BB n AG k AC aː BB w AM u BC
inkehlo	i BB n AG k AC eː BB ɬ BI o BC
inkinga	i BB n AG k AC iː BB n AG ɡ AC a BB
inkohlisa	i BB n AG k AC o BC ɬ BI iː BB s AJ a BB
inkomba	i BB n AG k AC oː BC m AF b AH a BB
inkomo	i BB n AG k AC oː BC m AF o BC
inkontileka	i BB n AG k AC o BC n AG t AK i BB l AE eː BB ɠ BJ a BB
inkosana	i BB n AG k AC o BC s AJ aː BB n AG a BB
inkosazana	i BB n AG k AC o BC s AJ a BB z AJ aː BB n AG a BB
inkosi	i BB n AG k AC oː BC s AJ i BB
inkosikazi	i BB n AG k AC o BC s AJ i BB ɠ BJ aː BB z AJ i BB
inkotha	i BB n AG k AC oː BC tʰ AL a BB
inkuba	i BB n AG k AC uː BC ɓ BG a BB
inkukhu	i BB n AG k AC uː BC kʰ AD u BC
inkululeko	i BB n AG k AC u BC l AE u BC l AE eː BB ɠ BJ o BC
inkulungwane	i BB n AG k AC u BC l AE u BC n AG ɡ AC w AM aː BB n AG e BB
inkumbulo	i BB n AG k AC u BC m AF b AH uː BC l AE o BC
inkundla	i BB n AG k AC uː BC n AG ɮ BI a BB
inkungu	i BB n AG k AC uː BC n AG ɡ AC u BC
inkunzana	i BB n AG k AC u BC n AG z AJ aː BB n AG a BB
inkunzi	i BB n AG k AC uː BC n AG z AJ i BB
inkwazi	i BB n AG k AC w AM aː BB z AJ i BB
inkwindi	i BB n AG k AC w AM iː BB n AG d AK i BB
inqaba	i BB ǃ aː BB ɓ BG a BB
inqama	i BB ǃ aː BB m AF a BB
inqe	iː BB ǃ e BB
inqina	i BB ǃ iː BB n AG a BB
inqindi	i BB ǃ iː BB n AG d AK i BB
inqola	i BB ǃ oː BC l AE a BB
inqolobana	i BB ǃ o BC l AE o BC ɓ BG aː BB n AG a BB
inqolobane	i BB ǃ o BC l AE o BC ɓ BG aː BB n AG e BB
inqulu	i BB ǃ uː BC l AE u BC
inqumba	i BB ǃ uː BC m AF b AH a BB
inqwaba	i BB ǃ w AM aː BB ɓ BG a BB
insangu	i BB n AG s AJ aː BB n AG ɡ AC u BC
insele	i BB n AG s AJ eː BB l AE e BB
insephe	i BB n AG s AJ eː BB pʰ AI e BB
insimba	i BB n AG s AJ iː BB m AF b AH a BB
insimbi	i BB n AG s AJ iː BB m AF b AH i BB
insimu	i BB n AG s AJ iː BB m AF u BC
insipho	i BB n AG s AJ iː BB pʰ AI o BC
insizwa	i BB n AG s AJ iː BB z AJ w AM a BB
inso	iː BB n AG s AJ o BC
insundu	i BB n AG s AJ uː BC n AG d AK u BC
inswelakalo	i BB n AG s AJ w AM e BB l AE a BB ɠ BJ aː BB l AE o BC
inswelo	i BB n AG s AJ w AM eː BB l AE o BC
intaba	i BB n AG t AK aː BB ɓ BG a BB
intaka	i BB n AG t AK aː BB ɠ BJ a BB
intambo	i BB n AG t AK aː BB m AF b AH o BC
intamo	i BB n AG t AK aː BB m AF o BC
intandane	i BB n AG t AK a BB n AG d AK aː BB n AG e BB
intando	i BB n AG t AK aː BB n AG d AK o BC
intela	i BB n AG t AK eː BB l AE a BB
intengo	i BB n AG t AK eː BB n AG ɡ AC o BC
intethe	i BB n AG t AK eː BB tʰ AL e BB
intini	i BB n AG t AK iː BB n AG i BB
into	iː BB n AG t AK o BC
intombazane	i BB n AG t AK o BC m AF b AH a BB z AJ aː BB n AG e BB
intombi	i BB n AG t AK oː BC m AF b AH i BB
intonga	i BB n AG t AK oː BC n AG ɡ AC a BB
intsha	iː BB ɲ AG t AK ʃ AJ a BB
intshe	iː BB ɲ AG t AK ʃ AJ e BB
intshonalanga	i BB ɲ AG t AK ʃ AJ o BC n AG a BB l AE aː BB n AG ɡ AC a BB
intshontsho	iː BB ɲ AG t AK ʃ AJ oː BC ɲ AG t AK ʃ AJ o BC
intshumayelo	i BB ɲ AG t AK ʃ AJ u BC m AF a BB j AB eː BB l AE o BC
intshushiso	i BB ɲ AG t AK ʃ AJ u BC ʃ AJ iː BB s AJ o BC
intulo	i BB n AG t AK uː BC l AE o BC
intuthane	i BB n AG t AK u BC tʰ AL aː BB n AG e BB
intuthu	i BB n AG t AK uː BC tʰ AL u BC
intwala	i BB n AG t AK w AM aː BB l AE a BB
intwasahlobo	i BB n AG t AK w AM a BB s AJ a BB ɬ BI oː BC ɓ BG o BC
intwentshe	i BB n AG t AK w AM eː BB ɲ AG t AK ʃ AJ e BB
inungu	i BB n AG uː BC n AG ɡ AC u BC
inxa	i BB ǁ aː BB
inxaso	i BB ǁ aː BB s AJ o BC
inxeba	iː BB ǁ eː BB ɓ BG a BB
inxele	iː BB ǁ eː BB l AE e BB
inxokovane	i BB ǁ o BC ɠ BJ o BC v BF aː BB n AG e BB
inyakatho	i BB ɲ AG a BB ɠ BJ aː BB tʰ AL o BC
inyala	i BB ɲ AG aː BB l AE a BB
inyama	i BB ɲ AG aː BB m AF a BB
inyamazane	i BB ɲ AG a BB m AF a BB z AJ aː BB n AG e BB
inyanga	i BB ɲ AG aː BB n AG ɡ AC a BB
inyathi	i BB ɲ AG aː BB tʰ AL i BB
inyendle	i BB ɲ AG eː BB n AG ɮ BI e BB
inyoka	i BB ɲ AG oː BC ɠ BJ a BB
inyonga	i BB ɲ AG oː BC n AG ɡ AC a BB
inyongo	i BB ɲ AG oː BC n AG ɡ AC o BC
inyoni	i BB ɲ AG oː BC n AG i BB
inyosi	i BB ɲ AG oː BC s AJ i BB
inyumba	i BB ɲ AG uː BC m AF b AH a BB
inzima	i BB n AG z AJ iː BB m AF a BB
inzondo	i BB n AG z AJ oː BC n AG d AK o BC
inzulu	i BB n AG z AJ uː BC l AE u BC
iphahla	iː BB pʰ AI aː BB ɬ BI a BB
iphakathi	iː BB pʰ AI a BB ɠ BJ aː BB tʰ AL i BB
iphalamende	iː BB pʰ AI a BB l AE a BB m AF eː BB n AG d AK e BB
iphango	iː BB pʰ AI aː BB n AG ɡ AC o BC
iphaphu	iː BB pʰ AI aː BB pʰ AI u BC
iphara	iː BB pʰ AI aː BB r BD a BB
iphasika	iː BB pʰ AI a BB s AJ iː BB ɠ BJ a BB
iphela	iː BB pʰ AI eː BB l AE a BB
iphepha	iː BB pʰ AI eː BB pʰ AI a BB
iphiko	iː BB pʰ AI iː BB ɠ BJ o BC
iphoyisa	iː BB pʰ AI o BC j AB iː BB s AJ a BB
iphupho	iː BB pʰ AI uː BC pʰ AI o BC
iphutha	iː BB pʰ AI uː BC tʰ AL a BB
iphuzu	iː BB pʰ AI uː BC z AJ u BC
ipipi	iː BB p AH iː BB p AH i BB
ipiyano	iː BB p AH i BB j AB aː BB n AG o BC
ipulangwe	iː BB p AH u BC l AE aː BB n AG ɡ AC w AM e BB
ipulazi	iː BB p AH u BC l AE aː BB z AJ i BB
iqabi	iː BB ǃ aː BB ɓ BG i BB
iqakala	iː BB ǃ a BB ɠ BJ aː BB l AE a BB
iqanda	iː BB ǃ aː BB n AG d AK a BB
iqaqa	iː BB ǃ aː BB ǃ a BB
iqatha	iː BB ǃ aː BB tʰ AL a BB
iqembu	iː BB ǃ eː BB m AF b AH u BC
iqeqeba	iː BB ǃ e BB ǃ eː BB ɓ BG a BB
iqhawe	iː BB ǃʰ aː BB w AM e BB
iqhezu	iː BB ǃʰ eː BB z AJ u BC
iqhina	iː BB ǃʰ iː BB n AG a BB
iqhinga	iː BB ǃʰ iː BB n AG ɡ AC a BB
iqhude	iː BB ǃʰ uː BC d AK e BB
iqhwa	iː BB ǃʰ w AM a BB
iqhwabazi	iː BB ǃʰ w AM a BB ɓ BG aː BB z AJ i BB
iqhwana	iː BB ǃʰ w AM aː BB n AG a BB
iqili	iː BB ǃ iː BB l AE i BB
iqiniso	iː BB ǃ i BB n AG iː BB s AJ o BC
iqola	iː BB ǃ oː BC l AE a BB
iqoqo	iː BB ǃ oː BC ǃ o BC
iqwahhashi	iː BB ǃ w AM a BB ɦ AA aː BB ʃ AJ i BB
iresiphi	iː BB r BD e BB s AJ iː BB pʰ AI i BB
isabelo	i BB s AJ a BB ɓ BG eː BB l AE o BC
isabizwana	i BB s AJ a BB ɓ BG i BB z AJ w AM aː BB n AG a BB
isala	i BB s AJ aː BB l AE a BB
isalukazi	i BB s AJ a BB l AE u BC ɠ BJ aː BB z AJ i BB
isambane	i BB s AJ a BB m AF b AH aː BB n AG e BB
isanda	i BB s AJ aː BB n AG d AK a BB
isandiso	i BB s AJ a BB n AG d AK iː BB s AJ o BC
isandla	i BB s AJ aː BB n AG ɮ BI a BB
isando	i BB s AJ aː BB n AG d AK o BC
isandu	i BB s AJ aː BB n AG d AK u BC
isangoma	i BB s AJ a BB n AG ɡ AC oː BC m AF a BB
isapha	iː BB s AJ aː BB pʰ AI a BB
isebi	i BB s AJ eː BB ɓ BG i BB
isele	iː BB s AJ eː BB l AE e BB
isende	iː BB s AJ eː BB n AG d AK e BB
isendwishi	iː BB s AJ e BB n AG d AK w AM iː BB ʃ AJ i BB
isenzo	i BB s AJ eː BB n AG z AJ o BC
ishaka	iː BB ʃ AJ aː BB ɠ BJ a BB
ishayina	iː BB ʃ AJ a BB j AB iː BB n AG a BB
ishinga	iː BB ʃ AJ iː BB n AG ɡ AC a BB
ishiya	iː BB ʃ AJ iː BB j AB a BB
ishongololo	iː BB ʃ AJ o BC n AG ɡ AC o BC l AE oː BC l AE o BC
ishumi	iː BB ʃ AJ uː BC m AF i BB
ishwa	iː BB ʃ AJ w AM a BB
isi	iː BB s AJ i BB
isibabule	i BB s AJ i BB ɓ BG a BB ɓ BG uː BC l AE e BB
isibaya	i BB s AJ i BB ɓ BG aː BB j AB a BB
isibhakela	i BB s AJ i BB b AH a BB ɠ BJ eː BB l AE a BB
isibhaxelo	i BB s AJ i BB b AH a BB ǁ eː BB l AE o BC
isibhedlela	i BB s AJ i BB b AH e BB ɮ BI eː BB l AE a BB
isibhokodo	i BB s AJ i BB b AH o BC ɠ BJ oː BC d AK o BC
isibhoza	i BB s AJ i BB b AH oː BC z AJ a BB
isibhunu	i BB s AJ i BB b AH uː BC n AG u BC
isibi	i BB s AJ iː BB ɓ BG i BB
isibiba	i BB s AJ i BB ɓ BG iː BB ɓ BG a BB
isibili	i BB s AJ i BB ɓ BG iː BB l AE i BB
isibindi	i BB s AJ i BB ɓ BG iː BB n AG d AK i BB
isibingelelo	i BB s AJ i BB ɓ BG i BB n AG ɡ AC e BB l AE eː BB l AE o BC
isibomvu	i BB s AJ i BB ɓ BG oː BC m AF v BF u BC
isibongo	i BB s AJ i BB ɓ BG oː BC n AG ɡ AC o BC
isibungu	i BB s AJ i BB ɓ BG uː BC n AG ɡ AC u BC
isibunu	i BB s AJ i BB ɓ BG uː BC n AG u BC
isicathulo	i BB s AJ i BB ǀ a BB tʰ AL uː BC l AE o BC
isicebi	i BB s AJ i BB ǀ eː BB ɓ BG i BB
isicholo	i BB s AJ i BB ǀʰ oː BC l AE o BC
isichotho	i BB s AJ i BB ǀʰ oː BC tʰ AL o BC
isichwe	i BB s AJ iː BB ǀʰ w AM e BB
isici	i BB s AJ iː BB ǀ i BB
isicunulo	i BB s AJ i BB ǀ u BC n AG uː BC l AE o BC
isidakwa	i BB s AJ i BB d AK aː BB ɠ BJ w AM a BB
isidididi	i BB s AJ i BB d AK i BB d AK iː BB d AK i BB
isidingo	i BB s AJ i BB d AK iː BB n AG ɡ AC o BC
isidla	i BB s AJ iː BB ɮ BI a BB
isidleke	i BB s AJ i BB ɮ BI eː BB ɠ BJ e BB
isidlele	i BB s AJ i BB ɮ BI eː BB l AE e BB
isidlo	i BB s AJ iː BB ɮ BI o BC
isidlokolo	i BB s AJ i BB ɮ BI o BC ɠ BJ oː BC l AE o BC
isidula	i BB s AJ i BB d AK uː BC l AE a BB
isidumbu	i BB s AJ i BB d AK uː BC m AF b AH u BC
isidwaba	i BB s AJ i BB d AK w AM aː BB ɓ BG a BB
isidwebo	i BB s AJ i BB d AK w AM eː BB ɓ BG o BC
isifazane	i BB s AJ i BB f BF a BB z AJ aː BB n AG e BB
isifingqo	i BB s AJ i BB f BF iː BB ǃʱ o BC
isifo	i BB s AJ iː BB f BF o BC
isifuba	i BB s AJ i BB f BF uː BC ɓ BG a BB
isifulentshi	i BB s AJ i BB f BF u BC l AE eː BB ɲ AG t AK ʃ AJ i BB
isifunda	i BB s AJ i BB f BF uː BC n AG d AK a BB
isiga	i BB s AJ iː BB ɡ AC a BB
isigcawu	i BB s AJ i BB ǀʱ aː BB w AM u BC
isigcibisholo	i BB s AJ i BB ǀʱ i BB ɓ BG i BB ʃ AJ oː BC l AE o BC
isigcino	i BB s AJ i BB ǀʱ iː BB n AG o BC
isigebengu	i BB s AJ i BB ɡ AC e BB ɓ BG eː BB n AG ɡ AC u BC
isigedla	i BB s AJ i BB ɡ AC eː BB ɮ BI a BB
isigedlekazi	i BB s AJ i BB ɡ AC e BB ɮ BI e BB ɠ BJ aː BB z AJ i BB
isigege	i BB s AJ i BB ɡ AC eː BB ɡ AC e BB
isigidi	i BB s AJ i BB ɡ AC iː BB d AK i BB
isigidigidi	i BB s AJ i BB ɡ AC i BB d AK i BB ɡ AC iː BB d AK i BB
isigigaba	i BB s AJ i BB ɡ AC i BB ɡ AC aː BB ɓ BG a BB
isigingci	i BB s AJ i BB ɡ AC iː BB ǀʱ i BB
isigodi	i BB s AJ i BB ɡ AC oː BC d AK i BB
isigqi	i BB s AJ iː BB ǃʱ i BB
isigqiki	i BB s AJ i BB ǃʱ iː BB ɠ BJ i BB
isigqila	i BB s AJ i BB ǃʱ iː BB l AE a BB
isigqizo	i BB s AJ i BB ǃʱ iː BB z AJ o BC
isigqoko	i BB s AJ i BB ǃʱ oː BC ɠ BJ o BC
isigubhu	i BB s AJ i BB ɡ AC uː BC b AH u BC
isigwaca	i BB s AJ i BB ɡ AC w AM aː BB ǀ a BB
isigwadlulo	i BB s AJ i BB ɡ AC w AM a BB ɮ BI uː BC l AE o BC
isigwayi	i BB s AJ i BB ɡ AC w AM aː BB j AB i BB
isigwedlo	i BB s AJ i BB ɡ AC w AM eː BB ɮ BI o BC
isigwegwe	i BB s AJ i BB ɡ AC w AM eː BB ɡ AC w AM e BB
isigxobo	i BB s AJ i BB ǁʱ oː BC ɓ BG o BC
isihla	i BB s AJ iː BB ɬ BI a BB
isihlabathi	i BB s AJ i BB ɬ BI a BB ɓ BG aː BB tʰ AL i BB
isihlahla	i BB s AJ i BB ɬ BI aː BB ɬ BI a BB
isihlakaniphi	i BB s AJ i BB ɬ BI a BB ɠ BJ a BB n AG iː BB pʰ AI i BB
isihlalo	i BB s AJ i BB ɬ BI aː BB l AE o BC
isihlangu	i BB s AJ i BB ɬ BI aː BB n AG ɡ AC u BC
isihlanu	i BB s AJ i BB ɬ BI aː BB n AG u BC
isihlelo	i BB s AJ i BB ɬ BI eː BB l AE o BC
isihlephu	i BB s AJ i BB ɬ BI eː BB pʰ AI u BC
isihlobo	i BB s AJ i BB ɬ BI oː BC ɓ BG o BC
isihloko	i BB s AJ i BB ɬ BI oː BC ɠ BJ o BC
isihlungu	i BB s AJ i BB ɬ BI uː BC n AG ɡ AC u BC
isijingi	i BB s AJ i BB d AK ʒ AJ iː BB n AG ɡ AC i BB
isijula	i BB s AJ i BB d AK ʒ AJ uː BC l AE a BB
isikebhe	i BB s AJ i BB k AC eː BB b AH e BB
isikhala	i BB s AJ i BB kʰ AD aː BB l AE a BB
isikhali	i BB s AJ i BB kʰ AD aː BB l AE i BB
isikhashana	i BB s AJ i BB kʰ AD a BB ʃ AJ aː BB n AG a BB
isikhathi	i BB s AJ i BB kʰ AD aː BB tʰ AL i BB
isikhindi	i BB s AJ i BB kʰ AD iː BB n AG d AK i BB
isikhombisa	i BB s AJ i BB kʰ AD o BC m AF b AH iː BB s AJ a BB
isikhotha	i BB s AJ i BB kʰ AD oː BC tʰ AL a BB
isikhulu	i BB s AJ i BB kʰ AD uː BC l AE u BC
isikhumba	i BB s AJ i BB kʰ AD uː BC m AF b AH a BB
isikhumbuzo	i BB s AJ i BB kʰ AD u BC m AF b AH uː BC z AJ o BC
isikhundla	i BB s AJ i BB kʰ AD uː BC n AG ɮ BI a BB
isikhwama	i BB s AJ i BB kʰ AD w AM aː BB m AF a BB
isikhwehlela	i BB s AJ i BB kʰ AD w AM e BB ɬ BI eː BB l AE a BB
isikhwenene	i BB s AJ i BB kʰ AD w AM e BB n AG eː BB n AG e BB
isikhwili	i BB s AJ i BB kʰ AD w AM iː BB l AE i BB
isikole	i BB s AJ i BB k AC oː BC l AE e BB
isikweleti	i BB s AJ i BB k AC w AM e BB l AE eː BB t AK i BB
isikweletu	i BB s AJ i BB k AC w AM e BB l AE eː BB t AK u BC
isikwenetu	i BB s AJ i BB k AC w AM e BB n AG eː BB t AK u BC
isileti	i BB s AJ i BB l AE eː BB t AK i BB
isilevu	i BB s AJ i BB l AE eː BB v BF u BC
isilima	i BB s AJ i BB l AE iː BB m AF a BB
isilisa	i BB s AJ i BB l AE iː BB s AJ a BB
isiliva	iː BB s AJ i BB l AE iː BB v BF a BB
isilo	i BB s AJ iː BB l AE o BC
isilonda	i BB s AJ i BB l AE oː BC n AG d AK a BB
isilungu	i BB s AJ i BB l AE uː BC n AG ɡ AC u BC
isilwane	i BB s AJ i BB l AE w AM aː BB n AG e BB
isilwi	i BB s AJ iː BB l AE w AM i BB
isimame	i BB s AJ i BB mʱ BL aː BB mʱ BL e BB
isimangaliso	i BB s AJ i BB m AF a BB n AG ɡ AC a BB l AE iː BB s AJ o BC
isimba	iː BB s AJ iː BB m AF b AH a BB
isimemo	i BB s AJ i BB m AF eː BB m AF o BC
isimo	i BB s AJ iː BB m AF o BC
isinci	i BB s AJ iː BB ǀ i BB
isinciphiso	i BB s AJ i BB ǀ i BB pʰ AI iː BB s AJ o BC
isine	i BB s AJ iː BB n AG e BB
isingane	i BB s AJ i BB n AG ɡ AC aː BB n AG e BB
isingci	i BB s AJ iː BB ǀʱ i BB
isingisi	i BB s AJ i BB n AG ɡ AC iː BB s AJ i BB
isinguni	i BB s AJ i BB n AG ɡ AC uː BC n AG i BB
isinkwa	i BB s AJ iː BB n AG k AC w AM a BB
isinkwe	i BB s AJ iː BB n AG k AC w AM e BB
isinqe	i BB s AJ iː BB ǃ e BB
isinqumo	i BB s AJ i BB ǃ uː BC m AF o BC
isintu	i BB s AJ iː BB n AG t AK u BC
isinxele	i BB s AJ i BB ǁ eː BB l AE e BB
isinye	i BB s AJ iː BB ɲ AG e BB
isinzima	i BB s AJ i BB n AG z AJ iː BB m AF a BB
isiphambano	i BB s AJ i BB pʰ AI a BB m AF b AH aː BB n AG o BC
isiphapha	i BB s AJ i BB pʰ AI aː BB pʰ AI a BB
isiphawulo	i BB s AJ i BB pʰ AI a BB w AM uː BC l AE o BC
isiphethe	i BB s AJ i BB pʰ AI eː BB tʰ AL e BB
isiphetho	i BB s AJ i BB pʰ AI eː BB tʰ AL o BC
isiphika	i BB s AJ i BB pʰ AI iː BB ɠ BJ a BB
isipho	i BB s AJ iː BB pʰ AI o BC
isiphukuphuku	i BB s AJ i BB pʰ AI u BC ɠ BJ u BC pʰ AI uː BC ɠ BJ u BC
isiphundu	i BB s AJ i BB pʰ AI uː BC n AG d AK u BC
isiphuzi	i BB s AJ i BB pʰ AI uː BC z AJ i BB
isipinashi	i BB s AJ i BB p AH i BB n AG aː BB ʃ AJ i BB
isipunu	i BB s AJ i BB p AH uː BC n AG u BC
isiqalo	i BB s AJ i BB ǃ aː BB l AE o BC
isiqephu	i BB s AJ i BB ǃ eː BB pʰ AI u BC
isiqhaza	i BB s AJ i BB ǃʰ aː BB z AJ a BB
isiqhebeza	i BB s AJ i BB ǃʰ e BB ɓ BG eː BB z AJ a BB
isiqhephu	i BB s AJ i BB ǃʰ eː BB pʰ AI u BC
isiqhimu	i BB s AJ i BB ǃʰ iː BB m AF u BC
isiqhingana	i BB s AJ i BB ǃʰ i BB n AG ɡ AC aː BB n AG a BB
isiqhingi	i BB s AJ i BB ǃʰ iː BB n AG ɡ AC i BB
isiqimu	i BB s AJ i BB ǃ iː BB m AF u BC
isiqinti	i BB s AJ i BB ǃ iː BB n AG t AK i BB
isiqithi	i BB s AJ i BB ǃ iː BB tʰ AL i BB
isiqopha	i BB s AJ i BB ǃ oː BC pʰ AI a BB
isiqoqo	i BB s AJ i BB ǃ oː BC ǃ o BC
isiquba	i BB s AJ i BB ǃ uː BC ɓ BG a BB
isisebenzi	i BB s AJ i BB s AJ e BB ɓ BG eː BB n AG z AJ i BB
isishayina	i BB s AJ i BB ʃ AJ a BB j AB iː BB n AG a BB
isishiyagalolunye	i BB s AJ i BB ʃ AJ i BB j AB a BB ɡ AC a BB l AE o BC l AE uː BC ɲ AG e BB
isishiyagalombili	i BB s AJ i BB ʃ AJ i BB j AB a BB ɡ AC a BB l AE o BC m AF b AH iː BB l AE i BB
isishuqulu	i BB s AJ i BB ʃ AJ u BC ǃ uː BC l AE u BC
isishushiso	i BB s AJ i BB ʃ AJ u BC ʃ AJ iː BB s AJ o BC
isisu	i BB s AJ iː BB s AJ u BC
isisuthu	i BB s AJ i BB s AJ uː BC tʰ AL u BC
isiswazi	i BB s AJ i BB s AJ w AM aː BB z AJ i BB
isiswebhu	i BB s AJ i BB s AJ w AM eː BB b AH u BC
isitambu	i BB s AJ i BB t AK aː BB m AF b AH u BC
isiteleka	i BB s AJ i BB t AK e BB l AE eː BB ɠ BJ a BB
isitha	iː BB s AJ iː BB tʰ AL a BB
isithando	i BB s AJ i BB tʰ AL aː BB n AG d AK o BC
isithandwa	i BB s AJ i BB tʰ AL aː BB n AG d AK w AM a BB
isithathu	i BB s AJ i BB tʰ AL aː BB tʰ AL u BC
isithelo	i BB s AJ i BB tʰ AL eː BB l AE o BC
isithembiso	i BB s AJ i BB tʰ AL e BB m AF b AH iː BB s AJ o BC
isithixo	i BB s AJ i BB tʰ AL iː BB ǁ o BC
isithole	i BB s AJ i BB tʰ AL oː BC l AE e BB
isithombe	i BB s AJ i BB tʰ AL oː BC m AF b AH e BB
isithunywa	i BB s AJ i BB tʰ AL uː BC ɲ AG w AM a BB
isithupha	i BB s AJ i BB tʰ AL uː BC pʰ AI a BB
isithutha	i BB s AJ i BB tʰ AL uː BC tʰ AL a BB
isithuthuthu	i BB s AJ i BB tʰ AL u BC tʰ AL uː BC tʰ AL u BC
isithwalambiza	i BB s AJ i BB tʰ AL w AM a BB l AE a BB m AF b AH iː BB z AJ a BB
isithwathwa	i BB s AJ i BB tʰ AL w AM aː BB tʰ AL w AM a BB
isitimela	i BB s AJ i BB t AK i BB m AF eː BB l AE a BB
isitini	i BB s AJ i BB t AK iː BB n AG i BB
isitofu	i BB s AJ i BB t AK oː BC f BF u BC
isitsha	i BB s AJ iː BB t AK ʃ AJ a BB
isitshalo	i BB s AJ i BB t AK ʃ AJ aː BB l AE o BC
isitshwana	i BB s AJ i BB t AK ʃ AJ w AM aː BB n AG a BB
isitswana	i BB s AJ i BB t AK s AJ w AM aː BB n AG a BB
isitulo	i BB s AJ i BB t AK uː BC l AE o BC
isivalo	i BB s AJ i BB v BF aː BB l AE o BC
isivande	i BB s AJ i BB v BF aː BB n AG d AK e BB
isixaxa	i BB s AJ i BB ǁ aː BB ǁ a BB
isixazululo	i BB s AJ i BB ǁ a BB z AJ u BC l AE uː BC l AE o BC
isixhosa	i BB s AJ i BB ǁʰ oː BC s AJ a BB
isixubho	i BB s AJ i BB ǁ uː BC b AH o BC
isixuku	i BB s AJ i BB ǁ uː BC ɠ BJ u BC
isixula	i BB s AJ i BB ǁ uː BC l AE a BB
isiziba	i BB s AJ i BB z AJ iː BB ɓ BG a BB
isizulu	i BB s AJ i BB z AJ uː BC l AE u BC
isizwe	i BB s AJ iː BB z AJ w AM e BB
iso	iː BB s AJ o BC
isoka	iː BB s AJ oː BC ɠ BJ a BB
isondo	iː BB s AJ oː BC n AG d AK o BC
isono	i BB s AJ oː BC n AG o BC
isonto	iː BB s AJ oː BC n AG t AK o BC
isosa	iː BB s AJ oː BC s AJ a BB
isu	iː BB s AJ u BC
isundu	iː BB s AJ uː BC n AG d AK u BC
iswazi	iː BB s AJ w AM aː BB z AJ i BB
itafula	iː BB t AK a BB f BF uː BC l AE a BB
ithambo	iː BB tʰ AL aː BB m AF b AH o BC
ithanga	iː BB tʰ AL aː BB n AG ɡ AC a BB
itheku	iː BB tʰ AL eː BB ɠ BJ u BC
ithemba	iː BB tʰ AL eː BB m AF b AH a BB
ithikithi	iː BB tʰ AL i BB ɠ BJ iː BB tʰ AL i BB
ithuba	iː BB tʰ AL uː BC ɓ BG a BB
ithumbu	iː BB tʰ AL uː BC m AF b AH u BC
ithunga	iː BB tʰ AL uː BC n AG ɡ AC a BB
ithusi	iː BB tʰ AL uː BC s AJ i BB
ithwasa	iː BB tʰ AL w AM aː BB s AJ a BB
itiye	iː BB t AK iː BB j AB e BB
itshe	iː BB t AK ʃ AJ e BB
itshitshi	iː BB t AK ʃ AJ iː BB t AK ʃ AJ i BB
itswayi	iː BB t AK s AJ w AM aː BB j AB i BB
iva	iː BB v BF a BB
ivaka	iː BB v BF aː BB ɠ BJ a BB
ivesi	iː BB v BF eː BB s AJ i BB
ivila	iː BB v BF iː BB l AE a BB
ivoti	iː BB v BF oː BC t AK i BB
ivukusi	iː BB v BF u BC ɠ BJ uː BC s AJ i BB
ivukuzi	iː BB v BF u BC ɠ BJ uː BC z AJ i BB
iwa	iː BB w AM a BB
iwayini	iː BB w AM a BB j AB iː BB n AG i BB
iwodi	iː BB w AM oː BC d AK i BB
ixhaphozi	iː BB ǁʰ a BB pʰ AI oː BC z AJ i BB
ixhegu	iː BB ǁʰ eː BB ɡ AC u BC
ixhiba	iː BB ǁʰ iː BB ɓ BG a BB
ixhumela	iː BB ǁʰ u BC m AF eː BB l AE a BB
ixilongo	iː BB ǁ i BB l AE oː BC n AG ɡ AC o BC
ixolo	iː BB ǁ oː BC l AE o BC
ixoxo	iː BB ǁ oː BC ǁ o BC
ixuku	iː BB ǁ uː BC ɠ BJ u BC
iyadi	iː BB j AB aː BB d AK i BB
iyezi	iː BB j AB eː BB z AJ i BB
izaba	i BB z AJ aː BB ɓ BG a BB
izabulo	i BB z AJ a BB ɓ BG uː BC l AE o BC
izala	iː BB z AJ aː BB l AE a BB
izambane	iː BB z AJ a BB m AF b AH aː BB n AG e BB
izembe	iː BB z AJ eː BB m AF b AH e BB
izigqoko	i BB z AJ i BB ǃʱ ɔː BC ɠ BJ o BC
izihlalo	i BB z AJ i BB ɬ BI aː BB l AE o BC
iziko	iː BB z AJ iː BB ɠ BJ o BC
izimu	iː BB z AJ iː BB m AF u BC
izinga	iː BB z AJ iː BB n AG ɡ AC a BB
izinhloni	i BB z AJ i BB n AG ɬ BI oː BC n AG i BB
izinkabi	i BB z AJ i BB ŋ AN k AC aː BB ɓ BG i BB
izinkamba	i BB z AJ i BB ŋ AN k AC aː BB m AF b AH a BB
izinsizwa	i BB z AJ i BB n AG s AJ iː BB z AJ w AM a BB
izintini	i BB z AJ i BB n AG t AK i BB n AG i BB
izintombi	i BB z AJ i BB n AG t AK oː BC m AF b AH i BB
izinyo	iː BB z AJ iː BB ɲ AG o BC
izipho	iː BB z AJ iː BB pʰ AI o BC
izitha	iː BB z AJ iː BB tʰ AL a BB
izolo	iː BB z AJ oː BC l AE o BC
izu	iː BB z AJ uː BC
izulu	iː BB z AJ uː BC l AE u BC
izwamoya	iː BB z AJ w AM a BB m AF oː BC j AB a BB
izwe	iː BB z AJ w AM e BB
izwekazi	iː BB z AJ w AM e BB ɠ BJ aː BB z AJ i BB
izwi	iː BB z AJ w AM i BB
jana	d AK ʒ AJ aː BB n AG a BB
kade	k AC aː BB d AK e BB
kahle	ɠ BJ aː BB ɬ BI e BB
kahleni	ɠ BJ a BB ɬ BI eː BB n AG i BB
kakhulu	ɠ BJ a BB kʰ AD uː BC l AE u BC
kambe	k AC aː BB m AF b AH e BB
kanjani	ɠ BJ a BB ɲ AG d AK ʒ AJ aː BB n AG i BB
kanti	k AC a BB n AG t AK iː BB
kanye	ɠ BJ aː BB ɲ AG e BB
ke	ɠ BJ e BB
khama	kʰ AD aː BB m AF a BB
khiqiza	kʰ AD i BB ǃ iː BB z AJ a BB
khona	kʰ AD oː BC n AG a BB
khulu	kʰ AD uː BC l AE u BC
khwehlela	kʰ AD w AM e BB ɬ BI eː BB l AE a BB
khweza	kʰ AD w AM eː BB z AJ a BB
khwezela	kʰ AD w AM e BB z AJ eː BB l AE a BB
kleza	k AC x BE eː BB z AJ a BB
konje	k AC oː BC ɲ AG d AK ʒ AJ e BB
kude	ɠ BJ uː BC d AK e BB
kusasa	ɠ BJ u BC s AJ aː BB s AJ a BB
kwazulu	ɠ BJ w AM a BB z AJ uː BC l AE u BC
kweleta	k AC w AM e BB l AE eː BB t AK a BB
la	l AE a BB
laba	l AE a BB ɓ BG a BB
labaya	l AE aː BB ɓ BG a BB j AB aː BB
labo	l AE aː BB ɓ BG o BC
lahla	l AE aː BB ɬ BI a BB
lala	l AE aː BB l AE a BB
lala kahle	l AE a BB l AE a BB ɠ BJ aː BB ɬ BI e BB
lalani kahle	l AE a BB l AE a BB n AG i BB ɠ BJ aː BB ɬ BI e BB
lapha	l AE aː BB pʰ AI a BB
lapho	l AE aː BB pʰ AI o BC
lawaya	l AE aː BB w AM a BB j AB aː BB
lawo	l AE aː BB w AM o BC
le	l AE e BB
leli	l AE e BB l AE i BB
leliya	l AE eː BB l AE i BB j AB aː BB
lelo	l AE eː BB l AE o BC
lenga	l AE eː BB n AG ɡ AC a BB
lesi	l AE e BB s AJ i BB
lesiya	l AE eː BB s AJ i BB j AB aː BB
leso	l AE eː BB s AJ o BC
leyaya	l AE eː BB j AB a BB j AB aː BB
leyo	l AE eː BB j AB o BC
lezi	l AE e BB z AJ i BB
leziya	l AE eː BB z AJ i BB j AB aː BB
lezo	l AE eː BB z AJ o BC
libala	l AE i BB ɓ BG aː BB l AE a BB
lo	l AE o BC
loba	l AE oː BC ɓ BG a BB
lobo	l AE oː BC ɓ BG o BC
lobu	l AE o BC ɓ BG u BC
lobuya	l AE oː BC ɓ BG u BC j AB aː BB
lokho	l AE oː BC kʰ AD o BC
lokhu	l AE o BC kʰ AD u BC
lokhuya	l AE oː BC kʰ AD u BC j AB aː BB
lolo	l AE oː BC l AE o BC
lolu	l AE o BC l AE u BC
loluya	l AE oː BC l AE u BC j AB aː BB
lona	l AE oː BC n AG a BB
lowaya	l AE oː BC w AM a BB j AB aː BB
lowo	l AE oː BC w AM o BC
luhlaza	l AE u BC ɬ BI aː BB z AJ a BB
luma	l AE uː BC m AF a BB
lwa	l AE w AM a BB
maye	mʱ BL a BB jʱ BK eː BB
mema	m AF eː BB m AF a BB
mhla	m̩ BH ɬ BI a BB
mhlawumbe	m̩ BH ɬ BI a BB w AM uː BC m AF b AH e BB
mhlophe	m̩ BH ɬ BI oː BC pʰ AI e BB
mina	m AF iː BB n AG a BB
muntu	m AF uː BC n AG t AK u BC
musa	mʱ BL uː BC s AJ a BB
na	n AG a BB
nakanjani	n AG a BB ɠ BJ a BB ɲ AG d AK ʒ AJ aː BB n AG i BB
namhlanje	n AG a BB m̩ BH ɬ BI aː BB ɲ AG d AK ʒ AJ e BB
nceda	ǀ eː BB d AK a BB
ncedisa	ǀ e BB d AK iː BB s AJ a BB
ncelisa	ǀ e BB l AE iː BB s AJ a BB
ncibilika	ǀ i BB ɓ BG i BB l AE iː BB ɠ BJ a BB
ncika	ǀ iː BB ɠ BJ a BB
ncintisana	ǀ i BB n AG t AK i BB s AJ aː BB n AG a BB
ncipha	ǀ iː BB pʰ AI a BB
nciphisa	ǀ i BB pʰ AI iː BB s AJ a BB
ncokola	ǀ o BC ɠ BJ oː BC l AE a BB
ndiza	n AG d AK iː BB z AJ a BB
ngcola	ǀʱ oː BC l AE a BB
ngcolisa	ǀʱ o BC l AE iː BB s AJ a BB
ngcwaba	ǀʱ w AM aː BB ɓ BG a BB
ngikhona	n AG ɡ AC i BB kʰ AD oː BC n AG a BB
ngiyabonga	n AG ɡ AC i BB j AB a BB ɓ BG oː BC n AG ɡ AC a BB
ngiyakuthanda	n AG ɡ AC i BB j AB a BB ɠ BJ u BC tʰ AL aː BB n AG d AK a BB
ngiyaphila	n AG ɡ AC i BB j AB a BB pʰ AI iː BB l AE a BB
ngoba	n AG ɡ AC oː BC ɓ BG a BB
ngokuba	n AG ɡ AC o BC ɠ BJ uː BC ɓ BG a BB
ngomuso	n AG ɡ AC o BC m AF uː BC s AJ o BC
ngqongqoza	ǃʱ o BC ǃʱ oː BC z AJ a BB
nihambe kahle	n AG i BB h AA a BB m AF b AH e BB ɠ BJ aː BB ɬ BI e BB
nilale kahle	n AG i BB l AE a BB l AE e BB ɠ BJ aː BB ɬ BI e BB
nina	n AG iː BB n AG a BB
ningi	n AG iː BB n AG ɡ AC i BB
nisale kahle	n AG i BB s AJ a BB l AE e BB ɠ BJ aː BB ɬ BI e BB
njalo	ɲ AG d AK ʒ AJ aː BB l AE o BC
njani	ɲ AG d AK ʒ AJ aː BB n AG i BB
nke	n AG k AC e BB
noma	n AG oː BC m AF a BB
nqaba	ǃ aː BB ɓ BG a BB
nqabela	ǃ a BB ɓ BG eː BB l AE a BB
nqaka	ǃ aː BB ɠ BJ a BB
nqamuka	ǃ a BB m AF uː BC ɠ BJ a BB
nqamula	ǃ a BB m AF uː BC l AE a BB
nqekuza	ǃ e BB ɠ BJ uː BC z AJ a BB
nqikaza	ǃ i BB ɠ BJ aː BB z AJ a BB
nqoba	ǃ oː BC ɓ BG a BB
nquma	ǃ uː BC m AF a BB
nqunu	ǃ uː BC n AG u BC
nqwabela	ǃ w AM a BB ɓ BG eː BB l AE a BB
nxa	ǁ aː BB
nxazonke	ǁ a BB z AJ oː BC n AG k AC e BB
nxephepha	ǁ e BB pʰ AI eː BB pʰ AI a BB
nyakenye	ɲ AG a BB ɠ BJ eː BB ɲ AG e BB
nyenyeza	ɲ AG e BB ɲ AG eː BB z AJ a BB
oda	ʔ BA oː BC d AK a BB
phaka	pʰ AI aː BB ɠ BJ a BB
phakathi	pʰ AI a BB ɠ BJ aː BB tʰ AL i BB
phambili	pʰ AI a BB m AF b AH iː BB l AE i BB
phansi	pʰ AI aː BB n AG s AJ i BB
phela	pʰ AI eː BB l AE a BB
phephisa	pʰ AI e BB pʰ AI iː BB s AJ a BB
phesheya	pʰ AI e BB ʃ AJ eː BB j AB a BB
phezolo	pʰ AI e BB z AJ oː BC l AE o BC
phezu	pʰ AI eː BB z AJ u BC
phezulu	pʰ AI e BB z AJ uː BC l AE u BC
phinde	pʰ AI iː BB n AG d AK e BB
phola	pʰ AI oː BC l AE a BB
qabatheka	ǃ a BB ɓ BG a BB tʰ AL eː BB ɠ BJ a BB
qabuka	ǃ a BB ɓ BG uː BC ɠ BJ a BB
qabula	ǃ a BB ɓ BG uː BC l AE a BB
qagela	ǃ a BB ɡ AC eː BB l AE a BB
qala	ǃ aː BB l AE a BB
qalaza	ǃ a BB l AE aː BB z AJ a BB
qamba	ǃ aː BB m AF b AH a BB
qamela	ǃ a BB m AF eː BB l AE a BB
qaphela	ǃ a BB pʰ AI eː BB l AE a BB
qaqa	ǃ aː BB ǃ a BB
qaqamba	ǃ a BB ǃ aː BB m AF b AH a BB
qatha	ǃ aː BB tʰ AL a BB
qathaka	ǃ a BB tʰ AL aː BB ɠ BJ a BB
qeda	ǃ eː BB d AK a BB
qedakala	ǃ e BB d AK a BB ɠ BJ aː BB l AE a BB
qede	ǃ eː BB d AK e BB
qeqebula	ǃ e BB ǃ e BB ɓ BG uː BC l AE a BB
qhakaza	ǃʰ a BB ɠ BJ aː BB z AJ a BB
qhamu	ǃʰ a BB m AF u BC
qhamuka	ǃʰ a BB m AF uː BC ɠ BJ a BB
qhaqha	ǃʰ aː BB ǃʰ a BB
qhaqhazela	ǃʰ a BB ǃʰ a BB z AJ eː BB l AE a BB
qhasha	ǃʰ aː BB ʃ AJ a BB
qhathanisa	ǃʰ a BB tʰ AL a BB n AG iː BB s AJ a BB
qhebeza	ǃʰ e BB ɓ BG eː BB z AJ a BB
qhela	ǃʰ eː BB l AE a BB
qhelisa	ǃʰ e BB l AE iː BB s AJ a BB
qhephuka	ǃʰ e BB pʰ AI uː BC ɠ BJ a BB
qhesha	ǃʰ eː BB ʃ AJ a BB
qhina	ǃʰ iː BB n AG a BB
qhiyama	ǃʰ i BB j AB aː BB m AF a BB
qhubeka	ǃʰ u BC ɓ BG eː BB ɠ BJ a BB
qhuma	ǃʰ uː BC m AF a BB
qhutha	ǃʰ uː BC tʰ AL a BB
qhuthula	ǃʰ u BC tʰ AL uː BC l AE a BB
qhwaga	ǃʰ w AM aː BB ɡ AC a BB
qhwaya	ǃʰ w AM aː BB j AB a BB
qhweba	ǃʰ w AM eː BB ɓ BG a BB
qinisela	ǃ i BB n AG i BB s AJ eː BB l AE a BB
qoba	ǃ oː BC ɓ BG a BB
qoka	ǃ oː BC ɠ BJ a BB
qoma	ǃ oː BC m AF a BB
qomisa	ǃ o BC m AF iː BB s AJ a BB
qonda	ǃ oː BC n AG d AK a BB
qondisa	ǃ o BC n AG d AK iː BB s AJ a BB
qoqa	ǃ oː BC ǃ a BB
quba	ǃ uː BC ɓ BG a BB
quleka	ǃ u BC l AE eː BB ɠ BJ a BB
qumba	ǃ uː BC m AF b AH a BB
qwasha	ǃ w AM aː BB ʃ AJ a BB
qwashaza	ǃ w AM a BB ʃ AJ aː BB z AJ a BB
sala kahle	s AJ a BB l AE a BB ɠ BJ aː BB ɬ BI e BB
salani kahle	s AJ a BB l AE a BB n AG i BB ɠ BJ aː BB ɬ BI e BB
sanibona	s AJ a BB n AG i BB ɓ BG oː BC n AG a BB
sanibonani	s AJ a BB n AG i BB ɓ BG o BC n AG aː BB n AG i BB
sawubona	s AJ a BB w AM u BC ɓ BG oː BC n AG a BB
sebenza	s AJ e BB ɓ BG eː BB n AG z AJ a BB
shaqa	ʃ AJ aː BB ǃ a BB
shaqeka	ʃ AJ a BB ǃ eː BB ɠ BJ a BB
shwabana	ʃ AJ w AM a BB ɓ BG aː BB n AG a BB
singa	s AJ iː BB n AG ɡ AC a BB
soka	s AJ oː BC ɠ BJ a BB
sombu	s AJ o BC m AF b AH u BC
sombuluka	s AJ o BC m AF b AH u BC l AE uː BC ɠ BJ a BB
sombulula	s AJ o BC m AF b AH u BC l AE uː BC l AE a BB
sona	s AJ oː BC n AG a BB
swaca	s AJ w AM aː BB ǀ a BB
swakama	s AJ w AM a BB ɠ BJ aː BB m AF a BB
teleka	t AK e BB l AE eː BB ɠ BJ a BB
thathu	tʰ AL aː BB tʰ AL u BC
thetha	tʰ AL eː BB tʰ AL a BB
thina	tʰ AL iː BB n AG a BB
thukuthela	tʰ AL u BC ɠ BJ u BC tʰ AL eː BB l AE a BB
ubaba	u BC ɓ BG aː BB ɓ BG a BB
ubabekazi	u BC ɓ BG a BB ɓ BG e BB ɠ BJ aː BB z AJ i BB
ubala	uː BC ɓ BG aː BB l AE a BB
ubambo	uː BC ɓ BG aː BB m AF b AH o BC
ubani	u BC ɓ BG aː BB n AG i BB
ubasi	u BC ɓ BG aː BB s AJ i BB
ubhadi	u BC b AH aː BB d AK i BB
ubhaka	u BC b AH aː BB ɠ BJ a BB
ubhanana	u BC b AH a BB n AG aː BB n AG a BB
ubhavu	u BC b AH aː BB v BF u BC
ubhejane	u BC b AH e BB d AK ʒ AJ aː BB n AG e BB
ubheseni	u BC b AH e BB s AJ eː BB n AG i BB
ubhiya	u BC b AH iː BB j AB a BB
ubhiye	u BC b AH iː BB j AB e BB
ubhoko	uː BC b AH oː BC ɠ BJ o BC
ubhontshisi	u BC b AH o BC ɲ AG t AK ʃ AJ iː BB s AJ i BB
ubhoshobana	u BC b AH o BC ʃ AJ o BC ɓ BG aː BB n AG a BB
ubhova	u BC b AH oː BC v BF a BB
ubhozo	u BC b AH oː BC z AJ o BC
ubhusha	u BC b AH uː BC ʃ AJ a BB
ubisi	uː BC ɓ BG iː BB s AJ i BB
ubolo	uː BC ɓ BG oː BC l AE o BC
ubomvu	uː BC ɓ BG oː BC m AF v BF u BC
uboya	u BC ɓ BG oː BC j AB a BB
ububanzi	u BC ɓ BG u BC ɓ BG aː BB n AG z AJ i BB
ububhibhi	u BC ɓ BG u BC b AH iː BB b AH i BB
ububi	u BC ɓ BG uː BC ɓ BG i BB
ububomvu	u BC ɓ BG u BC ɓ BG oː BC m AF v BF u BC
ubuchopho	u BC ɓ BG u BC ǀʰ oː BC pʰ AI o BC
ubuciko	u BC ɓ BG u BC ǀ iː BB ɠ BJ o BC
ubudala	u BC ɓ BG u BC d AK aː BB l AE a BB
ubude	u BC ɓ BG uː BC d AK e BB
ubudlelwane	u BC ɓ BG u BC ɮ BI e BB l AE w AM aː BB n AG e BB
ubudoda	u BC ɓ BG u BC d AK oː BC d AK a BB
ubugqila	u BC ɓ BG u BC ǃʱ iː BB l AE a BB
ubugwala	u BC ɓ BG u BC ɡ AC w AM aː BB l AE a BB
ubuhlalu	u BC ɓ BG u BC ɬ BI aː BB l AE u BC
ubuhlanya	u BC ɓ BG u BC ɬ BI aː BB ɲ AG a BB
ubuhle	u BC ɓ BG uː BC ɬ BI e BB
ubuhleli	u BC ɓ BG u BC ɬ BI eː BB l AE i BB
ubuhlobo	u BC ɓ BG u BC ɬ BI oː BC ɓ BG o BC
ubuhlungu	u BC ɓ BG u BC ɬ BI uː BC n AG ɡ AC u BC
ubukhali	u BC ɓ BG u BC kʰ AD aː BB l AE i BB
ubukhosazana	u BC ɓ BG u BC kʰ AD o BC s AJ a BB z AJ aː BB n AG a BB
ubukhosikazi	u BC ɓ BG u BC kʰ AD o BC s AJ i BB ɠ BJ aː BB z AJ i BB
ubukhulu	u BC ɓ BG u BC kʰ AD uː BC l AE u BC
ubuluhlaza	u BC ɓ BG u BC l AE u BC ɬ BI aː BB z AJ a BB
ubumhlophe	u BC ɓ BG u BC m̩ BH ɬ BI oː BC pʰ AI e BB
ubumnene	u BC ɓ BG u BC m̩ BH n AG eː BB n AG e BB
ubumnyama	u BC ɓ BG u BC m̩ BH ɲ AG aː BB m AF a BB
ubumpi	u BC ɓ BG uː BC m AF p AH i BB
ubumpofu	u BC ɓ BG u BC m AF p AH oː BC f BF u BC
ubumpohlo	u BC ɓ BG u BC m AF p AH oː BC ɬ BI o BC
ubumtoti	u BC ɓ BG u BC m̩ BH t AK oː BC t AK i BB
ubuncane	u BC ɓ BG u BC ǀ aː BB n AG e BB
ubundlalifa	u BC ɓ BG u BC n AG ɮ BI a BB l AE iː BB f BF a BB
ubungane	u BC ɓ BG u BC n AG ɡ AC aː BB n AG e BB
ubungcono	u BC ɓ BG u BC ǀʱ oː BC n AG o BC
ubungqa	u BC ɓ BG uː BC ǃʱ a BB
ubungqo	u BC ɓ BG uː BC ǃʱ o BC
ubungqolokosho	u BC ɓ BG u BC ǃʱ o BC l AE o BC ɠ BJ oː BC ʃ AJ o BC
ubuningi	u BC ɓ BG u BC n AG iː BB n AG ɡ AC i BB
ubunjani	u BC ɓ BG u BC ɲ AG d AK ʒ AJ aː BB n AG i BB
ubunqunu	u BC ɓ BG u BC ǃ uː BC n AG u BC
ubunsomi	u BC ɓ BG u BC n AG s AJ oː BC m AF i BB
ubuntu	u BC ɓ BG uː BC n AG t AK u BC
ubuntwana	u BC ɓ BG u BC n AG t AK w AM aː BB n AG a BB
ubunxele	u BC ɓ BG u BC ǁ eː BB l AE e BB
ubunyakanyaka	u BC ɓ BG u BC ɲ AG a BB ɠ BJ a BB ɲ AG aː BB ɠ BJ a BB
ubunye	u BC ɓ BG uː BC ɲ AG e BB
ubuphansi	u BC ɓ BG u BC pʰ AI aː BB n AG s AJ i BB
ubuqhawe	u BC ɓ BG u BC ǃʰ aː BB w AM e BB
ubuqotho	u BC ɓ BG u BC ǃ oː BC tʰ AL o BC
ubusha	u BC ɓ BG uː BC ʃ AJ a BB
ubusika	u BC ɓ BG u BC s AJ iː BB ɠ BJ a BB
ubuso	u BC ɓ BG uː BC s AJ o BC
ubusuku	u BC ɓ BG u BC s AJ uː BC ɠ BJ u BC
ubutha	u BC ɓ BG uː BC tʰ AL a BB
ubuthakathaka	u BC ɓ BG u BC tʰ AL a BB ɠ BJ a BB tʰ AL aː BB ɠ BJ a BB
ubuthi	u BC ɓ BG uː BC tʰ AL i BB
ubuthuntu	u BC ɓ BG u BC tʰ AL uː BC n AG t AK u BC
ubuthutha	u BC ɓ BG u BC tʰ AL uː BC tʰ AL a BB
ubuvaka	u BC ɓ BG u BC v BF aː BB ɠ BJ a BB
ubuvila	u BC ɓ BG u BC v BF iː BB l AE a BB
ubuxhegu	u BC ɓ BG u BC ǁʰ eː BB ɡ AC u BC
ubuzimu	u BC ɓ BG u BC z AJ iː BB m AF u BC
ubuzwe	u BC ɓ BG uː BC z AJ w AM e BB
uchakide	u BC ǀʰ a BB ɠ BJ iː BB d AK e BB
ucingo	uː BC ǀ iː BB n AG ɡ AC o BC
ucwecwe	uː BC ǀ w AM eː BB ǀ w AM e BB
udaba	uː BC d AK aː BB ɓ BG a BB
udaka	uː BC d AK aː BB ɠ BJ a BB
udlame	uː BC ɮ BI aː BB m AF e BB
udlawu	uː BC ɮ BI aː BB w AM u BC
udokotela	u BC d AK o BC ɠ BJ o BC t AK eː BB l AE a BB
udoli	u BC d AK oː BC l AE i BB
udondolo	uː BC d AK o BC n AG d AK oː BC l AE o BC
udonga	uː BC d AK oː BC n AG ɡ AC a BB
udoti	u BC d AK oː BC t AK i BB
udwi	u BC d AK w AM iː BB
ufezela	u BC f BF e BB z AJ eː BB l AE a BB
ufu	uː BC f BF u BC
ufudu	uː BC f BF uː BC d AK u BC
ugadi	u BC ɡ AC aː BB d AK i BB
ugalo	uː BC ɡ AC aː BB l AE o BC
ugamthilini	u BC ɡ AC a BB m AF tʰ AL i BB l AE iː BB n AG i BB
uganandela	u BC ɡ AC a BB n AG a BB n AG d AK eː BB l AE a BB
ugazi	uː BC ɡ AC aː BB z AJ i BB
ugesi	u BC ɡ AC eː BB s AJ i BB
ugigi	u BC ɡ AC iː BB ɡ AC i BB
ugogo	u BC ɡ AC oː BC ɡ AC o BC
ugologo	u BC ɡ AC o BC l AE oː BC ɡ AC o BC
ugqozi	uː BC ǃʱ oː BC z AJ i BB
ugu	uː BC ɡ AC u BC
ugwadule	uː BC ɡ AC w AM a BB d AK uː BC l AE e BB
ugwava	u BC ɡ AC w AM aː BB v BF a BB
ugwayi	u BC ɡ AC w AM aː BB j AB i BB
ugxa	uː BC ǁʱ a BB
uhabhu	uː BC h AA aː BB b AH u BC
uhambe kahle	u BC h AA a BB m AF b AH e BB ɠ BJ aː BB ɬ BI e BB
uhambo	uː BC h AA aː BB m AF b AH o BC
uhele	uː BC h AA eː BB l AE e BB
uhhafu	u BC ɦ AA aː BB f BF u BC
uhla	uː BC ɬ BI a BB
uhlaka	uː BC ɬ BI aː BB ɠ BJ a BB
uhlamvu	uː BC ɬ BI aː BB m AF v BF u BC
uhlangothi	uː BC ɬ BI a BB n AG ɡ AC oː BC tʰ AL i BB
uhlanya	uː BC ɬ BI aː BB ɲ AG a BB
uhlaza	uː BC ɬ BI aː BB z AJ a BB
uhleko	uː BC ɬ BI eː BB ɠ BJ o BC
uhlelo	uː BC ɬ BI eː BB l AE o BC
uhlobo	uː BC ɬ BI oː BC ɓ BG o BC
uhlu	uː BC ɬ BI u BC
uhulumeni	u BC h AA u BC l AE u BC m AF eː BB n AG i BB
ujamu	u BC d AK ʒ AJ aː BB m AF u BC
ujehova	u BC d AK ʒ AJ e BB h AA oː BC v BF a BB
ujeke	u BC d AK ʒ AJ eː BB ɠ BJ e BB
ujele	u BC d AK ʒ AJ eː BB l AE e BB
ujesu	u BC d AK ʒ AJ eː BB s AJ u BC
ujinja	u BC d AK ʒ AJ iː BB ɲ AG d AK ʒ AJ a BB
uju	uː BC d AK ʒ AJ u BC
ujusi	u BC d AK ʒ AJ uː BC s AJ i BB
ukhali	u BC kʰ AD aː BB l AE i BB
ukhamba	uː BC kʰ AD aː BB m AF b AH a BB
ukhetho	uː BC kʰ AD eː BB tʰ AL o BC
ukhisimusi	u BC kʰ AD i BB s AJ i BB m AF uː BC s AJ i BB
ukhokho	u BC kʰ AD oː BC kʰ AD o BC
ukholwase	u BC kʰ AD o BC l AE w AM aː BB s AJ e BB
ukhongolose	u BC kʰ AD o BC n AG ɡ AC o BC l AE oː BC s AJ e BB
ukhonkolo	u BC kʰ AD o BC n AG k AC oː BC l AE o BC
ukhophe	uː BC kʰ AD oː BC pʰ AI e BB
ukhozi	uː BC kʰ AD oː BC z AJ i BB
ukhuni	uː BC kʰ AD uː BC n AG i BB
ukhwathu	uː BC kʰ AD w AM aː BB tʰ AL u BC
ukhweshe	uː BC kʰ AD w AM eː BB ʃ AJ e BB
ukoko	u BC k AC oː BC k AC o BC
ukotini	u BC k AC o BC t AK iː BB n AG i BB
ukubulala	u BC ɠ BJ u BC ɓ BG u BC l AE aː BB l AE a BB
ukucwila	u BC ɠ BJ u BC ǀ w AM iː BB l AE a BB
ukudla	u BC ɠ BJ uː BC ɮ BI a BB
ukudoba	u BC ɠ BJ u BC d AK oː BC ɓ BG a BB
ukudweba	u BC ɠ BJ u BC d AK w AM eː BB ɓ BG a BB
ukufa	u BC ɠ BJ uː BC f BF a BB
ukugeza	u BC ɠ BJ u BC ɡ AC eː BB z AJ a BB
ukugqwala	u BC ɠ BJ u BC ǃʱ w AM aː BB l AE a BB
ukugula	u BC ɠ BJ u BC ɡ AC uː BC l AE a BB
ukugxeka	u BC ɠ BJ u BC ǁʱ eː BB ɠ BJ a BB
ukuhlamba	u BC ɠ BJ u BC ɬ BI aː BB m AF b AH a BB
ukuhlikihla	u BC ɠ BJ u BC ɬ BI i BB ɠ BJ iː BB ɬ BI a BB
ukuhlwa	u BC ɠ BJ uː BC ɬ BI w AM a BB
ukukhanya	u BC ɠ BJ u BC kʰ AD aː BB ɲ AG a BB
ukulwa	u BC ɠ BJ uː BC l AE w AM a BB
ukuma	u BC ɠ BJ uː BC m AF a BB
ukumangala	u BC ɠ BJ u BC m AF a BB n AG ɡ AC aː BB l AE a BB
ukuna	u BC ɠ BJ uː BC n AG a BB
ukuncoma	u BC ɠ BJ u BC ǀ oː BC m AF a BB
ukunene	u BC ɠ BJ u BC n AG eː BB n AG e BB
ukungcola	u BC ɠ BJ u BC ǀʱ oː BC l AE a BB
ukungenisa	u BC ɠ BJ u BC n AG ɡ AC e BB n AG iː BB s AJ a BB
ukungqubuzana	u BC ɠ BJ u BC ǃʱ u BC ɓ BG u BC z AJ aː BB n AG a BB
ukunqoba	u BC ɠ BJ u BC ǃ oː BC ɓ BG a BB
ukunto	u BC ɠ BJ uː BC n AG t AK o BC
ukuntshontsha	u BC ɠ BJ u BC ɲ AG t AK ʃ AJ oː BC ɲ AG t AK ʃ AJ a BB
ukunxele	u BC ɠ BJ u BC ǁ eː BB l AE e BB
ukunyenyeza	u BC ɠ BJ u BC ɲ AG e BB ɲ AG eː BB z AJ a BB
ukupela	u BC ɠ BJ u BC p AH eː BB l AE a BB
ukupheka	u BC ɠ BJ u BC pʰ AI eː BB ɠ BJ a BB
ukuphela	u BC ɠ BJ u BC pʰ AI eː BB l AE a BB
ukuphoqa	u BC ɠ BJ u BC pʰ AI oː BC ǃ a BB
ukuphutha	u BC ɠ BJ u BC pʰ AI uː BC tʰ AL a BB
ukuqala	u BC ɠ BJ u BC ǃ aː BB l AE a BB
ukuqaphela	u BC ɠ BJ u BC ǃ a BB pʰ AI eː BB l AE a BB
ukuqhuma	u BC ɠ BJ u BC ǃʰ uː BC m AF a BB
ukuqoma	u BC ɠ BJ u BC ǃ oː BC m AF a BB
ukusa	u BC ɠ BJ uː BC s AJ a BB
ukushisa	u BC ɠ BJ u BC ʃ AJ iː BB s AJ a BB
ukuthula	u BC ɠ BJ u BC tʰ AL uː BC l AE a BB
ukuze	u BC ɠ BJ uː BC z AJ e BB
ukuzibulala	u BC ɠ BJ u BC z AJ i BB ɓ BG u BC l AE aː BB l AE a BB
ukuzigqaja	u BC ɠ BJ u BC z AJ i BB ǃʱ aː BB d AK ʒ AJ a BB
ukwi	uː BC k AC w AM i BB
ukwindla	u BC ɠ BJ w AM iː BB n AG ɮ BI a BB
ulale kahle	u BC l AE a BB l AE e BB ɠ BJ aː BB ɬ BI e BB
uletisi	u BC l AE e BB t AK iː BB s AJ i BB
ulimi	uː BC l AE iː BB m AF i BB
ulwandle	uː BC l AE w AM aː BB n AG ɮ BI e BB
ulwazi	uː BC l AE w AM aː BB z AJ i BB
ulwesibili	u BC l AE w AM e BB s AJ i BB ɓ BG iː BB l AE i BB
ulwesihlanu	u BC l AE w AM e BB s AJ i BB ɬ BI aː BB n AG u BC
ulwesine	u BC l AE w AM e BB s AJ iː BB n AG e BB
ulwesithathu	u BC l AE w AM e BB s AJ i BB tʰ AL aː BB tʰ AL u BC
ulwezi	uː BC l AE w AM eː BB z AJ i BB
uma	uː BC m AF a BB
umabelo	u BC m AF a BB ɓ BG eː BB l AE o BC
umabi	u BC m AF aː BB ɓ BG i BB
umabo	u BC m AF aː BB ɓ BG o BC
umafikazisina	u BC m AF a BB f BF i BB ɠ BJ a BB z AJ i BB s AJ iː BB n AG a BB
umakhelwane	u BC m AF a BB kʰ AD e BB l AE w AM aː BB n AG e BB
umakhi	u BC m AF aː BB kʰ AD i BB
umalukazi	u BC m AF a BB l AE u BC ɠ BJ aː BB z AJ i BB
umalume	u BC m AF a BB l AE uː BC m AF e BB
umama	u BC mʱ BL aː BB m AF a BB
umame	u BC m AF aː BB m AF e BB
umandulo	u BC m AF a BB n AG d AK uː BC l AE o BC
umaquba	u BC m AF a BB ǃ uː BC ɓ BG a BB
umashiqela	u BC m AF a BB ʃ AJ i BB ǃ eː BB l AE a BB
umasingana	u BC m AF a BB s AJ i BB n AG ɡ AC aː BB n AG a BB
umata	u BC m AF aː BB t AK a BB
umbala	u BC m̩ BH ɓ BG aː BB l AE a BB
umbaso	u BC m̩ BH ɓ BG aː BB s AJ o BC
umbayimbayi	u BC m AF b AH a BB j AB i BB m AF b AH aː BB j AB i BB
umbhali	u BC m̩ BH b AH aː BB l AE i BB
umbhalo	u BC m̩ BH b AH aː BB l AE o BC
umbhede	u BC m̩ BH b AH eː BB d AK e BB
umbhicongo	u BC m̩ BH b AH i BB ǀ oː BC n AG ɡ AC o BC
umbhidli	u BC m̩ BH b AH iː BB ɮ BI i BB
umbhubhudlo	u BC m̩ BH b AH u BC b AH uː BC ɮ BI o BC
umbiko	u BC m̩ BH ɓ BG iː BB ɠ BJ o BC
umboko	u BC m̩ BH ɓ BG oː BC ɠ BJ o BC
umbombo	u BC m̩ BH ɓ BG oː BC m AF b AH o BC
umbono	u BC m̩ BH ɓ BG oː BC n AG o BC
umbulali	u BC m̩ BH ɓ BG u BC l AE aː BB l AE i BB
umcebo	u BC m̩ BH ǀ eː BB ɓ BG o BC
umcubungulo	u BC m̩ BH ǀ u BC ɓ BG u BC n AG ɡ AC uː BC l AE o BC
umculo	u BC m̩ BH ǀ uː BC l AE o BC
umcwaningi	u BC m̩ BH ǀ w AM a BB n AG iː BB n AG ɡ AC i BB
umcwebo	u BC m̩ BH ǀ w AM eː BB ɓ BG o BC
umdabu	u BC m̩ BH d AK aː BB ɓ BG u BC
umdanso	u BC m̩ BH d AK aː BB n AG s AJ o BC
umdidi	u BC m̩ BH d AK iː BB d AK i BB
umdlali	u BC m̩ BH ɮ BI aː BB l AE i BB
umdlalo	u BC m̩ BH ɮ BI aː BB l AE o BC
umdlwenguli	u BC m̩ BH ɮ BI w AM e BB n AG ɡ AC uː BC l AE i BB
umduzu	u BC m̩ BH d AK uː BC z AJ u BC
umdwebo	u BC m̩ BH d AK w AM eː BB ɓ BG o BC
umdweshu	u BC m̩ BH d AK w AM eː BB ʃ AJ u BC
umebo	u BC m AF eː BB ɓ BG o BC
umelusi	u BC m AF e BB l AE uː BC s AJ i BB
umendo	u BC m AF eː BB n AG d AK o BC
umenzi	u BC m AF eː BB n AG z AJ i BB
umese	u BC mʱ BL eː BB s AJ e BB
umfana	u BC m̩ BH f BF aː BB n AG a BB
umfanyana	u BC m̩ BH f BF a BB ɲ AG aː BB n AG a BB
umfazi	u BC m̩ BH f BF aː BB z AJ i BB
umfelokazi	u BC m̩ BH f BF e BB l AE o BC ɠ BJ aː BB z AJ i BB
umfino	u BC m̩ BH f BF iː BB n AG o BC
umfokazana	u BC m̩ BH f BF o BC ɠ BJ a BB z AJ aː BB n AG a BB
umfokazi	u BC m̩ BH f BF o BC ɠ BJ aː BB z AJ i BB
umfudlana	u BC m̩ BH f BF u BC ɮ BI aː BB n AG a BB
umfula	u BC m̩ BH f BF uː BC l AE a BB
umfumfu	u BC m AF f BF uː BC m AF f BF u BC
umfundi	u BC m̩ BH f BF uː BC n AG d AK i BB
umfundisi	u BC m̩ BH f BF u BC n AG d AK iː BB s AJ i BB
umgankla	u BC m̩ BH ɡ AC aː BB n AG k AC l AE a BB
umganu	u BC m̩ BH ɡ AC aː BB n AG u BC
umgcagco	u BC m̩ BH ǀʱ aː BB ǀʱ o BC
umgede	u BC m̩ BH ɡ AC eː BB d AK e BB
umgibeli	u BC m̩ BH ɡ AC i BB ɓ BG eː BB l AE i BB
umgodi	u BC m̩ BH ɡ AC oː BC d AK i BB
umgqibelo	u BC m̩ BH ǃʱ i BB ɓ BG eː BB l AE o BC
umgqomo	u BC m AF ǃʱ oː BC m AF o BC
umgqulo	u BC m̩ BH ǃʱ uː BC l AE o BC
umgungundlovu	u BC m̩ BH ɡ AC u BC n AG ɡ AC u BC n AG ɮ BI oː BC v BF u BC
umgwamanda	u BC m̩ BH ɡ AC w AM a BB m AF aː BB n AG d AK a BB
umgwaqana	u BC m̩ BH ɡ AC w AM a BB ǃ aː BB n AG a BB
umgwaqo	u BC m̩ BH ɡ AC w AM aː BB ǃ o BC
umgwebi	u BC m̩ BH ɡ AC w AM eː BB ɓ BG i BB
umgwenya	u BC m̩ BH ɡ AC w AM eː BB ɲ AG a BB
umgxala	u BC m̩ BH ǁʱ aː BB l AE a BB
umhlaba	u BC m̩ BH ɬ BI aː BB ɓ BG a BB
umhlabathi	u BC m̩ BH ɬ BI a BB ɓ BG aː BB tʰ AL i BB
umhlane	u BC m̩ BH ɬ BI aː BB n AG e BB
umhlanga	u BC m̩ BH ɬ BI aː BB n AG ɡ AC a BB
umhlangano	u BC m̩ BH ɬ BI a BB n AG ɡ AC aː BB n AG o BC
umhlaza	u BC m̩ BH ɬ BI aː BB z AJ a BB
umhleli	u BC m̩ BH ɬ BI eː BB l AE i BB
umhlengi	u BC m̩ BH ɬ BI eː BB n AG ɡ AC i BB
umhlobo	u BC m̩ BH ɬ BI oː BC ɓ BG o BC
umhlophe	u BC m̩ BH ɬ BI oː BC pʰ AI e BB
umhlophekazi	u BC m̩ BH ɬ BI o BC pʰ AI e BB ɠ BJ aː BB z AJ i BB
umhlukazi	u BC m̩ BH ɬ BI u BC ɠ BJ aː BB z AJ i BB
umhluzi	u BC m̩ BH ɬ BI uː BC z AJ i BB
umhlwazi	u BC m̩ BH ɬ BI w AM aː BB z AJ i BB
umhuzulo	u BC m̩ BH h AA u BC z AJ uː BC l AE o BC
umhwebi	u BC m̩ BH h AA w AM eː BB ɓ BG i BB
umhwebo	u BC m̩ BH h AA w AM eː BB ɓ BG o BC
umisi	u BC m AF iː BB s AJ i BB
umjaho	u BC m̩ BH d AK ʒ AJ aː BB h AA o BC
umjondolo	u BC m̩ BH d AK ʒ AJ o BC n AG d AK oː BC l AE o BC
umjovo	u BC m̩ BH d AK ʒ AJ oː BC v BF o BC
umkhabo	u BC m̩ BH kʰ AD aː BB ɓ BG o BC
umkhathi	u BC m̩ BH kʰ AD aː BB tʰ AL i BB
umkhawulo	u BC m̩ BH kʰ AD a BB w AM uː BC l AE o BC
umkhaya	u BC m̩ BH kʰ AD aː BB j AB a BB
umkhemese	u BC m AF kʰ AD e BB m AF eː BB s AJ e BB
umkhetho	u BC m̩ BH kʰ AD eː BB tʰ AL o BC
umkhomazi	u BC m̩ BH kʰ AD o BC m AF aː BB z AJ i BB
umkhombo	u BC m̩ BH kʰ AD oː BC m AF b AH o BC
umkhomo	u BC m̩ BH kʰ AD oː BC m AF o BC
umkhono	u BC m̩ BH kʰ AD oː BC n AG o BC
umkhonto	u BC m̩ BH kʰ AD oː BC n AG t AK o BC
umkhuba	u BC m̩ BH kʰ AD uː BC ɓ BG a BB
umkhulu	u BC m̩ BH kʰ AD uː BC l AE u BC
umkhumbi	u BC m̩ BH kʰ AD uː BC m AF b AH i BB
umkhwekazi	u BC m̩ BH kʰ AD w AM e BB ɠ BJ aː BB z AJ i BB
umkhwenyana	u BC m̩ BH kʰ AD w AM e BB ɲ AG aː BB n AG a BB
umklomelo	u BC m̩ BH k AC x BE o BC m AF eː BB l AE o BC
umlambo	u BC m̩ BH l AE aː BB m AF b AH o BC
umlamu	u BC m̩ BH l AE aː BB m AF u BC
umlenze	u BC m̩ BH l AE eː BB n AG z AJ e BB
umlilo	u BC m̩ BH l AE iː BB l AE o BC
umlisa	u BC m̩ BH l AE iː BB s AJ a BB
umlobokazi	u BC m̩ BH l AE o BC ɓ BG o BC ɠ BJ aː BB z AJ i BB
umlomo	u BC m̩ BH l AE oː BC m AF o BC
umlotha	u BC m̩ BH l AE oː BC tʰ AL a BB
umlungu	u BC m̩ BH l AE uː BC n AG ɡ AC u BC
ummbila	u BC m̩ BH m AF b AH iː BB l AE a BB
ummese	u BC m̩ BH m AF eː BB s AJ e BB
umncintiswano	u BC m̩ BH ǀ i BB n AG t AK i BB s AJ w AM aː BB n AG o BC
umndeni	u BC m̩ BH n AG d AK eː BB n AG i BB
umngane	u BC m̩ BH n AG ɡ AC aː BB n AG e BB
umngcwabo	u BC m̩ BH ǀʱ w AM aː BB ɓ BG o BC
umngqithi	u BC m̩ BH ǃʱ iː BB tʰ AL i BB
umngquphane	u BC m̩ BH ǃʱ u BC pʰ AI aː BB n AG e BB
umnguni	u BC m̩ BH n AG ɡ AC uː BC n AG i BB
umnqobi	u BC m AF ǃ oː BC ɓ BG i BB
umnqumo	u BC m̩ BH ǃ uː BC m AF o BC
umntwana	u BC m̩ BH n AG t AK w AM aː BB n AG a BB
umnyama	u BC m̩ BH ɲ AG aː BB m AF a BB
umnyango	u BC m̩ BH ɲ AG aː BB n AG ɡ AC o BC
umnyelele	u BC m̩ BH ɲ AG e BB l AE eː BB l AE e BB
umoba	u BC m AF oː BC ɓ BG a BB
umona	u BC m AF oː BC n AG a BB
umoya	u BC m AF oː BC j AB a BB
umpetshisi	u BC m̩ BH p AH e BB t AK ʃ AJ iː BB s AJ i BB
umphakathi	u BC m̩ BH pʰ AI a BB ɠ BJ aː BB tʰ AL i BB
umphako	u BC m̩ BH pʰ AI aː BB ɠ BJ o BC
umphambili	u BC m̩ BH pʰ AI a BB m AF b AH iː BB l AE i BB
umphansi	u BC m̩ BH pʰ AI aː BB n AG s AJ i BB
umphefumulo	u BC m̩ BH pʰ AI e BB f BF u BC m AF uː BC l AE o BC
umpheki	u BC m̩ BH pʰ AI eː BB ɠ BJ i BB
umphimbo	u BC m̩ BH pʰ AI iː BB m AF b AH o BC
umphumela	u BC m̩ BH pʰ AI u BC m AF eː BB l AE a BB
umqala	u BC m̩ BH ǃ aː BB l AE a BB
umqali	u BC m̩ BH ǃ aː BB l AE i BB
umqamelo	u BC m̩ BH ǃ a BB m AF eː BB l AE o BC
umqhele	u BC m̩ BH ǃʰ eː BB l AE e BB
umqolo	u BC m̩ BH ǃ oː BC l AE o BC
umqondo	u BC m̩ BH ǃ oː BC n AG d AK o BC
umqophi	u BC m̩ BH ǃ oː BC pʰ AI i BB
umqotho	u BC m̩ BH ǃ oː BC tʰ AL o BC
umquba	u BC m̩ BH ǃ uː BC ɓ BG a BB
umqwakuza	u BC m̩ BH ǃ w AM a BB ɠ BJ uː BC z AJ a BB
umsebenzi	u BC m̩ BH s AJ e BB ɓ BG eː BB n AG z AJ i BB
umsebenzisi	u BC m̩ BH s AJ e BB ɓ BG e BB n AG z AJ iː BB s AJ i BB
umshado	u BC m̩ BH ʃ AJ aː BB d AK o BC
umshana	u BC m̩ BH ʃ AJ aː BB n AG a BB
umshini	u BC m̩ BH ʃ AJ iː BB n AG i BB
umshiya	u BC m̩ BH ʃ AJ iː BB j AB a BB
umshumayeli	u BC m̩ BH ʃ AJ u BC m AF a BB j AB eː BB l AE i BB
umshushisi	u BC m̩ BH ʃ AJ u BC ʃ AJ iː BB s AJ i BB
umshushiso	u BC m̩ BH ʃ AJ u BC ʃ AJ iː BB s AJ o BC
umshwana	u BC m̩ BH ʃ AJ w AM aː BB n AG a BB
umsila	u BC m̩ BH s AJ iː BB l AE a BB
umsindo	u BC m̩ BH s AJ iː BB n AG d AK o BC
umsombuluko	u BC m̩ BH s AJ o BC m AF b AH u BC l AE uː BC ɠ BJ o BC
umsuka	u BC m̩ BH s AJ uː BC ɠ BJ a BB
umsundu	u BC m̩ BH s AJ uː BC n AG d AK u BC
umsuthu	u BC m̩ BH s AJ uː BC tʰ AL u BC
umswakama	u BC m̩ BH s AJ w AM a BB ɠ BJ aː BB m AF a BB
umtata	u BC m̩ BH t AK aː BB t AK a BB
umthambo	u BC m̩ BH tʰ AL aː BB m AF b AH o BC
umthamo	u BC m̩ BH tʰ AL aː BB m AF o BC
umthandi	u BC m̩ BH tʰ AL aː BB n AG d AK i BB
umthembu	u BC m̩ BH tʰ AL eː BB m AF b AH u BC
umthetho	u BC m̩ BH tʰ AL eː BB tʰ AL o BC
umthofu	u BC m̩ BH tʰ AL oː BC f BF u BC
umthombo	u BC m̩ BH tʰ AL oː BC m AF b AH o BC
umthunzi	u BC m̩ BH tʰ AL uː BC n AG z AJ i BB
umthuqu	u BC m̩ BH tʰ AL uː BC ǃ u BC
umthwalo	u BC m AF tʰ AL w AM aː BB l AE o BC
umtoti	u BC m̩ BH t AK oː BC t AK i BB
umtshwana	u BC m̩ BH t AK ʃ AJ w AM aː BB n AG a BB
umtswana	u BC m̩ BH t AK s AJ w AM aː BB n AG a BB
umtube	u BC m̩ BH t AK uː BC ɓ BG e BB
umudwa	u BC m AF uː BC d AK w AM a BB
umufi	u BC m AF uː BC f BF i BB
umufo	u BC m AF uː BC f BF o BC
umuga	u BC m AF uː BC ɡ AC a BB
umugqa	u BC m AF uː BC ǃʱ a BB
umuhla	u BC m AF uː BC ɬ BI a BB
umuhlwa	u BC m AF uː BC ɬ BI w AM a BB
umukhwa	u BC m AF uː BC kʰ AD w AM a BB
umukhwe	u BC m AF uː BC kʰ AD w AM e BB
umumba	u BC m AF uː BC m AF b AH a BB
umumbi	u BC m AF uː BC m AF b AH i BB
umumo	u BC m AF uː BC m AF o BC
umunca	uː BC m AF uː BC ǀ a BB
umunqa	u BC m AF uː BC ǃ a BB
umunswi	u BC m AF uː BC n AG s AJ w AM i BB
umuntu	u BC m AF uː BC n AG t AK u BC
umuntu ngumuntu ngabantu	u BC m AF u BC n AG t AK u BC n AG ɡ AC u BC m AF u BC n AG t AK u BC n AG ɡ AC a BB ɓ BG aː BB n AG t AK u BC
umunwe	u BC m AF uː BC n AG w AM e BB
umunyu	u BC m AF uː BC ɲ AG u BC
umusa	u BC m AF uː BC s AJ a BB
umusho	u BC m AF uː BC ʃ AJ o BC
umusi	u BC m AF uː BC s AJ i BB
umuso	u BC m AF uː BC s AJ o BC
umuthi	u BC m AF uː BC tʰ AL i BB
umuthwa	u BC m AF uː BC tʰ AL w AM a BB
umuva	u BC m AF uː BC v BF a BB
umuvi	u BC m AF uː BC v BF i BB
umuwa	u BC m AF uː BC w AM a BB
umuzi	u BC m AF uː BC z AJ i BB
umuzwa	u BC m AF uː BC z AJ w AM a BB
umvimba	u BC m̩ BH v BF iː BB m AF b AH a BB
umvingqi	u BC m AF v BF iː BB ǃʱ i BB
umvithi	u BC m̩ BH v BF iː BB tʰ AL i BB
umvoti	u BC m̩ BH v BF oː BC t AK i BB
umvubu	u BC m̩ BH v BF uː BC ɓ BG u BC
umvundla	u BC m̩ BH v BF uː BC n AG ɮ BI a BB
umvuno	u BC m̩ BH v BF uː BC n AG o BC
umvuzi	u BC m̩ BH v BF uː BC z AJ i BB
umvuzo	u BC m̩ BH v BF uː BC z AJ o BC
umxhapho	u BC m̩ BH ǁʰ aː BB pʰ AI o BC
umxhosa	u BC m̩ BH ǁʰ oː BC s AJ a BB
umyeni	u BC m̩ BH j AB eː BB n AG i BB
umzala	u BC m̩ BH z AJ aː BB l AE a BB
umzali	u BC m̩ BH z AJ aː BB l AE i BB
umzamo	u BC m̩ BH z AJ aː BB m AF o BC
umzekelo	u BC m̩ BH z AJ e BB ɠ BJ eː BB l AE o BC
umzimba	u BC m̩ BH z AJ iː BB m AF b AH a BB
umzingeli	u BC m̩ BH z AJ i BB n AG ɡ AC eː BB l AE i BB
umzukulu	u BC m̩ BH z AJ u BC ɠ BJ uː BC l AE u BC
umzulu	u BC m̩ BH z AJ uː BC l AE u BC
umzuzu	u BC m̩ BH z AJ uː BC z AJ u BC
umzuzwana	u BC m̩ BH z AJ u BC z AJ w AM aː BB n AG a BB
uncedo	uː BC ǀ eː BB d AK o BC
uncibijane	u BC ǀ i BB ɓ BG i BB d AK ʒ AJ aː BB n AG e BB
uncwaba	u BC ǀ w AM aː BB ɓ BG a BB
undasa	u BC n AG d AK aː BB s AJ a BB
unesi	u BC n AG eː BB s AJ i BB
ungcede	u BC ǀʱ eː BB d AK e BB
ungqi	uː BC ǃʱ i BB
ungqo	uː BC ǃʱ o BC
ungqongqoshe	u BC ǃʱ o BC ǃʱ oː BC ʃ AJ e BB
ungulazibuya	u BC n AG ɡ AC u BC l AE a BB z AJ i BB ɓ BG uː BC j AB a BB
ungwaqa	u BC n AG ɡ AC w AM aː BB ǃ a BB
unhlaba	u BC n AG ɬ BI aː BB ɓ BG a BB
unhlangula	u BC n AG ɬ BI a BB n AG ɡ AC uː BC l AE a BB
unhlangulana	u BC n AG ɬ BI a BB n AG ɡ AC u BC l AE aː BB n AG a BB
unhlolanja	u BC n AG ɬ BI o BC l AE aː BB ɲ AG d AK ʒ AJ a BB
unina	u BC n AG iː BB n AG a BB
unkamisa	u BC n AG k AC a BB m AF iː BB s AJ a BB
unkulunkulu	u BC n AG k AC u BC l AE u BC n AG k AC uː BC l AE u BC
unobhala	u BC n AG o BC b AH aː BB l AE a BB
unogwaja	u BC n AG o BC ɡ AC w AM aː BB d AK ʒ AJ a BB
unohha	u BC nʱ BM oː BC ɦ AA a BB
unondwebu	u BC n AG o BC n AG d AK w AM eː BB ɓ BG u BC
unqangi	u BC ǃ aː BB n AG ɡ AC i BB
unswinswinswi	u BC n AG s AJ w AM i BB n AG s AJ w AM iː BB n AG s AJ w AM i BB
untulikazi	u BC n AG t AK u BC l AE i BB ɠ BJ aː BB z AJ i BB
unwabu	uː BC n AG w AM aː BB ɓ BG u BC
unwele	uː BC n AG w AM eː BB l AE e BB
unya	uː BC ɲ AG a BB
unyaka	u BC ɲ AG aː BB ɠ BJ a BB
unyawo	uː BC ɲ AG aː BB w AM o BC
unyelele	uː BC ɲ AG e BB l AE eː BB l AE e BB
unyembezi	uː BC ɲ AG e BB m AF b AH eː BB z AJ i BB
unyezi	u BC ɲ AG eː BB z AJ i BB
unyoko	u BC ɲ AG oː BC ɠ BJ o BC
unzo	u BC n AG z AJ oː BC
unzoqhwishi	u BC n AG z AJ oː BC ǃʰ w AM iː BB ʃ AJ i BB
upende	u BC p AH eː BB n AG d AK e BB
uphahla	uː BC pʰ AI aː BB ɬ BI a BB
uphaphe	uː BC pʰ AI aː BB pʰ AI e BB
uphayinaphu	u BC pʰ AI a BB j AB i BB n AG aː BB pʰ AI u BC
uphepha	u BC pʰ AI eː BB pʰ AI a BB
uphephela	u BC pʰ AI e BB pʰ AI eː BB l AE a BB
uphondo	uː BC pʰ AI oː BC n AG d AK o BC
uqhezu	uː BC ǃʰ eː BB z AJ u BC
uqhoqhoqho	u BC ǃʰ o BC ǃʰ oː BC ǃʰ o BC
uqhwishi	u BC ǃʰ w AM iː BB ʃ AJ i BB
uqobo	uː BC ǃ oː BC ɓ BG o BC
usale kahle	u BC s AJ a BB l AE e BB ɠ BJ aː BB ɬ BI e BB
usana	uː BC s AJ aː BB n AG a BB
usapho	uː BC s AJ aː BB pʰ AI o BC
usawoti	u BC s AJ a BB w AM oː BC t AK i BB
usepthemba	u BC s AJ e BB p AH tʰ AL eː BB m AF b AH a BB
ushaka	u BC ʃ AJ aː BB ɠ BJ a BB
ushizi	u BC ʃ AJ iː BB z AJ i BB
ushukela	u BC ʃ AJ u BC ɠ BJ eː BB l AE a BB
usiba	uː BC s AJ iː BB ɓ BG a BB
usogekle	u BC s AJ o BC ɡ AC eː BB k AC x BE e BB
usuku	uː BC s AJ uː BC ɠ BJ u BC
utamatisi	u BC t AK a BB m AF a BB t AK iː BB s AJ i BB
uthando	uː BC tʰ AL aː BB n AG d AK o BC
uthi	uː BC tʰ AL i BB
uthuli	uː BC tʰ AL uː BC l AE i BB
utshana	u BC t AK ʃ AJ aː BB n AG a BB
utshani	u BC t AK ʃ AJ aː BB n AG i BB
utshwala	u BC t AK ʃ AJ w AM aː BB l AE a BB
uvalo	uː BC v BF aː BB l AE o BC
uve	uː BC v BF e BB
uvolo	u BC v BF oː BC l AE o BC
uweta	u BC w AM eː BB t AK a BB
uxamu	u BC ǁ aː BB m AF u BC
uxolo	uː BC ǁ oː BC l AE o BC
uyihlo	u BC j AB iː BB ɬ BI o BC
uyise	u BC j AB iː BB s AJ e BB
uzamcolo	u BC z AJ a BB m̩ BH ǀ oː BC l AE o BC
uzekamanzi	u BC z AJ e BB ɠ BJ a BB m AF aː BB n AG z AJ i BB
uzibandlela	u BC z AJ i BB ɓ BG a BB n AG ɮ BI eː BB l AE a BB
uzibuthe	u BC z AJ i BB ɓ BG uː BC tʰ AL e BB
uzipho	uː BC z AJ iː BB pʰ AI o BC
uzulu	u BC z AJ uː BC l AE u BC
vuya	v BF uː BC j AB a BB
wena	w AM eː BB n AG a BB
wololo	w AM o BC l AE o BC l AE oː BC
wona	w AM oː BC n AG a BB
xega	ǁ eː BB ɡ AC a BB
xegisa	ǁ e BB ɡ AC iː BB s AJ a BB
xhapha	ǁʰ aː BB pʰ AI a BB
xhasa	ǁʰ aː BB s AJ a BB
xhuga	ǁʰ uː BC ɡ AC a BB
xhuma	ǁʰ uː BC m AF a BB
xokozela	ǁ o BC ɠ BJ o BC z AJ eː BB l AE a BB
xola	ǁ oː BC l AE a BB
xoxa	ǁ oː BC ǁ a BB
xuba	ǁ uː BC ɓ BG a BB
xubana	ǁ u BC ɓ BG aː BB n AG a BB
xubha	ǁ uː BC b AH a BB
xwaya	ǁ w AM aː BB j AB a BB
xwayisa	ǁ w AM a BB j AB iː BB s AJ a BB
yebo	jʱ BK eː BB ɓ BG o BC
yeka	j AB eː BB ɠ BJ a BB
yena	j AB eː BB n AG a BB
yona	j AB oː BC n AG a BB
za	z AJ a BB
zala	z AJ aː BB l AE a BB
ze	z AJ e BB
zona	z AJ oː BC n AG a BB
