abantu	a AD ɓ aː AD n t u AE
amabele	a AD m a AD ɓ eː AD l e AD
amabhanqa	a AD m a AD b aː AD ǃ a AD
amafutha	a AD m a AD f uː AE tʰ a AD
amagcino	a AD m a AD ǀʱ iː AD n o AE
amahlebezi	a AD m a AD ɬ e AD ɓ eː AD z i AD
amahloni	a AD m a AD ɬ oː AE n i AD
amakha	a AD m aː AD kʰ a AD
amakhaza	a AD m a AD kʰ aː AD z a AD
amakhosi	a AD m a AD kʰ oː AE s i AD
amakhwezikhwezi	a AD m a AD kʰ w AC e AD z i AD kʰ w AC eː AD z i AD
amala	a AD m aː AD l a AD
amandla	a AD m aː AD n ɮ a AD
amanga	a AD m aː AD n ɡ a AD
amanqamu	a AD m a AD ǃ aː AD m u AE
amanyala	a AD m a AD ɲ aː AD l a AD
amanzi	a AD m aː AD n z i AD
amatata	a AD m a AD t aː AD t a AD
amathe	a AD m aː AD tʰ e AD
ayina	ʔ a AD j AB iː AD n a AD
bana	ɓ aː AD n a AD
bayede	ɓ a AD j AB eː AD d e AD
be	ɓ e AD
bona	ɓ oː AE n a AD
buhlungu	ɓ u AE ɬ uː AE n ɡ u AE
c	ǀ
cha	ǀʰ a AD
cishe	ǀ iː AD ʃ e AD
cwala	ǀ w AC aː AD l a AD
cwecwa	ǀ w AC eː AD ǀ w AC a AD
cwila	ǀ w AC iː AD l a AD
cwilisa	ǀ w AC i AD l iː AD s a AD
dabuka	d a AD ɓ uː AE ɠ a AD
dana	d aː AD n a AD
dla	ɮ a AD
dlala	ɮ aː AD l a AD
dlwengula	ɮ w AC e AD n ɡ uː AE l a AD
duma	d uː AE m a AD
dwa	d w AC a AD
ebula	e AD ɓ uː AE l a AD
ebuza	e AD ɓ uː AE z a AD
eluka	e AD l uː AE ɠ a AD
engeza	e AD n ɡ eː AD z a AD
ethwasa	e AD tʰ w AC aː AD s a AD
fa	f a AD
funa	f uː AE n a AD
futhi	f uː AE tʰ i AD
fuya	f uː AE j AB a AD
gaya	ɡ aː AD j AB a AD
gcoba	ǀʱ oː AE ɓ a AD
gcwalisa	ǀʱ w AC a AD l iː AD s a AD
gqagqa	ǃʱ aː AD ǃʱ a AD
gqagqaza	ǃʱ a AD ǃʱ aː AD z a AD
gqaja	ǃʱ aː AD d ʒ a AD
gqama	ǃʱ aː AD m a AD
gqamuka	ǃʱ a AD m uː AE ɠ a AD
gqekeza	ǃʱ e AD ɠ eː AD z a AD
gqola	ǃʱ oː AE l a AD
gqula	ǃʱ uː AE l a AD
gqwala	ǃʱ w AC aː AD l a AD
gwansa	ɡ w AC aː AD n s a AD
gwavuma	ɡ w AC a AD v uː AE m a AD
gwaza	ɡ w AC aː AD z a AD
gwedla	ɡ w AC eː AD ɮ a AD
gwema	ɡ w AC eː AD m a AD
gwinqa	ɡ w AC iː AD ǃ a AD
gwinya	ɡ w AC iː AD ɲ a AD
gxeka	ǁʱ eː AD ɠ a AD
gxila	ǁʱ iː AD l a AD
hamba kahle	h AA a AD m b a AD ɠ aː AD ɬ e AD
hambani kahle	h AA a AD m b a AD n i AD ɠ aː AD ɬ e AD
hawu	h AA aː AD w AC u AE
hlafuna	ɬ a AD f uː AE n a AD
hleka	ɬ eː AD ɠ a AD
hleze	ɬ eː AD z e AD
hlikihla	ɬ i AD ɠ iː AD ɬ a AD
hlobonga	ɬ o AE ɓ oː AE n ɡ a AD
hlonipha	ɬ o AE n iː AD pʰ a AD
ibala	iː AD ɓ aː AD l a AD
ibandla	i AD ɓ aː AD n ɮ a AD
ibele	iː AD ɓ eː AD l e AD
ibhaka	iː AD b aː AD ɠ a AD
ibhakede	iː AD b a AD ɠ eː AD d e AD
ibhala	iː AD b aː AD l a AD
ibhanoyi	iː AD b a AD n oː AE j AB i AD
ibhantshi	iː AD b aː AD ɲ t ʃ i AD
ibhasi	iː AD b aː AD s i AD
ibhayibheli	iː AD b a AD j AB i AD b eː AD l i AD
ibhayisikili	iː AD b a AD j AB i AD s i AD k iː AD l i AD
ibhayisikobho	iː AD b a AD j AB i AD s i AD k oː AE b o AE
ibhaza	iː AD b a AD z aː AD
ibhentshi	iː AD b eː AD ɲ t ʃ i AD
ibhimbi	iː AD b iː AD m b i AD
ibhodlela	iː AD b o AE ɮ eː AD l a AD
ibhodlo	iː AD b oː AE ɮ o AE
ibhodwe	iː AD b oː AE d w AC e AD
ibhokisi	iː AD b o AE ɠ iː AD s i AD
ibhola	iː AD b oː AE l a AD
ibhomu	iː AD b oː AE m u AE
ibhotela	iː AD b o AE t eː AD l a AD
ibhubesi	iː AD b u AE ɓ eː AD s i AD
ibhudla	iː AD b uː AE ɮ a AD
ibhuku	iː AD b uː AE ɠ u AE
ibhulakufesi	iː AD b u AE l a AD ɠ u AE f eː AD s i AD
ibhulashi	iː AD b u AE l aː AD ʃ i AD
ibhuleki	iː AD b u AE l eː AD ɠ i AD
ibhulukwe	iː AD b u AE l uː AE ɠ w AC e AD
ibhungane	iː AD b u AE n ɡ aː AD n e AD
ibhunu	iː AD b uː AE n u AE
ibizo	iː AD ɓ iː AD z o AE
ibomvu	iː AD ɓ oː AE m v u AE
ibululu	iː AD ɓ u AE l uː AE l u AE
ibumba	iː AD ɓ uː AE m b a AD
ibunzi	iː AD ɓ uː AE n z i AD
icebo	iː AD ǀ eː AD ɓ o AE
icele	iː AD ǀ eː AD l e AD
ichibi	iː AD ǀʰ iː AD ɓ i AD
ichopho	iː AD ǀʰ oː AE pʰ o AE
ichwane	iː AD ǀʰ w AC aː AD n e AD
icici	iː AD ǀ iː AD ǀ i AD
icilongo	iː AD ǀ i AD l oː AE n ɡ o AE
icukazi	iː AD ǀ u AE ɠ aː AD z i AD
iculo	iː AD ǀ uː AE l o AE
idada	iː AD d aː AD d a AD
idesiki	iː AD d e AD s iː AD ɠ i AD
idikazi	iː AD d i AD ɠ aː AD z i AD
idimoni	iː AD d i AD m oː AE n i AD
idlaka	iː AD ɮ aː AD ɠ a AD
idlozi	iː AD ɮ oː AE z i AD
idolo	iː AD d oː AE l o AE
idolobha	iː AD d o AE l oː AE b a AD
idube	iː AD d uː AE ɓ e AD
iduku	iː AD d uː AE ɠ u AE
idwala	iː AD d w AC aː AD l a AD
idweshu	iː AD d w AC eː AD ʃ u AE
ifa	iː AD f a AD
ifilimu	iː AD f i AD l iː AD m u AE
ifleyistata	i AD f l e AD j AB i AD s t aː AD t a AD
ifosholo	iː AD f o AE ʃ oː AE l o AE
ifotho	iː AD f oː AE tʰ o AE
ifu	iː AD f u AE
ifulentshi	iː AD f u AE l eː AD ɲ t ʃ i AD
igagasi	iː AD ɡ a AD ɡ aː AD s i AD
igalaji	iː AD ɡ a AD l aː AD d ʒ i AD
igalofu	iː AD ɡ a AD l oː AE f u AE
igama	iː AD ɡ aː AD m a AD
iganu	iː AD ɡ aː AD n u AE
igazi	iː AD ɡ aː AD z i AD
igceke	iː AD ǀʱ eː AD ɠ e AD
igciwane	iː AD ǀʱ i AD w AC aː AD n e AD
igcukumuva	iː AD ǀʱ u AE ɠ u AE m uː AE v a AD
igedlela	iː AD ɡ e AD ɮ eː AD l a AD
igeja	iː AD ɡ eː AD d ʒ a AD
igeza	iː AD ɡ eː AD z a AD
igilavu	iː AD ɡ i AD l aː AD v u AE
igilebhisi	iː AD ɡ i AD l e AD b iː AD s i AD
igobongo	iː AD ɡ o AE ɓ oː AE n ɡ o AE
igola	iː AD ɡ oː AE l a AD
igoli	iː AD ɡ oː AE l i AD
igolide	iː AD ɡ o AE l iː AD d e AD
igoqo	iː AD ɡ oː AE ǃ o AE
igqubu	iː AD ǃʱ uː AE ɓ u AE
igquma	iː AD ǃʱ uː AE m a AD
igqwetha	iː AD ǃʱ w AC eː AD tʰ a AD
igugu	iː AD ɡ uː AE ɡ u AE
igula	iː AD ɡ uː AE l a AD
igumbi	iː AD ɡ uː AE m b i AD
igundane	iː AD ɡ u AE n d aː AD n e AD
igundwane	iː AD ɡ u AE n d w AC aː AD n e AD
igwababa	iː AD ɡ w AC a AD ɓ aː AD ɓ a AD
igwala	iː AD ɡ w AC aː AD l a AD
igwebu	iː AD ɡ w AC eː AD ɓ u AE
igwenya	iː AD ɡ w AC eː AD ɲ a AD
igwinya	iː AD ɡ w AC iː AD ɲ a AD
igxolo	iː AD ǁʱ oː AE l o AE
ihansi	iː AD h AA aː AD n s i AD
ihawa	iː AD h AA aː AD w AC a AD
ihembe	iː AD h AA eː AD m b e AD
ihhala	iː AD ɦ AA aː AD l a AD
ihhashi	iː AD ɦ AA aː AD ʃ i AD
ihhofu	iː AD ɦ AA oː AE f u AE
ihholo	iː AD ɦ AA oː AE l o AE
ihhotela	iː AD ɦ AA o AE t eː AD l a AD
ihhovisi	iː AD ɦ AA o AE v iː AD s i AD
ihlahla	iː AD ɬ aː AD ɬ a AD
ihlakani	iː AD ɬ a AD ɠ aː AD n i AD
ihlathi	iː AD ɬ aː AD tʰ i AD
ihlaya	iː AD ɬ aː AD j AB a AD
ihlelo	iː AD ɬ eː AD l o AE
ihlezi	iː AD ɬ eː AD z i AD
ihlo	iː AD ɬ o AE
ihlobo	iː AD ɬ oː AE ɓ o AE
ihlombe	iː AD ɬ oː AE m b e AD
ihlumela	iː AD ɬ u AE m eː AD l a AD
iholide	iː AD h AA o AE l iː AD d e AD
ihora	iː AD h AA oː AE r a AD
ihubo	iː AD h AA uː AE ɓ o AE
ijaji	iː AD d ʒ aː AD d ʒ i AD
ijazi	iː AD d ʒ aː AD z i AD
ijele	iː AD d ʒ eː AD l e AD
ijezi	iː AD d ʒ eː AD z i AD
ijokwe	iː AD d ʒ oː AE ɠ w AC e AD
ijongosi	iː AD d ʒ o AE n ɡ oː AE s i AD
ijuba	iː AD d ʒ uː AE ɓ a AD
ijubane	iː AD d ʒ u AE ɓ aː AD n e AD
ikalikuni	iː AD k a AD l i AD k uː AE n i AD
ikamela	iː AD k a AD m eː AD l a AD
ikati	iː AD k aː AD t i AD
ikatshana	iː AD k a AD t ʃ aː AD n a AD
ikesi	iː AD k eː AD s i AD
ikewu	iː AD k eː AD w AC u AE
ikhabe	iː AD kʰ aː AD ɓ e AD
ikhabethe	iː AD kʰ a AD ɓ eː AD tʰ e AD
ikhala	iː AD kʰ aː AD l a AD
ikhalenda	iː AD kʰ a AD l eː AD n d a AD
ikhanda	iː AD kʰ aː AD n d a AD
ikhanjana	iː AD kʰ a AD ɲ d ʒ aː AD n a AD
ikhanzi	iː AD kʰ aː AD n z i AD
ikhaphethe	iː AD kʰ a AD pʰ eː AD tʰ e AD
ikhasi	iː AD kʰ aː AD s i AD
ikhasimende	iː AD kʰ a AD s i AD m eː AD n d e AD
ikhaya	iː AD kʰ aː AD j AB a AD
ikhefu	iː AD kʰ eː AD f u AE
ikhehla	iː AD kʰ eː AD ɬ a AD
ikheji	iː AD kʰ eː AD d ʒ i AD
ikhekhe	iː AD kʰ eː AD kʰ e AD
ikhekheba	iː AD kʰ e AD kʰ eː AD ɓ a AD
ikheli	iː AD kʰ eː AD l i AD
ikhemese	iː AD kʰ e AD m eː AD s e AD
ikhethini	iː AD kʰ e AD tʰ iː AD n i AD
ikhishi	iː AD kʰ iː AD ʃ i AD
ikholwase	iː AD kʰ o AE l w AC aː AD s e AD
ikhonsathi	iː AD kʰ o AE n s aː AD tʰ i AD
ikhukhamba	iː AD kʰ u AE kʰ aː AD m b a AD
ikhukhu	iː AD kʰ uː AE kʰ u AE
ikhulu	iː AD kʰ uː AE l u AE
ikhwapha	iː AD kʰ w AC aː AD pʰ a AD
ikhweza	iː AD kʰ w AC eː AD z a AD
ikhwezi	iː AD kʰ w AC eː AD z i AD
ikhwilithi	iː AD kʰ w AC i AD l iː AD tʰ i AD
ikilasi	iː AD k i AD l aː AD s i AD
ikilogo	iː AD k i AD l oː AE ɡ o AE
iklabishi	iː AD k x a AD ɓ iː AD ʃ i AD
iklwa	iː AD k x w AC a AD
ilahle	iː AD l aː AD ɬ e AD
ilanga	iː AD l aː AD n ɡ a AD
ilantshi	iː AD l aː AD ɲ t ʃ i AD
ilayisense	iː AD l a AD j AB i AD s eː AD n s e AD
ilayisi	iː AD l a AD j AB iː AD s i AD
ilembe	iː AD l eː AD m b e AD
ilisho	iː AD l iː AD ʃ o AE
ilobolo	iː AD l o AE ɓ oː AE l o AE
ilokhuzane	i AD l o AE kʰ u AE z aː AD n e AD
ilokwe	iː AD l oː AE ɠ w AC e AD
iloli	iː AD l oː AE l i AD
ilulwane	iː AD l u AE l w AC aː AD n e AD
ilungelo	iː AD l u AE n ɡ eː AD l o AE
imadlana	i AD m a AD ɮ aː AD n a AD
imali	i AD m aː AD l i AD
imamba	i AD m aː AD m b a AD
imayela	iː AD m a AD j AB eː AD l a AD
imbabala	i AD m b a AD ɓ aː AD l a AD
imbala	i AD m b aː AD l a AD
imbali	i AD m b aː AD l i AD
imbambe	i AD m b aː AD m b e AD
imbasa	i AD m b aː AD s a AD
imbazo	i AD m b aː AD z o AE
imbenge	i AD m b eː AD n ɡ e AD
imbewu	i AD m b eː AD w AC u AE
imbila	i AD m b iː AD l a AD
imbiza	i AD m b iː AD z a AD
imbizo	i AD m b iː AD z o AE
imbodla	i AD m b oː AE ɮ a AD
imbongi	i AD m b oː AE n ɡ i AD
imbongolo	i AD m b o AE n ɡ oː AE l o AE
imboni	i AD m b oː AE n i AD
imbovane	i AD m b o AE v aː AD n e AD
imbube	i AD m b uː AE ɓ e AD
imbungulu	i AD m b u AE n ɡ uː AE l u AE
imbuya	i AD m b uː AE j AB a AD
imbuzana	i AD m b u AE z aː AD n a AD
imbuzane	i AD m b u AE z aː AD n e AD
imbuzi	i AD m b uː AE z i AD
imbuzikazi	i AD m b u AE z i AD ɠ aː AD z i AD
imelika	iː AD m e AD l iː AD ɠ a AD
imfene	i AD m f eː AD n e AD
imfihlo	i AD m f iː AD ɬ o AE
imfologo	i AD m f o AE l oː AE ɡ o AE
imfoloko	i AD m f o AE l oː AE ɠ o AE
imfolozi	i AD m f o AE l oː AE z i AD
imfuluwenza	i AD m f u AE l u AE w AC eː AD n z a AD
imini	i AD m iː AD n i AD
iminithi	iː AD m i AD n iː AD tʰ i AD
imoto	i AD m oː AE t o AE
impahla	i AD m p aː AD ɬ a AD
impakama	i AD m p a AD ɠ aː AD m a AD
impakathi	i AD m p a AD ɠ aː AD tʰ i AD
impala	i AD m p aː AD l a AD
impalampala	i AD m p a AD l a AD m p aː AD l a AD
impambosi	i AD m p a AD m b oː AE s i AD
impande	i AD m p aː AD n d e AD
impangele	i AD m p a AD n ɡ eː AD l e AD
impela	i AD m p eː AD l a AD
impelesi	i AD m p e AD l eː AD s i AD
impempe	i AD m p eː AD m p e AD
impendulo	i AD m p e AD n d uː AE l o AE
impi	iː AD m p i AD
impilo	i AD m p iː AD l o AE
impisi	i AD m p iː AD s i AD
impofu	i AD m p oː AE f u AE
impohlo	i AD m p oː AE ɬ o AE
impongo	i AD m p oː AE n ɡ o AE
impophoma	i AD m p o AE pʰ oː AE m a AD
impoqo	i AD m p oː AE ǃ o AE
impuco	i AD m p uː AE ǀ o AE
impukane	i AD m p u AE ɠ aː AD n e AD
impumalanga	i AD m p u AE m a AD l aː AD n ɡ a AD
impumulo	i AD m p u AE m uː AE l o AE
impungushe	i AD m p u AE n ɡ uː AE ʃ e AD
impunzi	i AD m p uː AE n z i AD
impuphu	i AD m p uː AE pʰ u AE
impusela	i AD m p u AE s eː AD l a AD
imvama	i AD m v aː AD m a AD
imvamisa	i AD m v a AD m iː AD s a AD
imvana	i AD m v aː AD n a AD
imvelo	i AD m v eː AD l o AE
imvemvane	i AD m v e AD m v aː AD n e AD
imvu	iː AD m v u AE
imvubu	i AD m v uː AE ɓ u AE
imvukazi	i AD m v u AE ɠ aː AD z i AD
imvukusi	i AD m v u AE ɠ uː AE s i AD
imvula	i AD m v uː AE l a AD
imvumo	i AD m v uː AE m o AE
inalithi	iː AD n a AD l iː AD tʰ i AD
incazo	i AD ǀ aː AD z o AE
inceku	i AD ǀ eː AD ɠ u AE
incingo	i AD ǀ iː AD n ɡ o AE
incombo	i AD ǀ oː AE m b o AE
incuncu	i AD ǀ uː AE ǀ u AE
incwadi	i AD ǀ w AC aː AD d i AD
incwancwa	i AD ǀ w AC aː AD ǀ w AC a AD
incwincwi	i AD ǀ w AC iː AD ǀ w AC i AD
indaba	i AD n d aː AD ɓ a AD
indabushe	i AD n d a AD ɓ uː AE ʃ e AD
indandatho	i AD n d a AD n d aː AD tʰ o AE
indawo	i AD n d aː AD w AC o AE
indebe	i AD n d eː AD ɓ e AD
indima	i AD n d iː AD m a AD
indingilizi	i AD n d i AD n ɡ i AD l iː AD z i AD
indishi	i AD n d iː AD ʃ i AD
indlala	i AD n ɮ aː AD l a AD
indlalifa	i AD n ɮ a AD l iː AD f a AD
indlamini	i AD n ɮ a AD m iː AD n i AD
indlamu	i AD n ɮ aː AD m u AE
indlazi	i AD n ɮ aː AD z i AD
indle	iː AD n ɮ e AD
indlebe	i AD n ɮ eː AD ɓ e AD
indleko	i AD n ɮ eː AD ɠ o AE
indlela	i AD n ɮ eː AD l a AD
indlobho	i AD n ɮ oː AE b o AE
indlondlo	i AD n ɮ oː AE n ɮ o AE
indlovu	i AD n ɮ oː AE v u AE
indlovukazi	i AD n ɮ o AE v u AE ɠ aː AD z i AD
indlozi	i AD n ɮ oː AE z i AD
indlu	iː AD n ɮ u AE
indlulamithi	i AD n ɮ u AE l a AD m iː AD tʰ i AD
indlwana	i AD n ɮ w AC aː AD n a AD
indoda	i AD n d oː AE d a AD
indodakazi	i AD n d o AE d a AD ɠ aː AD z i AD
indodana	i AD n d o AE d aː AD n a AD
induku	i AD n d uː AE ɠ u AE
induna	i AD n d uː AE n a AD
indwandwe	i AD n d w AC aː AD n d w AC e AD
indwangu	i AD n d w AC aː AD n ɡ u AE
inenevana	i AD n e AD n e AD v aː AD n a AD
inenevu	i AD n e AD n eː AD v u AE
ingadi	i AD n ɡ aː AD d i AD
ingalangala	i AD n ɡ a AD l a AD n ɡ aː AD l a AD
ingalo	i AD n ɡ aː AD l o AE
ingane	i AD n ɡ aː AD n e AD
inganeko	i AD n ɡ a AD n eː AD ɠ o AE
inganekwane	i AD n ɡ a AD n e AD ɠ w AC aː AD n e AD
ingcanga	i AD ǀʱ aː AD n ɡ a AD
ingcebo	i AD ǀʱ eː AD ɓ o AE
ingcosa	i AD ǀʱ oː AE s a AD
ingcwaba	iː AD ǀʱ w AC aː AD ɓ a AD
ingcwali	i AD ǀʱ w AC aː AD l i AD
ingcweti	i AD ǀʱ w AC eː AD t i AD
ingebe	i AD n ɡ eː AD ɓ e AD
ingede	i AD n ɡ eː AD d e AD
ingisi	iː AD n ɡ iː AD s i AD
ingobe	iː AD n ɡ oː AE ɓ e AD
ingoma	i AD n ɡ oː AE m a AD
ingonyama	i AD n ɡ o AE ɲ aː AD m a AD
ingoqokazi	i AD n ɡ o AE ǃ o AE ɠ aː AD z i AD
ingozi	i AD n ɡ oː AE z i AD
ingqalasizinda	i AD ǃʱ a AD l a AD s i AD z iː AD n d a AD
ingqofa	i AD ǃʱ oː AE f a AD
ingqomfi	i AD ǃʱ oː AE m f i AD
ingqondo	i AD ǃʱ oː AE n d o AE
ingqumbi	i AD ǃʱ uː AE m b i AD
ingqunge	i AD ǃʱ uː AE n ɡ e AD
ingquza	i AD ǃʱ uː AE z a AD
ingubo	i AD n ɡ uː AE ɓ o AE
ingulube	i AD n ɡ u AE l uː AE ɓ e AD
ingulule	i AD n ɡ u AE l uː AE l e AD
ingungumbane	i AD n ɡ u AE n ɡ u AE m b aː AD n e AD
ingwane	i AD n ɡ w AC aː AD n e AD
ingwe	iː AD n ɡ w AC e AD
ingwedli	i AD n ɡ w AC eː AD ɮ i AD
ingwenya	i AD n ɡ w AC eː AD ɲ a AD
ingxabano	i AD ǁʱ a AD ɓ aː AD n o AE
ingxenye	i AD ǁʱ eː AD ɲ e AD
ingxi	iː AD ǁʱ i AD
ingxobongo	i AD ǁʱ o AE ɓ oː AE n ɡ o AE
ingxotha	i AD ǁʱ oː AE tʰ a AD
ingxoxo	i AD ǁʱ oː AE ǁ o AE
ingxubevange	i AD ǁʱ u AE ɓ e AD v aː AD n ɡ e AD
inhlaba	i AD n ɬ aː AD ɓ a AD
inhlabathi	i AD n ɬ a AD ɓ aː AD tʰ i AD
inhlahla	i AD n ɬ aː AD ɬ a AD
inhlaka	i AD n ɬ aː AD ɠ a AD
inhlakanipho	i AD n ɬ a AD ɠ a AD n iː AD pʰ o AE
inhlalakahle	i AD n ɬ a AD l a AD ɠ aː AD ɬ e AD
inhlalo	i AD n ɬ aː AD l o AE
inhlamvu	i AD n ɬ aː AD m v u AE
inhlamvukazi	i AD n ɬ a AD m v u AE ɠ aː AD z i AD
inhlangano	i AD n ɬ a AD n ɡ aː AD n o AE
inhlanhla	i AD n ɬ aː AD n ɬ a AD
inhlansi	i AD n ɬ aː AD n s i AD
inhlanzi	i AD n ɬ aː AD n z i AD
inhlaziyo	i AD n ɬ a AD z iː AD j AB o AE
inhlekisa	i AD n ɬ e AD ɠ iː AD s a AD
inhlelo	i AD n ɬ eː AD l o AE
inhliziyo	i AD n ɬ i AD z iː AD j AB o AE
inhlobo	i AD n ɬ oː AE ɓ o AE
inhloko	i AD n ɬ oː AE ɠ o AE
inhloso	i AD n ɬ oː AE s o AE
inhlwathi	i AD n ɬ w AC aː AD tʰ i AD
iningi	iː AD n iː AD n ɡ i AD
iningizimu	i AD n i AD n ɡ i AD z iː AD m u AE
inja	iː AD ɲ d ʒ a AD
injemane	i AD ɲ d ʒ e AD m aː AD n e AD
injingwenikazi	i AD ɲ d ʒ i AD n ɡ w AC e AD n i AD ɠ aː AD z i AD
injobo	i AD ɲ d ʒ oː AE ɓ o AE
injolikazi	i AD ɲ d ʒ o AE l i AD ɠ aː AD z i AD
injongo	i AD ɲ d ʒ oː AE n ɡ o AE
injula	i AD ɲ d ʒ uː AE l a AD
inkabi	i AD n k aː AD ɓ i AD
inkala	i AD n k aː AD l a AD
inkambo	i AD n k aː AD m b o AE
inkampane	i AD n k a AD m p aː AD n e AD
inkanyezi	i AD n k a AD ɲ eː AD z i AD
inkathazo	i AD n k a AD tʰ aː AD z o AE
inkathi	i AD n k aː AD tʰ i AD
inkawu	i AD n k aː AD w AC u AE
inkehlo	i AD n k eː AD ɬ o AE
inkinga	i AD n k iː AD n ɡ a AD
inkohlisa	i AD n k o AE ɬ iː AD s a AD
inkomba	i AD n k oː AE m b a AD
inkomo	i AD n k oː AE m o AE
inkontileka	i AD n k o AE n t i AD l eː AD ɠ a AD
inkosana	i AD n k o AE s aː AD n a AD
inkosazana	i AD n k o AE s a AD z aː AD n a AD
inkosi	i AD n k oː AE s i AD
inkosikazi	i AD n k o AE s i AD ɠ aː AD z i AD
inkotha	i AD n k oː AE tʰ a AD
inkuba	i AD n k uː AE ɓ a AD
inkukhu	i AD n k uː AE kʰ u AE
inkululeko	i AD n k u AE l u AE l eː AD ɠ o AE
inkulungwane	i AD n k u AE l u AE n ɡ w AC aː AD n e AD
inkumbulo	i AD n k u AE m b uː AE l o AE
inkundla	i AD n k uː AE n ɮ a AD
inkungu	i AD n k uː AE n ɡ u AE
inkunzana	i AD n k u AE n z aː AD n a AD
inkunzi	i AD n k uː AE n z i AD
inkwazi	i AD n k w AC aː AD z i AD
inkwindi	i AD n k w AC iː AD n d i AD
inqaba	i AD ǃ aː AD ɓ a AD
inqama	i AD ǃ aː AD m a AD
inqe	iː AD ǃ e AD
inqina	i AD ǃ iː AD n a AD
inqindi	i AD ǃ iː AD n d i AD
inqola	i AD ǃ oː AE l a AD
inqolobana	i AD ǃ o AE l o AE ɓ aː AD n a AD
inqolobane	i AD ǃ o AE l o AE ɓ aː AD n e AD
inqulu	i AD ǃ uː AE l u AE
inqumba	i AD ǃ uː AE m b a AD
inqwaba	i AD ǃ w AC aː AD ɓ a AD
insangu	i AD n s aː AD n ɡ u AE
insele	i AD n s eː AD l e AD
insephe	i AD n s eː AD pʰ e AD
insimba	i AD n s iː AD m b a AD
insimbi	i AD n s iː AD m b i AD
insimu	i AD n s iː AD m u AE
insipho	i AD n s iː AD pʰ o AE
insizwa	i AD n s iː AD z w AC a AD
inso	iː AD n s o AE
insundu	i AD n s uː AE n d u AE
inswelakalo	i AD n s w AC e AD l a AD ɠ aː AD l o AE
inswelo	i AD n s w AC eː AD l o AE
intaba	i AD n t aː AD ɓ a AD
intaka	i AD n t aː AD ɠ a AD
intambo	i AD n t aː AD m b o AE
intamo	i AD n t aː AD m o AE
intandane	i AD n t a AD n d aː AD n e AD
intando	i AD n t aː AD n d o AE
intela	i AD n t eː AD l a AD
intengo	i AD n t eː AD n ɡ o AE
intethe	i AD n t eː AD tʰ e AD
intini	i AD n t iː AD n i AD
into	iː AD n t o AE
intombazane	i AD n t o AE m b a AD z aː AD n e AD
intombi	i AD n t oː AE m b i AD
intonga	i AD n t oː AE n ɡ a AD
intsha	iː AD ɲ t ʃ a AD
intshe	iː AD ɲ t ʃ e AD
intshonalanga	i AD ɲ t ʃ o AE n a AD l aː AD n ɡ a AD
intshontsho	iː AD ɲ t ʃ oː AE ɲ t ʃ o AE
intshumayelo	i AD ɲ t ʃ u AE m a AD j AB eː AD l o AE
intshushiso	i AD ɲ t ʃ u AE ʃ iː AD s o AE
intulo	i AD n t uː AE l o AE
intuthane	i AD n t u AE tʰ aː AD n e AD
intuthu	i AD n t uː AE tʰ u AE
intwala	i AD n t w AC aː AD l a AD
intwasahlobo	i AD n t w AC a AD s a AD ɬ oː AE ɓ o AE
intwentshe	i AD n t w AC eː AD ɲ t ʃ e AD
inungu	i AD n uː AE n ɡ u AE
inxa	i AD ǁ aː AD
inxaso	i AD ǁ aː AD s o AE
inxeba	iː AD ǁ eː AD ɓ a AD
inxele	iː AD ǁ eː AD l e AD
inxokovane	i AD ǁ o AE ɠ o AE v aː AD n e AD
inyakatho	i AD ɲ a AD ɠ aː AD tʰ o AE
inyala	i AD ɲ aː AD l a AD
inyama	i AD ɲ aː AD m a AD
inyamazane	i AD ɲ a AD m a AD z aː AD n e AD
inyanga	i AD ɲ aː AD n ɡ a AD
inyathi	i AD ɲ aː AD tʰ i AD
inyendle	i AD ɲ eː AD n ɮ e AD
inyoka	i AD ɲ oː AE ɠ a AD
inyonga	i AD ɲ oː AE n ɡ a AD
inyongo	i AD ɲ oː AE n ɡ o AE
inyoni	i AD ɲ oː AE n i AD
inyosi	i AD ɲ oː AE s i AD
inyumba	i AD ɲ uː AE m b a AD
inzima	i AD n z iː AD m a AD
inzondo	i AD n z oː AE n d o AE
inzulu	i AD n z uː AE l u AE
iphahla	iː AD pʰ aː AD ɬ a AD
iphakathi	iː AD pʰ a AD ɠ aː AD tʰ i AD
iphalamende	iː AD pʰ a AD l a AD m eː AD n d e AD
iphango	iː AD pʰ aː AD n ɡ o AE
iphaphu	iː AD pʰ aː AD pʰ u AE
iphara	iː AD pʰ aː AD r a AD
iphasika	iː AD pʰ a AD s iː AD ɠ a AD
iphela	iː AD pʰ eː AD l a AD
iphepha	iː AD pʰ eː AD pʰ a AD
iphiko	iː AD pʰ iː AD ɠ o AE
iphoyisa	iː AD pʰ o AE j AB iː AD s a AD
iphupho	iː AD pʰ uː AE pʰ o AE
iphutha	iː AD pʰ uː AE tʰ a AD
iphuzu	iː AD pʰ uː AE z u AE
ipipi	iː AD p iː AD p i AD
ipiyano	iː AD p i AD j AB aː AD n o AE
ipulangwe	iː AD p u AE l aː AD n ɡ w AC e AD
ipulazi	iː AD p u AE l aː AD z i AD
iqabi	iː AD ǃ aː AD ɓ i AD
iqakala	iː AD ǃ a AD ɠ aː AD l a AD
iqanda	iː AD ǃ aː AD n d a AD
iqaqa	iː AD ǃ aː AD ǃ a AD
iqatha	iː AD ǃ aː AD tʰ a AD
iqembu	iː AD ǃ eː AD m b u AE
iqeqeba	iː AD ǃ e AD ǃ eː AD ɓ a AD
iqhawe	iː AD ǃʰ aː AD w AC e AD
iqhezu	iː AD ǃʰ eː AD z u AE
iqhina	iː AD ǃʰ iː AD n a AD
iqhinga	iː AD ǃʰ iː AD n ɡ a AD
iqhude	iː AD ǃʰ uː AE d e AD
iqhwa	iː AD ǃʰ w AC a AD
iqhwabazi	iː AD ǃʰ w AC a AD ɓ aː AD z i AD
iqhwana	iː AD ǃʰ w AC aː AD n a AD
iqili	iː AD ǃ iː AD l i AD
iqiniso	iː AD ǃ i AD n iː AD s o AE
iqola	iː AD ǃ oː AE l a AD
iqoqo	iː AD ǃ oː AE ǃ o AE
iqwahhashi	iː AD ǃ w AC a AD ɦ AA aː AD ʃ i AD
iresiphi	iː AD r e AD s iː AD pʰ i AD
isabelo	i AD s a AD ɓ eː AD l o AE
isabizwana	i AD s a AD ɓ i AD z w AC aː AD n a AD
isala	i AD s aː AD l a AD
isalukazi	i AD s a AD l u AE ɠ aː AD z i AD
isambane	i AD s a AD m b aː AD n e AD
isanda	i AD s aː AD n d a AD
isandiso	i AD s a AD n d iː AD s o AE
isandla	i AD s aː AD n ɮ a AD
isando	i AD s aː AD n d o AE
isandu	i AD s aː AD n d u AE
isangoma	i AD s a AD n ɡ oː AE m a AD
isapha	iː AD s aː AD pʰ a AD
isebi	i AD s eː AD ɓ i AD
isele	iː AD s eː AD l e AD
isende	iː AD s eː AD n d e AD
isendwishi	iː AD s e AD n d w AC iː AD ʃ i AD
isenzo	i AD s eː AD n z o AE
ishaka	iː AD ʃ aː AD ɠ a AD
ishayina	iː AD ʃ a AD j AB iː AD n a AD
ishinga	iː AD ʃ iː AD n ɡ a AD
ishiya	iː AD ʃ iː AD j AB a AD
ishongololo	iː AD ʃ o AE n ɡ o AE l oː AE l o AE
ishumi	iː AD ʃ uː AE m i AD
ishwa	iː AD ʃ w AC a AD
isi	iː AD s i AD
isibabule	i AD s i AD ɓ a AD ɓ uː AE l e AD
isibaya	i AD s i AD ɓ aː AD j AB a AD
isibhakela	i AD s i AD b a AD ɠ eː AD l a AD
isibhaxelo	i AD s i AD b a AD ǁ eː AD l o AE
isibhedlela	i AD s i AD b e AD ɮ eː AD l a AD
isibhokodo	i AD s i AD b o AE ɠ oː AE d o AE
isibhoza	i AD s i AD b oː AE z a AD
isibhunu	i AD s i AD b uː AE n u AE
isibi	i AD s iː AD ɓ i AD
isibiba	i AD s i AD ɓ iː AD ɓ a AD
isibili	i AD s i AD ɓ iː AD l i AD
isibindi	i AD s i AD ɓ iː AD n d i AD
isibingelelo	i AD s i AD ɓ i AD n ɡ e AD l eː AD l o AE
isibomvu	i AD s i AD ɓ oː AE m v u AE
isibongo	i AD s i AD ɓ oː AE n ɡ o AE
isibungu	i AD s i AD ɓ uː AE n ɡ u AE
isibunu	i AD s i AD ɓ uː AE n u AE
isicathulo	i AD s i AD ǀ a AD tʰ uː AE l o AE
isicebi	i AD s i AD ǀ eː AD ɓ i AD
isicholo	i AD s i AD ǀʰ oː AE l o AE
isichotho	i AD s i AD ǀʰ oː AE tʰ o AE
isichwe	i AD s iː AD ǀʰ w AC e AD
isici	i AD s iː AD ǀ i AD
isicunulo	i AD s i AD ǀ u AE n uː AE l o AE
isidakwa	i AD s i AD d aː AD ɠ w AC a AD
isidididi	i AD s i AD d i AD d iː AD d i AD
isidingo	i AD s i AD d iː AD n ɡ o AE
isidla	i AD s iː AD ɮ a AD
isidleke	i AD s i AD ɮ eː AD ɠ e AD
isidlele	i AD s i AD ɮ eː AD l e AD
isidlo	i AD s iː AD ɮ o AE
isidlokolo	i AD s i AD ɮ o AE ɠ oː AE l o AE
isidula	i AD s i AD d uː AE l a AD
isidumbu	i AD s i AD d uː AE m b u AE
isidwaba	i AD s i AD d w AC aː AD ɓ a AD
isidwebo	i AD s i AD d w AC eː AD ɓ o AE
isifazane	i AD s i AD f a AD z aː AD n e AD
isifingqo	i AD s i AD f iː AD ǃʱ o AE
isifo	i AD s iː AD f o AE
isifuba	i AD s i AD f uː AE ɓ a AD
isifulentshi	i AD s i AD f u AE l eː AD ɲ t ʃ i AD
isifunda	i AD s i AD f uː AE n d a AD
isiga	i AD s iː AD ɡ a AD
isigcawu	i AD s i AD ǀʱ aː AD w AC u AE
isigcibisholo	i AD s i AD ǀʱ i AD ɓ i AD ʃ oː AE l o AE
isigcino	i AD s i AD ǀʱ iː AD n o AE
isigebengu	i AD s i AD ɡ e AD ɓ eː AD n ɡ u AE
isigedla	i AD s i AD ɡ eː AD ɮ a AD
isigedlekazi	i AD s i AD ɡ e AD ɮ e AD ɠ aː AD z i AD
isigege	i AD s i AD ɡ eː AD ɡ e AD
isigidi	i AD s i AD ɡ iː AD d i AD
isigidigidi	i AD s i AD ɡ i AD d i AD ɡ iː AD d i AD
isigigaba	i AD s i AD ɡ i AD ɡ aː AD ɓ a AD
isigingci	i AD s i AD ɡ iː AD ǀʱ i AD
isigodi	i AD s i AD ɡ oː AE d i AD
isigqi	i AD s iː AD ǃʱ i AD
isigqiki	i AD s i AD ǃʱ iː AD ɠ i AD
isigqila	i AD s i AD ǃʱ iː AD l a AD
isigqizo	i AD s i AD ǃʱ iː AD z o AE
isigqoko	i AD s i AD ǃʱ oː AE ɠ o AE
isigubhu	i AD s i AD ɡ uː AE b u AE
isigwaca	i AD s i AD ɡ w AC aː AD ǀ a AD
isigwadlulo	i AD s i AD ɡ w AC a AD ɮ uː AE l o AE
isigwayi	i AD s i AD ɡ w AC aː AD j AB i AD
isigwedlo	i AD s i AD ɡ w AC eː AD ɮ o AE
isigwegwe	i AD s i AD ɡ w AC eː AD ɡ w AC e AD
isigxobo	i AD s i AD ǁʱ oː AE ɓ o AE
isihla	i AD s iː AD ɬ a AD
isihlabathi	i AD s i AD ɬ a AD ɓ aː AD tʰ i AD
isihlahla	i AD s i AD ɬ aː AD ɬ a AD
isihlakaniphi	i AD s i AD ɬ a AD ɠ a AD n iː AD pʰ i AD
isihlalo	i AD s i AD ɬ aː AD l o AE
isihlangu	i AD s i AD ɬ aː AD n ɡ u AE
isihlanu	i AD s i AD ɬ aː AD n u AE
isihlelo	i AD s i AD ɬ eː AD l o AE
isihlephu	i AD s i AD ɬ eː AD pʰ u AE
isihlobo	i AD s i AD ɬ oː AE ɓ o AE
isihloko	i AD s i AD ɬ oː AE ɠ o AE
isihlungu	i AD s i AD ɬ uː AE n ɡ u AE
isijingi	i AD s i AD d ʒ iː AD n ɡ i AD
isijula	i AD s i AD d ʒ uː AE l a AD
isikebhe	i AD s i AD k eː AD b e AD
isikhala	i AD s i AD kʰ aː AD l a AD
isikhali	i AD s i AD kʰ aː AD l i AD
isikhashana	i AD s i AD kʰ a AD ʃ aː AD n a AD
isikhathi	i AD s i AD kʰ aː AD tʰ i AD
isikhindi	i AD s i AD kʰ iː AD n d i AD
isikhombisa	i AD s i AD kʰ o AE m b iː AD s a AD
isikhotha	i AD s i AD kʰ oː AE tʰ a AD
isikhulu	i AD s i AD kʰ uː AE l u AE
isikhumba	i AD s i AD kʰ uː AE m b a AD
isikhumbuzo	i AD s i AD kʰ u AE m b uː AE z o AE
isikhundla	i AD s i AD kʰ uː AE n ɮ a AD
isikhwama	i AD s i AD kʰ w AC aː AD m a AD
isikhwehlela	i AD s i AD kʰ w AC e AD ɬ eː AD l a AD
isikhwenene	i AD s i AD kʰ w AC e AD n eː AD n e AD
isikhwili	i AD s i AD kʰ w AC iː AD l i AD
isikole	i AD s i AD k oː AE l e AD
isikweleti	i AD s i AD k w AC e AD l eː AD t i AD
isikweletu	i AD s i AD k w AC e AD l eː AD t u AE
isikwenetu	i AD s i AD k w AC e AD n eː AD t u AE
isileti	i AD s i AD l eː AD t i AD
isilevu	i AD s i AD l eː AD v u AE
isilima	i AD s i AD l iː AD m a AD
isilisa	i AD s i AD l iː AD s a AD
isiliva	iː AD s i AD l iː AD v a AD
isilo	i AD s iː AD l o AE
isilonda	i AD s i AD l oː AE n d a AD
isilungu	i AD s i AD l uː AE n ɡ u AE
isilwane	i AD s i AD l w AC aː AD n e AD
isilwi	i AD s iː AD l w AC i AD
isimame	i AD s i AD mʱ aː AD mʱ e AD
isimangaliso	i AD s i AD m a AD n ɡ a AD l iː AD s o AE
isimba	iː AD s iː AD m b a AD
isimemo	i AD s i AD m eː AD m o AE
isimo	i AD s iː AD m o AE
isinci	i AD s iː AD ǀ i AD
isinciphiso	i AD s i AD ǀ i AD pʰ iː AD s o AE
isine	i AD s iː AD n e AD
isingane	i AD s i AD n ɡ aː AD n e AD
isingci	i AD s iː AD ǀʱ i AD
isingisi	i AD s i AD n ɡ iː AD s i AD
isinguni	i AD s i AD n ɡ uː AE n i AD
isinkwa	i AD s iː AD n k w AC a AD
isinkwe	i AD s iː AD n k w AC e AD
isinqe	i AD s iː AD ǃ e AD
isinqumo	i AD s i AD ǃ uː AE m o AE
isintu	i AD s iː AD n t u AE
isinxele	i AD s i AD ǁ eː AD l e AD
isinye	i AD s iː AD ɲ e AD
isinzima	i AD s i AD n z iː AD m a AD
isiphambano	i AD s i AD pʰ a AD m b aː AD n o AE
isiphapha	i AD s i AD pʰ aː AD pʰ a AD
isiphawulo	i AD s i AD pʰ a AD w AC uː AE l o AE
isiphethe	i AD s i AD pʰ eː AD tʰ e AD
isiphetho	i AD s i AD pʰ eː AD tʰ o AE
isiphika	i AD s i AD pʰ iː AD ɠ a AD
isipho	i AD s iː AD pʰ o AE
isiphukuphuku	i AD s i AD pʰ u AE ɠ u AE pʰ uː AE ɠ u AE
isiphundu	i AD s i AD pʰ uː AE n d u AE
isiphuzi	i AD s i AD pʰ uː AE z i AD
isipinashi	i AD s i AD p i AD n aː AD ʃ i AD
isipunu	i AD s i AD p uː AE n u AE
isiqalo	i AD s i AD ǃ aː AD l o AE
isiqephu	i AD s i AD ǃ eː AD pʰ u AE
isiqhaza	i AD s i AD ǃʰ aː AD z a AD
isiqhebeza	i AD s i AD ǃʰ e AD ɓ eː AD z a AD
isiqhephu	i AD s i AD ǃʰ eː AD pʰ u AE
isiqhimu	i AD s i AD ǃʰ iː AD m u AE
isiqhingana	i AD s i AD ǃʰ i AD n ɡ aː AD n a AD
isiqhingi	i AD s i AD ǃʰ iː AD n ɡ i AD
isiqimu	i AD s i AD ǃ iː AD m u AE
isiqinti	i AD s i AD ǃ iː AD n t i AD
isiqithi	i AD s i AD ǃ iː AD tʰ i AD
isiqopha	i AD s i AD ǃ oː AE pʰ a AD
isiqoqo	i AD s i AD ǃ oː AE ǃ o AE
isiquba	i AD s i AD ǃ uː AE ɓ a AD
isisebenzi	i AD s i AD s e AD ɓ eː AD n z i AD
isishayina	i AD s i AD ʃ a AD j AB iː AD n a AD
isishiyagalolunye	i AD s i AD ʃ i AD j AB a AD ɡ a AD l o AE l uː AE ɲ e AD
isishiyagalombili	i AD s i AD ʃ i AD j AB a AD ɡ a AD l o AE m b iː AD l i AD
isishuqulu	i AD s i AD ʃ u AE ǃ uː AE l u AE
isishushiso	i AD s i AD ʃ u AE ʃ iː AD s o AE
isisu	i AD s iː AD s u AE
isisuthu	i AD s i AD s uː AE tʰ u AE
isiswazi	i AD s i AD s w AC aː AD z i AD
isiswebhu	i AD s i AD s w AC eː AD b u AE
isitambu	i AD s i AD t aː AD m b u AE
isiteleka	i AD s i AD t e AD l eː AD ɠ a AD
isitha	iː AD s iː AD tʰ a AD
isithando	i AD s i AD tʰ aː AD n d o AE
isithandwa	i AD s i AD tʰ aː AD n d w AC a AD
isithathu	i AD s i AD tʰ aː AD tʰ u AE
isithelo	i AD s i AD tʰ eː AD l o AE
isithembiso	i AD s i AD tʰ e AD m b iː AD s o AE
isithixo	i AD s i AD tʰ iː AD ǁ o AE
isithole	i AD s i AD tʰ oː AE l e AD
isithombe	i AD s i AD tʰ oː AE m b e AD
isithunywa	i AD s i AD tʰ uː AE ɲ w AC a AD
isithupha	i AD s i AD tʰ uː AE pʰ a AD
isithutha	i AD s i AD tʰ uː AE tʰ a AD
isithuthuthu	i AD s i AD tʰ u AE tʰ uː AE tʰ u AE
isithwalambiza	i AD s i AD tʰ w AC a AD l a AD m b iː AD z a AD
isithwathwa	i AD s i AD tʰ w AC aː AD tʰ w AC a AD
isitimela	i AD s i AD t i AD m eː AD l a AD
isitini	i AD s i AD t iː AD n i AD
isitofu	i AD s i AD t oː AE f u AE
isitsha	i AD s iː AD t ʃ a AD
isitshalo	i AD s i AD t ʃ aː AD l o AE
isitshwana	i AD s i AD t ʃ w AC aː AD n a AD
isitswana	i AD s i AD t s w AC aː AD n a AD
isitulo	i AD s i AD t uː AE l o AE
isivalo	i AD s i AD v aː AD l o AE
isivande	i AD s i AD v aː AD n d e AD
isixaxa	i AD s i AD ǁ aː AD ǁ a AD
isixazululo	i AD s i AD ǁ a AD z u AE l uː AE l o AE
isixhosa	i AD s i AD ǁʰ oː AE s a AD
isixubho	i AD s i AD ǁ uː AE b o AE
isixuku	i AD s i AD ǁ uː AE ɠ u AE
isixula	i AD s i AD ǁ uː AE l a AD
isiziba	i AD s i AD z iː AD ɓ a AD
isizulu	i AD s i AD z uː AE l u AE
isizwe	i AD s iː AD z w AC e AD
iso	iː AD s o AE
isoka	iː AD s oː AE ɠ a AD
isondo	iː AD s oː AE n d o AE
isono	i AD s oː AE n o AE
isonto	iː AD s oː AE n t o AE
isosa	iː AD s oː AE s a AD
isu	iː AD s u AE
isundu	iː AD s uː AE n d u AE
iswazi	iː AD s w AC aː AD z i AD
itafula	iː AD t a AD f uː AE l a AD
ithambo	iː AD tʰ aː AD m b o AE
ithanga	iː AD tʰ aː AD n ɡ a AD
itheku	iː AD tʰ eː AD ɠ u AE
ithemba	iː AD tʰ eː AD m b a AD
ithikithi	iː AD tʰ i AD ɠ iː AD tʰ i AD
ithuba	iː AD tʰ uː AE ɓ a AD
ithumbu	iː AD tʰ uː AE m b u AE
ithunga	iː AD tʰ uː AE n ɡ a AD
ithusi	iː AD tʰ uː AE s i AD
ithwasa	iː AD tʰ w AC aː AD s a AD
itiye	iː AD t iː AD j AB e AD
itshe	iː AD t ʃ e AD
itshitshi	iː AD t ʃ iː AD t ʃ i AD
itswayi	iː AD t s w AC aː AD j AB i AD
iva	iː AD v a AD
ivaka	iː AD v aː AD ɠ a AD
ivesi	iː AD v eː AD s i AD
ivila	iː AD v iː AD l a AD
ivoti	iː AD v oː AE t i AD
ivukusi	iː AD v u AE ɠ uː AE s i AD
ivukuzi	iː AD v u AE ɠ uː AE z i AD
iwa	iː AD w AC a AD
iwayini	iː AD w AC a AD j AB iː AD n i AD
iwodi	iː AD w AC oː AE d i AD
ixhaphozi	iː AD ǁʰ a AD pʰ oː AE z i AD
ixhegu	iː AD ǁʰ eː AD ɡ u AE
ixhiba	iː AD ǁʰ iː AD ɓ a AD
ixhumela	iː AD ǁʰ u AE m eː AD l a AD
ixilongo	iː AD ǁ i AD l oː AE n ɡ o AE
ixolo	iː AD ǁ oː AE l o AE
ixoxo	iː AD ǁ oː AE ǁ o AE
ixuku	iː AD ǁ uː AE ɠ u AE
iyadi	iː AD j AB aː AD d i AD
iyezi	iː AD j AB eː AD z i AD
izaba	i AD z aː AD ɓ a AD
izabulo	i AD z a AD ɓ uː AE l o AE
izala	iː AD z aː AD l a AD
izambane	iː AD z a AD m b aː AD n e AD
izembe	iː AD z eː AD m b e AD
izigqoko	i AD z i AD ǃʱ ɔː AE ɠ o AE
izihlalo	i AD z i AD ɬ aː AD l o AE
iziko	iː AD z iː AD ɠ o AE
izimu	iː AD z iː AD m u AE
izinga	iː AD z iː AD n ɡ a AD
izinhloni	i AD z i AD n ɬ oː AE n i AD
izinkabi	i AD z i AD ŋ k aː AD ɓ i AD
izinkamba	i AD z i AD ŋ k aː AD m b a AD
izinsizwa	i AD z i AD n s iː AD z w AC a AD
izintini	i AD z i AD n t i AD n i AD
izintombi	i AD z i AD n t oː AE m b i AD
izinyo	iː AD z iː AD ɲ o AE
izipho	iː AD z iː AD pʰ o AE
izitha	iː AD z iː AD tʰ a AD
izolo	iː AD z oː AE l o AE
izu	iː AD z uː AE
izulu	iː AD z uː AE l u AE
izwamoya	iː AD z w AC a AD m oː AE j AB a AD
izwe	iː AD z w AC e AD
izwekazi	iː AD z w AC e AD ɠ aː AD z i AD
izwi	iː AD z w AC i AD
jana	d ʒ aː AD n a AD
kade	k aː AD d e AD
kahle	ɠ aː AD ɬ e AD
kahleni	ɠ a AD ɬ eː AD n i AD
kakhulu	ɠ a AD kʰ uː AE l u AE
kambe	k aː AD m b e AD
kanjani	ɠ a AD ɲ d ʒ aː AD n i AD
kanti	k a AD n t iː AD
kanye	ɠ aː AD ɲ e AD
ke	ɠ e AD
khama	kʰ aː AD m a AD
khiqiza	kʰ i AD ǃ iː AD z a AD
khona	kʰ oː AE n a AD
khulu	kʰ uː AE l u AE
khwehlela	kʰ w AC e AD ɬ eː AD l a AD
khweza	kʰ w AC eː AD z a AD
khwezela	kʰ w AC e AD z eː AD l a AD
kleza	k x eː AD z a AD
konje	k oː AE ɲ d ʒ e AD
kude	ɠ uː AE d e AD
kusasa	ɠ u AE s aː AD s a AD
kwazulu	ɠ w AC a AD z uː AE l u AE
kweleta	k w AC e AD l eː AD t a AD
la	l a AD
laba	l a AD ɓ a AD
labaya	l aː AD ɓ a AD j AB aː AD
labo	l aː AD ɓ o AE
lahla	l aː AD ɬ a AD
lala	l aː AD l a AD
lala kahle	l a AD l a AD ɠ aː AD ɬ e AD
lalani kahle	l a AD l a AD n i AD ɠ aː AD ɬ e AD
lapha	l aː AD pʰ a AD
lapho	l aː AD pʰ o AE
lawaya	l aː AD w AC a AD j AB aː AD
lawo	l aː AD w AC o AE
le	l e AD
leli	l e AD l i AD
leliya	l eː AD l i AD j AB aː AD
lelo	l eː AD l o AE
lenga	l eː AD n ɡ a AD
lesi	l e AD s i AD
lesiya	l eː AD s i AD j AB aː AD
leso	l eː AD s o AE
leyaya	l eː AD j AB a AD j AB aː AD
leyo	l eː AD j AB o AE
lezi	l e AD z i AD
leziya	l eː AD z i AD j AB aː AD
lezo	l eː AD z o AE
libala	l i AD ɓ aː AD l a AD
lo	l o AE
loba	l oː AE ɓ a AD
lobo	l oː AE ɓ o AE
lobu	l o AE ɓ u AE
lobuya	l oː AE ɓ u AE j AB aː AD
lokho	l oː AE kʰ o AE
lokhu	l o AE kʰ u AE
lokhuya	l oː AE kʰ u AE j AB aː AD
lolo	l oː AE l o AE
lolu	l o AE l u AE
loluya	l oː AE l u AE j AB aː AD
lona	l oː AE n a AD
lowaya	l oː AE w AC a AD j AB aː AD
lowo	l oː AE w AC o AE
luhlaza	l u AE ɬ aː AD z a AD
luma	l uː AE m a AD
lwa	l w AC a AD
maye	mʱ a AD jʱ AB eː AD
mema	m eː AD m a AD
mhla	m̩ ɬ a AD
mhlawumbe	m̩ ɬ a AD w AC uː AE m b e AD
mhlophe	m̩ ɬ oː AE pʰ e AD
mina	m iː AD n a AD
muntu	m uː AE n t u AE
musa	mʱ uː AE s a AD
na	n a AD
nakanjani	n a AD ɠ a AD ɲ d ʒ aː AD n i AD
namhlanje	n a AD m̩ ɬ aː AD ɲ d ʒ e AD
nceda	ǀ eː AD d a AD
ncedisa	ǀ e AD d iː AD s a AD
ncelisa	ǀ e AD l iː AD s a AD
ncibilika	ǀ i AD ɓ i AD l iː AD ɠ a AD
ncika	ǀ iː AD ɠ a AD
ncintisana	ǀ i AD n t i AD s aː AD n a AD
ncipha	ǀ iː AD pʰ a AD
nciphisa	ǀ i AD pʰ iː AD s a AD
ncokola	ǀ o AE ɠ oː AE l a AD
ndiza	n d iː AD z a AD
ngcola	ǀʱ oː AE l a AD
ngcolisa	ǀʱ o AE l iː AD s a AD
ngcwaba	ǀʱ w AC aː AD ɓ a AD
ngikhona	n ɡ i AD kʰ oː AE n a AD
ngiyabonga	n ɡ i AD j AB a AD ɓ oː AE n ɡ a AD
ngiyakuthanda	n ɡ i AD j AB a AD ɠ u AE tʰ aː AD n d a AD
ngiyaphila	n ɡ i AD j AB a AD pʰ iː AD l a AD
ngoba	n ɡ oː AE ɓ a AD
ngokuba	n ɡ o AE ɠ uː AE ɓ a AD
ngomuso	n ɡ o AE m uː AE s o AE
ngqongqoza	ǃʱ o AE ǃʱ oː AE z a AD
nihambe kahle	n i AD h AA a AD m b e AD ɠ aː AD ɬ e AD
nilale kahle	n i AD l a AD l e AD ɠ aː AD ɬ e AD
nina	n iː AD n a AD
ningi	n iː AD n ɡ i AD
nisale kahle	n i AD s a AD l e AD ɠ aː AD ɬ e AD
njalo	ɲ d ʒ aː AD l o AE
njani	ɲ d ʒ aː AD n i AD
nke	n k e AD
noma	n oː AE m a AD
nqaba	ǃ aː AD ɓ a AD
nqabela	ǃ a AD ɓ eː AD l a AD
nqaka	ǃ aː AD ɠ a AD
nqamuka	ǃ a AD m uː AE ɠ a AD
nqamula	ǃ a AD m uː AE l a AD
nqekuza	ǃ e AD ɠ uː AE z a AD
nqikaza	ǃ i AD ɠ aː AD z a AD
nqoba	ǃ oː AE ɓ a AD
nquma	ǃ uː AE m a AD
nqunu	ǃ uː AE n u AE
nqwabela	ǃ w AC a AD ɓ eː AD l a AD
nxa	ǁ aː AD
nxazonke	ǁ a AD z oː AE n k e AD
nxephepha	ǁ e AD pʰ eː AD pʰ a AD
nyakenye	ɲ a AD ɠ eː AD ɲ e AD
nyenyeza	ɲ e AD ɲ eː AD z a AD
oda	ʔ oː AE d a AD
phaka	pʰ aː AD ɠ a AD
phakathi	pʰ a AD ɠ aː AD tʰ i AD
phambili	pʰ a AD m b iː AD l i AD
phansi	pʰ aː AD n s i AD
phela	pʰ eː AD l a AD
phephisa	pʰ e AD pʰ iː AD s a AD
phesheya	pʰ e AD ʃ eː AD j AB a AD
phezolo	pʰ e AD z oː AE l o AE
phezu	pʰ eː AD z u AE
phezulu	pʰ e AD z uː AE l u AE
phinde	pʰ iː AD n d e AD
phola	pʰ oː AE l a AD
qabatheka	ǃ a AD ɓ a AD tʰ eː AD ɠ a AD
qabuka	ǃ a AD ɓ uː AE ɠ a AD
qabula	ǃ a AD ɓ uː AE l a AD
qagela	ǃ a AD ɡ eː AD l a AD
qala	ǃ aː AD l a AD
qalaza	ǃ a AD l aː AD z a AD
qamba	ǃ aː AD m b a AD
qamela	ǃ a AD m eː AD l a AD
qaphela	ǃ a AD pʰ eː AD l a AD
qaqa	ǃ aː AD ǃ a AD
qaqamba	ǃ a AD ǃ aː AD m b a AD
qatha	ǃ aː AD tʰ a AD
qathaka	ǃ a AD tʰ aː AD ɠ a AD
qeda	ǃ eː AD d a AD
qedakala	ǃ e AD d a AD ɠ aː AD l a AD
qede	ǃ eː AD d e AD
qeqebula	ǃ e AD ǃ e AD ɓ uː AE l a AD
qhakaza	ǃʰ a AD ɠ aː AD z a AD
qhamu	ǃʰ a AD m u AE
qhamuka	ǃʰ a AD m uː AE ɠ a AD
qhaqha	ǃʰ aː AD ǃʰ a AD
qhaqhazela	ǃʰ a AD ǃʰ a AD z eː AD l a AD
qhasha	ǃʰ aː AD ʃ a AD
qhathanisa	ǃʰ a AD tʰ a AD n iː AD s a AD
qhebeza	ǃʰ e AD ɓ eː AD z a AD
qhela	ǃʰ eː AD l a AD
qhelisa	ǃʰ e AD l iː AD s a AD
qhephuka	ǃʰ e AD pʰ uː AE ɠ a AD
qhesha	ǃʰ eː AD ʃ a AD
qhina	ǃʰ iː AD n a AD
qhiyama	ǃʰ i AD j AB aː AD m a AD
qhubeka	ǃʰ u AE ɓ eː AD ɠ a AD
qhuma	ǃʰ uː AE m a AD
qhutha	ǃʰ uː AE tʰ a AD
qhuthula	ǃʰ u AE tʰ uː AE l a AD
qhwaga	ǃʰ w AC aː AD ɡ a AD
qhwaya	ǃʰ w AC aː AD j AB a AD
qhweba	ǃʰ w AC eː AD ɓ a AD
qinisela	ǃ i AD n i AD s eː AD l a AD
qoba	ǃ oː AE ɓ a AD
qoka	ǃ oː AE ɠ a AD
qoma	ǃ oː AE m a AD
qomisa	ǃ o AE m iː AD s a AD
qonda	ǃ oː AE n d a AD
qondisa	ǃ o AE n d iː AD s a AD
qoqa	ǃ oː AE ǃ a AD
quba	ǃ uː AE ɓ a AD
quleka	ǃ u AE l eː AD ɠ a AD
qumba	ǃ uː AE m b a AD
qwasha	ǃ w AC aː AD ʃ a AD
qwashaza	ǃ w AC a AD ʃ aː AD z a AD
sala kahle	s a AD l a AD ɠ aː AD ɬ e AD
salani kahle	s a AD l a AD n i AD ɠ aː AD ɬ e AD
sanibona	s a AD n i AD ɓ oː AE n a AD
sanibonani	s a AD n i AD ɓ o AE n aː AD n i AD
sawubona	s a AD w AC u AE ɓ oː AE n a AD
sebenza	s e AD ɓ eː AD n z a AD
shaqa	ʃ aː AD ǃ a AD
shaqeka	ʃ a AD ǃ eː AD ɠ a AD
shwabana	ʃ w AC a AD ɓ aː AD n a AD
singa	s iː AD n ɡ a AD
soka	s oː AE ɠ a AD
sombu	s o AE m b u AE
sombuluka	s o AE m b u AE l uː AE ɠ a AD
sombulula	s o AE m b u AE l uː AE l a AD
sona	s oː AE n a AD
swaca	s w AC aː AD ǀ a AD
swakama	s w AC a AD ɠ aː AD m a AD
teleka	t e AD l eː AD ɠ a AD
thathu	tʰ aː AD tʰ u AE
thetha	tʰ eː AD tʰ a AD
thina	tʰ iː AD n a AD
thukuthela	tʰ u AE ɠ u AE tʰ eː AD l a AD
ubaba	u AE ɓ aː AD ɓ a AD
ubabekazi	u AE ɓ a AD ɓ e AD ɠ aː AD z i AD
ubala	uː AE ɓ aː AD l a AD
ubambo	uː AE ɓ aː AD m b o AE
ubani	u AE ɓ aː AD n i AD
ubasi	u AE ɓ aː AD s i AD
ubhadi	u AE b aː AD d i AD
ubhaka	u AE b aː AD ɠ a AD
ubhanana	u AE b a AD n aː AD n a AD
ubhavu	u AE b aː AD v u AE
ubhejane	u AE b e AD d ʒ aː AD n e AD
ubheseni	u AE b e AD s eː AD n i AD
ubhiya	u AE b iː AD j AB a AD
ubhiye	u AE b iː AD j AB e AD
ubhoko	uː AE b oː AE ɠ o AE
ubhontshisi	u AE b o AE ɲ t ʃ iː AD s i AD
ubhoshobana	u AE b o AE ʃ o AE ɓ aː AD n a AD
ubhova	u AE b oː AE v a AD
ubhozo	u AE b oː AE z o AE
ubhusha	u AE b uː AE ʃ a AD
ubisi	uː AE ɓ iː AD s i AD
ubolo	uː AE ɓ oː AE l o AE
ubomvu	uː AE ɓ oː AE m v u AE
uboya	u AE ɓ oː AE j AB a AD
ububanzi	u AE ɓ u AE ɓ aː AD n z i AD
ububhibhi	u AE ɓ u AE b iː AD b i AD
ububi	u AE ɓ uː AE ɓ i AD
ububomvu	u AE ɓ u AE ɓ oː AE m v u AE
ubuchopho	u AE ɓ u AE ǀʰ oː AE pʰ o AE
ubuciko	u AE ɓ u AE ǀ iː AD ɠ o AE
ubudala	u AE ɓ u AE d aː AD l a AD
ubude	u AE ɓ uː AE d e AD
ubudlelwane	u AE ɓ u AE ɮ e AD l w AC aː AD n e AD
ubudoda	u AE ɓ u AE d oː AE d a AD
ubugqila	u AE ɓ u AE ǃʱ iː AD l a AD
ubugwala	u AE ɓ u AE ɡ w AC aː AD l a AD
ubuhlalu	u AE ɓ u AE ɬ aː AD l u AE
ubuhlanya	u AE ɓ u AE ɬ aː AD ɲ a AD
ubuhle	u AE ɓ uː AE ɬ e AD
ubuhleli	u AE ɓ u AE ɬ eː AD l i AD
ubuhlobo	u AE ɓ u AE ɬ oː AE ɓ o AE
ubuhlungu	u AE ɓ u AE ɬ uː AE n ɡ u AE
ubukhali	u AE ɓ u AE kʰ aː AD l i AD
ubukhosazana	u AE ɓ u AE kʰ o AE s a AD z aː AD n a AD
ubukhosikazi	u AE ɓ u AE kʰ o AE s i AD ɠ aː AD z i AD
ubukhulu	u AE ɓ u AE kʰ uː AE l u AE
ubuluhlaza	u AE ɓ u AE l u AE ɬ aː AD z a AD
ubumhlophe	u AE ɓ u AE m̩ ɬ oː AE pʰ e AD
ubumnene	u AE ɓ u AE m̩ n eː AD n e AD
ubumnyama	u AE ɓ u AE m̩ ɲ aː AD m a AD
ubumpi	u AE ɓ uː AE m p i AD
ubumpofu	u AE ɓ u AE m p oː AE f u AE
ubumpohlo	u AE ɓ u AE m p oː AE ɬ o AE
ubumtoti	u AE ɓ u AE m̩ t oː AE t i AD
ubuncane	u AE ɓ u AE ǀ aː AD n e AD
ubundlalifa	u AE ɓ u AE n ɮ a AD l iː AD f a AD
ubungane	u AE ɓ u AE n ɡ aː AD n e AD
ubungcono	u AE ɓ u AE ǀʱ oː AE n o AE
ubungqa	u AE ɓ uː AE ǃʱ a AD
ubungqo	u AE ɓ uː AE ǃʱ o AE
ubungqolokosho	u AE ɓ u AE ǃʱ o AE l o AE ɠ oː AE ʃ o AE
ubuningi	u AE ɓ u AE n iː AD n ɡ i AD
ubunjani	u AE ɓ u AE ɲ d ʒ aː AD n i AD
ubunqunu	u AE ɓ u AE ǃ uː AE n u AE
ubunsomi	u AE ɓ u AE n s oː AE m i AD
ubuntu	u AE ɓ uː AE n t u AE
ubuntwana	u AE ɓ u AE n t w AC aː AD n a AD
ubunxele	u AE ɓ u AE ǁ eː AD l e AD
ubunyakanyaka	u AE ɓ u AE ɲ a AD ɠ a AD ɲ aː AD ɠ a AD
ubunye	u AE ɓ uː AE ɲ e AD
ubuphansi	u AE ɓ u AE pʰ aː AD n s i AD
ubuqhawe	u AE ɓ u AE ǃʰ aː AD w AC e AD
ubuqotho	u AE ɓ u AE ǃ oː AE tʰ o AE
ubusha	u AE ɓ uː AE ʃ a AD
ubusika	u AE ɓ u AE s iː AD ɠ a AD
ubuso	u AE ɓ uː AE s o AE
ubusuku	u AE ɓ u AE s uː AE ɠ u AE
ubutha	u AE ɓ uː AE tʰ a AD
ubuthakathaka	u AE ɓ u AE tʰ a AD ɠ a AD tʰ aː AD ɠ a AD
ubuthi	u AE ɓ uː AE tʰ i AD
ubuthuntu	u AE ɓ u AE tʰ uː AE n t u AE
ubuthutha	u AE ɓ u AE tʰ uː AE tʰ a AD
ubuvaka	u AE ɓ u AE v aː AD ɠ a AD
ubuvila	u AE ɓ u AE v iː AD l a AD
ubuxhegu	u AE ɓ u AE ǁʰ eː AD ɡ u AE
ubuzimu	u AE ɓ u AE z iː AD m u AE
ubuzwe	u AE ɓ uː AE z w AC e AD
uchakide	u AE ǀʰ a AD ɠ iː AD d e AD
ucingo	uː AE ǀ iː AD n ɡ o AE
ucwecwe	uː AE ǀ w AC eː AD ǀ w AC e AD
udaba	uː AE d aː AD ɓ a AD
udaka	uː AE d aː AD ɠ a AD
udlame	uː AE ɮ aː AD m e AD
udlawu	uː AE ɮ aː AD w AC u AE
udokotela	u AE d o AE ɠ o AE t eː AD l a AD
udoli	u AE d oː AE l i AD
udondolo	uː AE d o AE n d oː AE l o AE
udonga	uː AE d oː AE n ɡ a AD
udoti	u AE d oː AE t i AD
udwi	u AE d w AC iː AD
ufezela	u AE f e AD z eː AD l a AD
ufu	uː AE f u AE
ufudu	uː AE f uː AE d u AE
ugadi	u AE ɡ aː AD d i AD
ugalo	uː AE ɡ aː AD l o AE
ugamthilini	u AE ɡ a AD m tʰ i AD l iː AD n i AD
uganandela	u AE ɡ a AD n a AD n d eː AD l a AD
ugazi	uː AE ɡ aː AD z i AD
ugesi	u AE ɡ eː AD s i AD
ugigi	u AE ɡ iː AD ɡ i AD
ugogo	u AE ɡ oː AE ɡ o AE
ugologo	u AE ɡ o AE l oː AE ɡ o AE
ugqozi	uː AE ǃʱ oː AE z i AD
ugu	uː AE ɡ u AE
ugwadule	uː AE ɡ w AC a AD d uː AE l e AD
ugwava	u AE ɡ w AC aː AD v a AD
ugwayi	u AE ɡ w AC aː AD j AB i AD
ugxa	uː AE ǁʱ a AD
uhabhu	uː AE h AA aː AD b u AE
uhambe kahle	u AE h AA a AD m b e AD ɠ aː AD ɬ e AD
uhambo	uː AE h AA aː AD m b o AE
uhele	uː AE h AA eː AD l e AD
uhhafu	u AE ɦ AA aː AD f u AE
uhla	uː AE ɬ a AD
uhlaka	uː AE ɬ aː AD ɠ a AD
uhlamvu	uː AE ɬ aː AD m v u AE
uhlangothi	uː AE ɬ a AD n ɡ oː AE tʰ i AD
uhlanya	uː AE ɬ aː AD ɲ a AD
uhlaza	uː AE ɬ aː AD z a AD
uhleko	uː AE ɬ eː AD ɠ o AE
uhlelo	uː AE ɬ eː AD l o AE
uhlobo	uː AE ɬ oː AE ɓ o AE
uhlu	uː AE ɬ u AE
uhulumeni	u AE h AA u AE l u AE m eː AD n i AD
ujamu	u AE d ʒ aː AD m u AE
ujehova	u AE d ʒ e AD h AA oː AE v a AD
ujeke	u AE d ʒ eː AD ɠ e AD
ujele	u AE d ʒ eː AD l e AD
ujesu	u AE d ʒ eː AD s u AE
ujinja	u AE d ʒ iː AD ɲ d ʒ a AD
uju	uː AE d ʒ u AE
ujusi	u AE d ʒ uː AE s i AD
ukhali	u AE kʰ aː AD l i AD
ukhamba	uː AE kʰ aː AD m b a AD
ukhetho	uː AE kʰ eː AD tʰ o AE
ukhisimusi	u AE kʰ i AD s i AD m uː AE s i AD
ukhokho	u AE kʰ oː AE kʰ o AE
ukholwase	u AE kʰ o AE l w AC aː AD s e AD
ukhongolose	u AE kʰ o AE n ɡ o AE l oː AE s e AD
ukhonkolo	u AE kʰ o AE n k oː AE l o AE
ukhophe	uː AE kʰ oː AE pʰ e AD
ukhozi	uː AE kʰ oː AE z i AD
ukhuni	uː AE kʰ uː AE n i AD
ukhwathu	uː AE kʰ w AC aː AD tʰ u AE
ukhweshe	uː AE kʰ w AC eː AD ʃ e AD
ukoko	u AE k oː AE k o AE
ukotini	u AE k o AE t iː AD n i AD
ukubulala	u AE ɠ u AE ɓ u AE l aː AD l a AD
ukucwila	u AE ɠ u AE ǀ w AC iː AD l a AD
ukudla	u AE ɠ uː AE ɮ a AD
ukudoba	u AE ɠ u AE d oː AE ɓ a AD
ukudweba	u AE ɠ u AE d w AC eː AD ɓ a AD
ukufa	u AE ɠ uː AE f a AD
ukugeza	u AE ɠ u AE ɡ eː AD z a AD
ukugqwala	u AE ɠ u AE ǃʱ w AC aː AD l a AD
ukugula	u AE ɠ u AE ɡ uː AE l a AD
ukugxeka	u AE ɠ u AE ǁʱ eː AD ɠ a AD
ukuhlamba	u AE ɠ u AE ɬ aː AD m b a AD
ukuhlikihla	u AE ɠ u AE ɬ i AD ɠ iː AD ɬ a AD
ukuhlwa	u AE ɠ uː AE ɬ w AC a AD
ukukhanya	u AE ɠ u AE kʰ aː AD ɲ a AD
ukulwa	u AE ɠ uː AE l w AC a AD
ukuma	u AE ɠ uː AE m a AD
ukumangala	u AE ɠ u AE m a AD n ɡ aː AD l a AD
ukuna	u AE ɠ uː AE n a AD
ukuncoma	u AE ɠ u AE ǀ oː AE m a AD
ukunene	u AE ɠ u AE n eː AD n e AD
ukungcola	u AE ɠ u AE ǀʱ oː AE l a AD
ukungenisa	u AE ɠ u AE n ɡ e AD n iː AD s a AD
ukungqubuzana	u AE ɠ u AE ǃʱ u AE ɓ u AE z aː AD n a AD
ukunqoba	u AE ɠ u AE ǃ oː AE ɓ a AD
ukunto	u AE ɠ uː AE n t o AE
ukuntshontsha	u AE ɠ u AE ɲ t ʃ oː AE ɲ t ʃ a AD
ukunxele	u AE ɠ u AE ǁ eː AD l e AD
ukunyenyeza	u AE ɠ u AE ɲ e AD ɲ eː AD z a AD
ukupela	u AE ɠ u AE p eː AD l a AD
ukupheka	u AE ɠ u AE pʰ eː AD ɠ a AD
ukuphela	u AE ɠ u AE pʰ eː AD l a AD
ukuphoqa	u AE ɠ u AE pʰ oː AE ǃ a AD
ukuphutha	u AE ɠ u AE pʰ uː AE tʰ a AD
ukuqala	u AE ɠ u AE ǃ aː AD l a AD
ukuqaphela	u AE ɠ u AE ǃ a AD pʰ eː AD l a AD
ukuqhuma	u AE ɠ u AE ǃʰ uː AE m a AD
ukuqoma	u AE ɠ u AE ǃ oː AE m a AD
ukusa	u AE ɠ uː AE s a AD
ukushisa	u AE ɠ u AE ʃ iː AD s a AD
ukuthula	u AE ɠ u AE tʰ uː AE l a AD
ukuze	u AE ɠ uː AE z e AD
ukuzibulala	u AE ɠ u AE z i AD ɓ u AE l aː AD l a AD
ukuzigqaja	u AE ɠ u AE z i AD ǃʱ aː AD d ʒ a AD
ukwi	uː AE k w AC i AD
ukwindla	u AE ɠ w AC iː AD n ɮ a AD
ulale kahle	u AE l a AD l e AD ɠ aː AD ɬ e AD
uletisi	u AE l e AD t iː AD s i AD
ulimi	uː AE l iː AD m i AD
ulwandle	uː AE l w AC aː AD n ɮ e AD
ulwazi	uː AE l w AC aː AD z i AD
ulwesibili	u AE l w AC e AD s i AD ɓ iː AD l i AD
ulwesihlanu	u AE l w AC e AD s i AD ɬ aː AD n u AE
ulwesine	u AE l w AC e AD s iː AD n e AD
ulwesithathu	u AE l w AC e AD s i AD tʰ aː AD tʰ u AE
ulwezi	uː AE l w AC eː AD z i AD
uma	uː AE m a AD
umabelo	u AE m a AD ɓ eː AD l o AE
umabi	u AE m aː AD ɓ i AD
umabo	u AE m aː AD ɓ o AE
umafikazisina	u AE m a AD f i AD ɠ a AD z i AD s iː AD n a AD
umakhelwane	u AE m a AD kʰ e AD l w AC aː AD n e AD
umakhi	u AE m aː AD kʰ i AD
umalukazi	u AE m a AD l u AE ɠ aː AD z i AD
umalume	u AE m a AD l uː AE m e AD
umama	u AE mʱ aː AD m a AD
umame	u AE m aː AD m e AD
umandulo	u AE m a AD n d uː AE l o AE
umaquba	u AE m a AD ǃ uː AE ɓ a AD
umashiqela	u AE m a AD ʃ i AD ǃ eː AD l a AD
umasingana	u AE m a AD s i AD n ɡ aː AD n a AD
umata	u AE m aː AD t a AD
umbala	u AE m̩ ɓ aː AD l a AD
umbaso	u AE m̩ ɓ aː AD s o AE
umbayimbayi	u AE m b a AD j AB i AD m b aː AD j AB i AD
umbhali	u AE m̩ b aː AD l i AD
umbhalo	u AE m̩ b aː AD l o AE
umbhede	u AE m̩ b eː AD d e AD
umbhicongo	u AE m̩ b i AD ǀ oː AE n ɡ o AE
umbhidli	u AE m̩ b iː AD ɮ i AD
umbhubhudlo	u AE m̩ b u AE b uː AE ɮ o AE
umbiko	u AE m̩ ɓ iː AD ɠ o AE
umboko	u AE m̩ ɓ oː AE ɠ o AE
umbombo	u AE m̩ ɓ oː AE m b o AE
umbono	u AE m̩ ɓ oː AE n o AE
umbulali	u AE m̩ ɓ u AE l aː AD l i AD
umcebo	u AE m̩ ǀ eː AD ɓ o AE
umcubungulo	u AE m̩ ǀ u AE ɓ u AE n ɡ uː AE l o AE
umculo	u AE m̩ ǀ uː AE l o AE
umcwaningi	u AE m̩ ǀ w AC a AD n iː AD n ɡ i AD
umcwebo	u AE m̩ ǀ w AC eː AD ɓ o AE
umdabu	u AE m̩ d aː AD ɓ u AE
umdanso	u AE m̩ d aː AD n s o AE
umdidi	u AE m̩ d iː AD d i AD
umdlali	u AE m̩ ɮ aː AD l i AD
umdlalo	u AE m̩ ɮ aː AD l o AE
umdlwenguli	u AE m̩ ɮ w AC e AD n ɡ uː AE l i AD
umduzu	u AE m̩ d uː AE z u AE
umdwebo	u AE m̩ d w AC eː AD ɓ o AE
umdweshu	u AE m̩ d w AC eː AD ʃ u AE
umebo	u AE m eː AD ɓ o AE
umelusi	u AE m e AD l uː AE s i AD
umendo	u AE m eː AD n d o AE
umenzi	u AE m eː AD n z i AD
umese	u AE mʱ eː AD s e AD
umfana	u AE m̩ f aː AD n a AD
umfanyana	u AE m̩ f a AD ɲ aː AD n a AD
umfazi	u AE m̩ f aː AD z i AD
umfelokazi	u AE m̩ f e AD l o AE ɠ aː AD z i AD
umfino	u AE m̩ f iː AD n o AE
umfokazana	u AE m̩ f o AE ɠ a AD z aː AD n a AD
umfokazi	u AE m̩ f o AE ɠ aː AD z i AD
umfudlana	u AE m̩ f u AE ɮ aː AD n a AD
umfula	u AE m̩ f uː AE l a AD
umfumfu	u AE m f uː AE m f u AE
umfundi	u AE m̩ f uː AE n d i AD
umfundisi	u AE m̩ f u AE n d iː AD s i AD
umgankla	u AE m̩ ɡ aː AD n k l a AD
umganu	u AE m̩ ɡ aː AD n u AE
umgcagco	u AE m̩ ǀʱ aː AD ǀʱ o AE
umgede	u AE m̩ ɡ eː AD d e AD
umgibeli	u AE m̩ ɡ i AD ɓ eː AD l i AD
umgodi	u AE m̩ ɡ oː AE d i AD
umgqibelo	u AE m̩ ǃʱ i AD ɓ eː AD l o AE
umgqomo	u AE m ǃʱ oː AE m o AE
umgqulo	u AE m̩ ǃʱ uː AE l o AE
umgungundlovu	u AE m̩ ɡ u AE n ɡ u AE n ɮ oː AE v u AE
umgwamanda	u AE m̩ ɡ w AC a AD m aː AD n d a AD
umgwaqana	u AE m̩ ɡ w AC a AD ǃ aː AD n a AD
umgwaqo	u AE m̩ ɡ w AC aː AD ǃ o AE
umgwebi	u AE m̩ ɡ w AC eː AD ɓ i AD
umgwenya	u AE m̩ ɡ w AC eː AD ɲ a AD
umgxala	u AE m̩ ǁʱ aː AD l a AD
umhlaba	u AE m̩ ɬ aː AD ɓ a AD
umhlabathi	u AE m̩ ɬ a AD ɓ aː AD tʰ i AD
umhlane	u AE m̩ ɬ aː AD n e AD
umhlanga	u AE m̩ ɬ aː AD n ɡ a AD
umhlangano	u AE m̩ ɬ a AD n ɡ aː AD n o AE
umhlaza	u AE m̩ ɬ aː AD z a AD
umhleli	u AE m̩ ɬ eː AD l i AD
umhlengi	u AE m̩ ɬ eː AD n ɡ i AD
umhlobo	u AE m̩ ɬ oː AE ɓ o AE
umhlophe	u AE m̩ ɬ oː AE pʰ e AD
umhlophekazi	u AE m̩ ɬ o AE pʰ e AD ɠ aː AD z i AD
umhlukazi	u AE m̩ ɬ u AE ɠ aː AD z i AD
umhluzi	u AE m̩ ɬ uː AE z i AD
umhlwazi	u AE m̩ ɬ w AC aː AD z i AD
umhuzulo	u AE m̩ h AA u AE z uː AE l o AE
umhwebi	u AE m̩ h AA w AC eː AD ɓ i AD
umhwebo	u AE m̩ h AA w AC eː AD ɓ o AE
umisi	u AE m iː AD s i AD
umjaho	u AE m̩ d ʒ aː AD h AA o AE
umjondolo	u AE m̩ d ʒ o AE n d oː AE l o AE
umjovo	u AE m̩ d ʒ oː AE v o AE
umkhabo	u AE m̩ kʰ aː AD ɓ o AE
umkhathi	u AE m̩ kʰ aː AD tʰ i AD
umkhawulo	u AE m̩ kʰ a AD w AC uː AE l o AE
umkhaya	u AE m̩ kʰ aː AD j AB a AD
umkhemese	u AE m kʰ e AD m eː AD s e AD
umkhetho	u AE m̩ kʰ eː AD tʰ o AE
umkhomazi	u AE m̩ kʰ o AE m aː AD z i AD
umkhombo	u AE m̩ kʰ oː AE m b o AE
umkhomo	u AE m̩ kʰ oː AE m o AE
umkhono	u AE m̩ kʰ oː AE n o AE
umkhonto	u AE m̩ kʰ oː AE n t o AE
umkhuba	u AE m̩ kʰ uː AE ɓ a AD
umkhulu	u AE m̩ kʰ uː AE l u AE
umkhumbi	u AE m̩ kʰ uː AE m b i AD
umkhwekazi	u AE m̩ kʰ w AC e AD ɠ aː AD z i AD
umkhwenyana	u AE m̩ kʰ w AC e AD ɲ aː AD n a AD
umklomelo	u AE m̩ k x o AE m eː AD l o AE
umlambo	u AE m̩ l aː AD m b o AE
umlamu	u AE m̩ l aː AD m u AE
umlenze	u AE m̩ l eː AD n z e AD
umlilo	u AE m̩ l iː AD l o AE
umlisa	u AE m̩ l iː AD s a AD
umlobokazi	u AE m̩ l o AE ɓ o AE ɠ aː AD z i AD
umlomo	u AE m̩ l oː AE m o AE
umlotha	u AE m̩ l oː AE tʰ a AD
umlungu	u AE m̩ l uː AE n ɡ u AE
ummbila	u AE m̩ m b iː AD l a AD
ummese	u AE m̩ m eː AD s e AD
umncintiswano	u AE m̩ ǀ i AD n t i AD s w AC aː AD n o AE
umndeni	u AE m̩ n d eː AD n i AD
umngane	u AE m̩ n ɡ aː AD n e AD
umngcwabo	u AE m̩ ǀʱ w AC aː AD ɓ o AE
umngqithi	u AE m̩ ǃʱ iː AD tʰ i AD
umngquphane	u AE m̩ ǃʱ u AE pʰ aː AD n e AD
umnguni	u AE m̩ n ɡ uː AE n i AD
umnqobi	u AE m ǃ oː AE ɓ i AD
umnqumo	u AE m̩ ǃ uː AE m o AE
umntwana	u AE m̩ n t w AC aː AD n a AD
umnyama	u AE m̩ ɲ aː AD m a AD
umnyango	u AE m̩ ɲ aː AD n ɡ o AE
umnyelele	u AE m̩ ɲ e AD l eː AD l e AD
umoba	u AE m oː AE ɓ a AD
umona	u AE m oː AE n a AD
umoya	u AE m oː AE j AB a AD
umpetshisi	u AE m̩ p e AD t ʃ iː AD s i AD
umphakathi	u AE m̩ pʰ a AD ɠ aː AD tʰ i AD
umphako	u AE m̩ pʰ aː AD ɠ o AE
umphambili	u AE m̩ pʰ a AD m b iː AD l i AD
umphansi	u AE m̩ pʰ aː AD n s i AD
umphefumulo	u AE m̩ pʰ e AD f u AE m uː AE l o AE
umpheki	u AE m̩ pʰ eː AD ɠ i AD
umphimbo	u AE m̩ pʰ iː AD m b o AE
umphumela	u AE m̩ pʰ u AE m eː AD l a AD
umqala	u AE m̩ ǃ aː AD l a AD
umqali	u AE m̩ ǃ aː AD l i AD
umqamelo	u AE m̩ ǃ a AD m eː AD l o AE
umqhele	u AE m̩ ǃʰ eː AD l e AD
umqolo	u AE m̩ ǃ oː AE l o AE
umqondo	u AE m̩ ǃ oː AE n d o AE
umqophi	u AE m̩ ǃ oː AE pʰ i AD
umqotho	u AE m̩ ǃ oː AE tʰ o AE
umquba	u AE m̩ ǃ uː AE ɓ a AD
umqwakuza	u AE m̩ ǃ w AC a AD ɠ uː AE z a AD
umsebenzi	u AE m̩ s e AD ɓ eː AD n z i AD
umsebenzisi	u AE m̩ s e AD ɓ e AD n z iː AD s i AD
umshado	u AE m̩ ʃ aː AD d o AE
umshana	u AE m̩ ʃ aː AD n a AD
umshini	u AE m̩ ʃ iː AD n i AD
umshiya	u AE m̩ ʃ iː AD j AB a AD
umshumayeli	u AE m̩ ʃ u AE m a AD j AB eː AD l i AD
umshushisi	u AE m̩ ʃ u AE ʃ iː AD s i AD
umshushiso	u AE m̩ ʃ u AE ʃ iː AD s o AE
umshwana	u AE m̩ ʃ w AC aː AD n a AD
umsila	u AE m̩ s iː AD l a AD
umsindo	u AE m̩ s iː AD n d o AE
umsombuluko	u AE m̩ s o AE m b u AE l uː AE ɠ o AE
umsuka	u AE m̩ s uː AE ɠ a AD
umsundu	u AE m̩ s uː AE n d u AE
umsuthu	u AE m̩ s uː AE tʰ u AE
umswakama	u AE m̩ s w AC a AD ɠ aː AD m a AD
umtata	u AE m̩ t aː AD t a AD
umthambo	u AE m̩ tʰ aː AD m b o AE
umthamo	u AE m̩ tʰ aː AD m o AE
umthandi	u AE m̩ tʰ aː AD n d i AD
umthembu	u AE m̩ tʰ eː AD m b u AE
umthetho	u AE m̩ tʰ eː AD tʰ o AE
umthofu	u AE m̩ tʰ oː AE f u AE
umthombo	u AE m̩ tʰ oː AE m b o AE
umthunzi	u AE m̩ tʰ uː AE n z i AD
umthuqu	u AE m̩ tʰ uː AE ǃ u AE
umthwalo	u AE m tʰ w AC aː AD l o AE
umtoti	u AE m̩ t oː AE t i AD
umtshwana	u AE m̩ t ʃ w AC aː AD n a AD
umtswana	u AE m̩ t s w AC aː AD n a AD
umtube	u AE m̩ t uː AE ɓ e AD
umudwa	u AE m uː AE d w AC a AD
umufi	u AE m uː AE f i AD
umufo	u AE m uː AE f o AE
umuga	u AE m uː AE ɡ a AD
umugqa	u AE m uː AE ǃʱ a AD
umuhla	u AE m uː AE ɬ a AD
umuhlwa	u AE m uː AE ɬ w AC a AD
umukhwa	u AE m uː AE kʰ w AC a AD
umukhwe	u AE m uː AE kʰ w AC e AD
umumba	u AE m uː AE m b a AD
umumbi	u AE m uː AE m b i AD
umumo	u AE m uː AE m o AE
umunca	uː AE m uː AE ǀ a AD
umunqa	u AE m uː AE ǃ a AD
umunswi	u AE m uː AE n s w AC i AD
umuntu	u AE m uː AE n t u AE
umuntu ngumuntu ngabantu	u AE m u AE n t u AE n ɡ u AE m u AE n t u AE n ɡ a AD ɓ aː AD n t u AE
umunwe	u AE m uː AE n w AC e AD
umunyu	u AE m uː AE ɲ u AE
umusa	u AE m uː AE s a AD
umusho	u AE m uː AE ʃ o AE
umusi	u AE m uː AE s i AD
umuso	u AE m uː AE s o AE
umuthi	u AE m uː AE tʰ i AD
umuthwa	u AE m uː AE tʰ w AC a AD
umuva	u AE m uː AE v a AD
umuvi	u AE m uː AE v i AD
umuwa	u AE m uː AE w AC a AD
umuzi	u AE m uː AE z i AD
umuzwa	u AE m uː AE z w AC a AD
umvimba	u AE m̩ v iː AD m b a AD
umvingqi	u AE m v iː AD ǃʱ i AD
umvithi	u AE m̩ v iː AD tʰ i AD
umvoti	u AE m̩ v oː AE t i AD
umvubu	u AE m̩ v uː AE ɓ u AE
umvundla	u AE m̩ v uː AE n ɮ a AD
umvuno	u AE m̩ v uː AE n o AE
umvuzi	u AE m̩ v uː AE z i AD
umvuzo	u AE m̩ v uː AE z o AE
umxhapho	u AE m̩ ǁʰ aː AD pʰ o AE
umxhosa	u AE m̩ ǁʰ oː AE s a AD
umyeni	u AE m̩ j AB eː AD n i AD
umzala	u AE m̩ z aː AD l a AD
umzali	u AE m̩ z aː AD l i AD
umzamo	u AE m̩ z aː AD m o AE
umzekelo	u AE m̩ z e AD ɠ eː AD l o AE
umzimba	u AE m̩ z iː AD m b a AD
umzingeli	u AE m̩ z i AD n ɡ eː AD l i AD
umzukulu	u AE m̩ z u AE ɠ uː AE l u AE
umzulu	u AE m̩ z uː AE l u AE
umzuzu	u AE m̩ z uː AE z u AE
umzuzwana	u AE m̩ z u AE z w AC aː AD n a AD
uncedo	uː AE ǀ eː AD d o AE
uncibijane	u AE ǀ i AD ɓ i AD d ʒ aː AD n e AD
uncwaba	u AE ǀ w AC aː AD ɓ a AD
undasa	u AE n d aː AD s a AD
unesi	u AE n eː AD s i AD
ungcede	u AE ǀʱ eː AD d e AD
ungqi	uː AE ǃʱ i AD
ungqo	uː AE ǃʱ o AE
ungqongqoshe	u AE ǃʱ o AE ǃʱ oː AE ʃ e AD
ungulazibuya	u AE n ɡ u AE l a AD z i AD ɓ uː AE j AB a AD
ungwaqa	u AE n ɡ w AC aː AD ǃ a AD
unhlaba	u AE n ɬ aː AD ɓ a AD
unhlangula	u AE n ɬ a AD n ɡ uː AE l a AD
unhlangulana	u AE n ɬ a AD n ɡ u AE l aː AD n a AD
unhlolanja	u AE n ɬ o AE l aː AD ɲ d ʒ a AD
unina	u AE n iː AD n a AD
unkamisa	u AE n k a AD m iː AD s a AD
unkulunkulu	u AE n k u AE l u AE n k uː AE l u AE
unobhala	u AE n o AE b aː AD l a AD
unogwaja	u AE n o AE ɡ w AC aː AD d ʒ a AD
unohha	u AE nʱ oː AE ɦ AA a AD
unondwebu	u AE n o AE n d w AC eː AD ɓ u AE
unqangi	u AE ǃ aː AD n ɡ i AD
unswinswinswi	u AE n s w AC i AD n s w AC iː AD n s w AC i AD
untulikazi	u AE n t u AE l i AD ɠ aː AD z i AD
unwabu	uː AE n w AC aː AD ɓ u AE
unwele	uː AE n w AC eː AD l e AD
unya	uː AE ɲ a AD
unyaka	u AE ɲ aː AD ɠ a AD
unyawo	uː AE ɲ aː AD w AC o AE
unyelele	uː AE ɲ e AD l eː AD l e AD
unyembezi	uː AE ɲ e AD m b eː AD z i AD
unyezi	u AE ɲ eː AD z i AD
unyoko	u AE ɲ oː AE ɠ o AE
unzo	u AE n z oː AE
unzoqhwishi	u AE n z oː AE ǃʰ w AC iː AD ʃ i AD
upende	u AE p eː AD n d e AD
uphahla	uː AE pʰ aː AD ɬ a AD
uphaphe	uː AE pʰ aː AD pʰ e AD
uphayinaphu	u AE pʰ a AD j AB i AD n aː AD pʰ u AE
uphepha	u AE pʰ eː AD pʰ a AD
uphephela	u AE pʰ e AD pʰ eː AD l a AD
uphondo	uː AE pʰ oː AE n d o AE
uqhezu	uː AE ǃʰ eː AD z u AE
uqhoqhoqho	u AE ǃʰ o AE ǃʰ oː AE ǃʰ o AE
uqhwishi	u AE ǃʰ w AC iː AD ʃ i AD
uqobo	uː AE ǃ oː AE ɓ o AE
usale kahle	u AE s a AD l e AD ɠ aː AD ɬ e AD
usana	uː AE s aː AD n a AD
usapho	uː AE s aː AD pʰ o AE
usawoti	u AE s a AD w AC oː AE t i AD
usepthemba	u AE s e AD p tʰ eː AD m b a AD
ushaka	u AE ʃ aː AD ɠ a AD
ushizi	u AE ʃ iː AD z i AD
ushukela	u AE ʃ u AE ɠ eː AD l a AD
usiba	uː AE s iː AD ɓ a AD
usogekle	u AE s o AE ɡ eː AD k x e AD
usuku	uː AE s uː AE ɠ u AE
utamatisi	u AE t a AD m a AD t iː AD s i AD
uthando	uː AE tʰ aː AD n d o AE
uthi	uː AE tʰ i AD
uthuli	uː AE tʰ uː AE l i AD
utshana	u AE t ʃ aː AD n a AD
utshani	u AE t ʃ aː AD n i AD
utshwala	u AE t ʃ w AC aː AD l a AD
uvalo	uː AE v aː AD l o AE
uve	uː AE v e AD
uvolo	u AE v oː AE l o AE
uweta	u AE w AC eː AD t a AD
uxamu	u AE ǁ aː AD m u AE
uxolo	uː AE ǁ oː AE l o AE
uyihlo	u AE j AB iː AD ɬ o AE
uyise	u AE j AB iː AD s e AD
uzamcolo	u AE z a AD m̩ ǀ oː AE l o AE
uzekamanzi	u AE z e AD ɠ a AD m aː AD n z i AD
uzibandlela	u AE z i AD ɓ a AD n ɮ eː AD l a AD
uzibuthe	u AE z i AD ɓ uː AE tʰ e AD
uzipho	uː AE z iː AD pʰ o AE
uzulu	u AE z uː AE l u AE
vuya	v uː AE j AB a AD
wena	w AC eː AD n a AD
wololo	w AC o AE l o AE l oː AE
wona	w AC oː AE n a AD
xega	ǁ eː AD ɡ a AD
xegisa	ǁ e AD ɡ iː AD s a AD
xhapha	ǁʰ aː AD pʰ a AD
xhasa	ǁʰ aː AD s a AD
xhuga	ǁʰ uː AE ɡ a AD
xhuma	ǁʰ uː AE m a AD
xokozela	ǁ o AE ɠ o AE z eː AD l a AD
xola	ǁ oː AE l a AD
xoxa	ǁ oː AE ǁ a AD
xuba	ǁ uː AE ɓ a AD
xubana	ǁ u AE ɓ aː AD n a AD
xubha	ǁ uː AE b a AD
xwaya	ǁ w AC aː AD j AB a AD
xwayisa	ǁ w AC a AD j AB iː AD s a AD
yebo	jʱ AB eː AD ɓ o AE
yeka	j AB eː AD ɠ a AD
yena	j AB eː AD n a AD
yona	j AB oː AE n a AD
za	z a AD
zala	z aː AD l a AD
ze	z e AD
zona	z oː AE n a AD
