ნრდილოეთის	t ʃ ɾ d i l ɔ ɛ tʰ i s
ქარი	kʰ ɑ ɾ i
და	d ɑ
მპე	m z ɛ
ვამათობდნენ	kʼ ɑ m ɑ tʰ ɔ b d n ɛ n
თუ	tʰ u
რომელი	ɾ o m ɛ l i
იყო	i qʼ ɔ
უფრო	u pʰ ɾ ɔ
ძლიერი	d z l i ɛ ɾ i
ამ	a m
დროს	d ɾ ɔ s
ვაიარა	ɡ ɑ i ɑ ɾ ɑ
ერთმა	ɛ r tʰ m ɑ
ნაბდწაოხურულმა	n ɑ b ɑ d t sʼ a m ɔ x u r u l m ɑ
მგზავრმა	m ɡ z ɑ v ɾ m ɑ
ისინი	i s i n i
შეთანხმდნენ	ʃ ɛ tʰ ɑ n x m d n ɛ n
უძლიერესად	u d z l i ɛ r ɛ s ɑ d
ეცნოთ	ɛ t s n ɔ tʰ
ის	i s 
რომელიც	ɾ ɔ m ɛ l i t s
მგზავრს	m ɡ z ɑ v ɾ s
პირველი	pʼ i r v ɛ l i
მოახდევინებდა	m ɔ ɑ x d e v i n e b d ɑ
ნაბადს	n ɑ b ɑ d s
ჯერ	d ʒ ɛ ɾ
ჩრდილეთის	t ʃ r d i l ɔ ɛ tʰ i s
ქარმა	kʰ ɑ r m ɑ
დაუბერა	d ɑ u b ɛ ɾ ɑ
მთელი	m tʰ ɛ l i
ძალღონით	d z ɑ l ɣ ɔ n i tʰ 
მარამ	m ɑ ɡ ɾ ɑ m
რაც	ɾ ɑ t s
უფრო	u pʰ r ɔ
ძლიერ	d z l i ɛ ɾ
უბერავდა	u b ɛ ɾ ɑ v d ɑ 
მგზავრი	m ɡ z ɑ v ɾ i
მით	m i tʰ
უფრო	u pʰ r ɔ
მაგრად	m ɑ ɡ ɾ ɑ d
ეხვეოდა	ɛ x v e ɔ d a
ნაბადში	n ɑ b a d ʃ i
ბოლოს	b ɔ l ɔ s
ჩრდილოეთის	t ʃ ɾ d i l ɔ ɛ tʰ i s
ქარი	kʰ ɑ ɾ i
დაცხრა	d ɑ t s x ɾ a
ახლა	ɑ x l ɑ
მზემ	m z ɛ m
გამოაბრწყინა	ɡ ɑ m ɔ ɑ b r t sʼ qʼ i n ɑ
და	d ɑ
დააცხუნა	d ɑː t s x u n ɑ
მგზავრმა	m ɡ z ɑ v ɾ m ɑ
ნაბადი	n ɑ b ɑ d i
მაშინვე	m a ʃ i n v ɛ
მოიხდა	m ɔ i x ɑ d ɑ
ამრიგად	a m ɾ i ɡ ɑ d 
ჩრდილოეთის	t ʃ ɾ d i l ɔ ɛ tʰ i s
ქარი	kʰ ɑ r i
იძულებული	i d z u l ɛ b u l i
გახდა	ɡ ɑ x d a
ედიარებინა	ɛ ɣ i ɑ ɾ ɛ b i n ɑ 
რომ	r ɔ m
მათ	m a tʰ
შორს	ʃ ɔ ɾ i s
მზე	m z ɛ
უფრო	u pʰ ɾ ɔ
ძლიერი	d z l i ɛ ɾ i
იყო	i qʼ ɔ
